dialect	standard
예 옌나레 한 인 게 이시벼 년 저넨 에는 요 글려넨 인제 어르미 그르다지 웁서서	예 옛날에 한 이게 이십여년 전에는 요 근년에는 이제 얼음이 그다지 없었어
이제 한 이시벼 년 전 그 때에는 지금 지그믄 요기 인제 창후리서 인제 일러리 이 뽀도가 인제수시로 댕이지머는	이제 한 이십여년 전 그 때에는 지금 지금은 여기 이제 창후리에서 이제 이리로 이 보트가이제 수시로 다니지만
그 저 그 이저네는 이 남산포래는 데서 인처느루 여 여객서니 댕겨서	그저 그 이전에는 이북 남산포라는 데서 인천으로 여 여객선이 다녔어
그니께 연락서니지 인제 그거시 인제 하루에 여기서 한 번 아치메 인제 가구 저그서 한 번 오구하루에 한 번바께 배가 여기 웁서서	그러니까 연락도 이제 그것이 이제 하루에 여기서 한 번 아침에 이제 가고 저기서 한 번 오고하루에 한 번밖에 배가 여기 없었어
움는데 겨울처레는 뭐 오늘 내 향교에 드러가서 인제 오늘두 인제 부냥을 허구 하는 거 보구선인제 나와찌마는	없는데 겨울철에는 뭐 오늘 내가 이 향교에 들어가서 이제 오늘도 이제 분향을 하고 하는거 보고선 이제 나왔지만
거기 이제 어제 인제 광아 가따온 사람들 얘기 드르니껜 바다에 그냥 어르미 꽉 드려차뜨래 차서	거기 이제 어제 이제 강화 갔다온 사람들 얘기 들으니까 바다에 그냥 얼음이 꽉 들어찼더래찼어
근데 인제 무리 이 쓴 다으메는 어르미 차서 인제 배가 인제 댄 이 보도가 댕기질 모터고 물밀 때만 인제 거 무리 밀먼 어르미 갈라지 무리 이러 마니 올라오니껜 어르미 갈라지지	그런데 이제 물이 이 쓴 다음에는 얼음이 차서 이제 배가 이제 다 이 보트가 다니질 못하고물 밀 때에만 이제 그 물이 밀면 얼음이 갈라지 물이 이렇게 많이 올라오니까 얼음이 갈라지지
근께 그 이 그 시가늘 이용해서 배가 배가 다니지	그러니까 그 이 그 시간을 이용해서 배가 배가 다니지
그 간조시엔 무리 쓴 다멘 배 이 지금두 댕기지 모탄다구 허는데	그 간조 시엔 물이 쓴 다음엔 배가 지금도 다니지 못한다고 하는데
이 추위 그때는 그 귿 그 당시에 인처느루 댕길 때는 여그서 인천 저 월미도나 괘이부리 인제일러리 다닐 때는 여 무리 여서씨가늘 걸리는데 어르미 꽉 차니껜 배가 일쩔 모땡기고 겨울 내내인제 교동은 가처인는 처지라	이 추위 그때는 그 그 당시에 인천으로 다닐 때는 여기서 인천 저 월미도나 괭이부리 이제이리로 다닐 때는 무려 여섯시간을 걸렸는데 얼음이 꽉 차니까 배가 일절 못 다니고 겨울 내내이제 교동은 갇혀있는 처지라
핸데 이 글려네 오먼서 온나나가 대가지구선 은제 어르미 아놔서 아놔 하나두 웁썬는데	헌데 이 근년에 오면서 온난화가 되어 가지고선 언제 얼음이 안 왔어 안 와 하나도 없었는데
장녀네 장년 비뻐터 비러소 장녀네 인제 어르미 나서두 약깐 이제 낟때따구 하는데 오래는 헹펴넙씨꽉 드레차따구 허더라구	작년에 작년 빗부터 비로소 작년에 이제 얼음이 났어도 약간 이제 났댔다고 하는데 올해는형편없이 꽉 들어찼다고 하더라고
오는 기레 찌거꺼든뇨 이거 다 어름이죠	오는 길에 찍었거든요 이거 다 얼음이죠
오늘두 내 행교에서 그런 얘길 해서	오늘도 내가 향교에서 그런 얘길 했어
옌나렌 사만사오니라는데 오래는 사만사온두 우 웁써지고 마라떠라니껜 어느 사라미 구안 이란게 구안이로니야요	옛날엔 삼한사온이라는데 올해는 삼한사온도 없어지고 말았떠라니까 어느 사람이 구한일한그게 구한일온이에요
아으레 추꾸 하루 따드태니께 구안이로니지	아 그래 춥고 하루 따듯하니까 구한일온이지
그러태는 이 우스며 얘기두 핸는데	그렇다는지 웃으며 얘기도 했는데
오늘두 이거 엄창나게 어르미 나때는 건데 이거이 어드런 기후의 벼놔로서 데는 건지두 모르간는데	오늘도 이거 엄청나게 얼음이 났대는 건데 이게 어떤 기후의 변화로써 되는 건지도 모르겠는데
좌우간 기우가 지나내 인제 여름처레 여기 농사처리 농사꼬장인께 농사들 진는데 비두 엄창나게마니 와꾸	좌우간 기후가 지난해 이제 여름철에 여기 농사철이 농사고장이니까 농사들 짓는데 비도엄청나게 많이 왔고
그런가 해뜨니 올 겨우렌 유나니 이러이 춥꾸 허니께 내 보 이 금년도지 이게 벌써 이뤌따린껜	그런가 했더니 올 겨울엔 유난히 이렇게 춥고 이게 내 이 금년도지 이게 벌써 이월달이니까
에 장년도에 그랜는데 금년도에 농사도 어드케 될 껀지 이제 기우가 어드러케 벼놔알 껀지도모르가서	에 작년도에 그랬는데 금년도에 농사도 어떻게 될 건지 이제 기후가 어떻게 변화할 건지도모르겠어
그러면 먼저 이 마으리 어떤 마으린지를 좀 얘기를 드러보고 시픈데요	아 그러면 먼저 이 마을이 어떤 마을인지를 좀 얘기를 들어보고 싶은데요
어 이 고구리	어어 이 고구리
언제 어떠케 생겨나꼬 주민드른 보통 어떤 성씨가 이써요	예 언제 어떻게 생겨났고 주민들은 보통 어떤 성씨가 있어요
에 지금 지금 우리 교동도가 은제 어트게 생겨나때는 건 이건 몰라	에 지금 지금 우리 교동도가 언제 어떻게 생겨났대는 건 이건 몰라
응 어니때 어드러케 천지 개벼그루 조와 소그루 인제 생겨난 건지 건 모르 모르지	응 어느 때 어떻게 천지개벽으로 조화 속으로 이제 생겨난 건지 그건 모르 모르지
그 소거네 인제 속따메 드르며는 인제 우리가 흐니 천지개벽 천지개벽 허자나	그 속언에 이제 속담에 들으면 인제 우리가 흔히 천지개벽 천지개벽 하잖아
천지개벼기랜 말만 드러찌 우리가 천지개벽 본 사라믄 업따 마리지 또 보래야 볼 쑤도 움는거시구	천지개벽이란 말만 들었지 우리가 천지개벽 본 사람은 없다 말이지 또 볼래야 볼 수도 없는거지 뭐
그게 천지개벼기래는 거는 분명이 그 서 서적 서저그루 보며는 천지개벼근 분명이 인는 거시라마리지	그게 천지개벽이라는 거는 분병히 그 서 서적으로 보면 천지개벽은 분명히 있는 것이란 말이지
그게 천지개벼기 그면 천지개벼기 은마 그 기이리 은마나 걸리냐면 무려 시비만 구천뉵뺑 녀니래는세워리 흘를단 마리야	그게 천지개벽에 그러면 천재개벽이 얼마 그 길이 얼마나 걸리냐면 무려 십이만 구천육백년이라는 세월이란 말이야
그 시비만 구천뉵뺑 녀니 데며는 그땐 완저니 천지개벼기 된데는데	그 십이만 구천육백년이 되면 그땐 완전히 천지개벽이 된다는데
우리 교동이랜 데가 인제 그 천지개벼컬 때에 생겨난 건지 그 추후에 어드케 생겨난 건지 그거슨그 내여근 모르고	우리 교동이라는 데가 그 천지개벽할 때에 생겨난 건지 그 추후에 어떻게 생겨난 건지 그것은그 내역은 모르고
에 교동에 대한 금 또 뭐 다른 거 무를 꺼 인나	에 교동에 대한 그럼 또 뭐 다른 거 물을 거 있나
문는 데 대 대해서 다블 해줘야 되가찌	묻는 데 대해서 답을 해줘야 되겠지
그럼 어떤 성씨 분드리 마는지  보통은 어떤 성씨가 마나요 이 교동에는 승씨 예	그럼 어떤 성씨 분들이 많은지  보통은 어떤 성씨가 많아요 이 교동에는 성씨예
승씨는 여기가 오대승이야 다섣 다서씅이 저 저 대승이야	성씨는 여기가 오대성이야 다섯 다섯 성이 저 대성이야
그 다서씅 중에는 에 황씨 방씨  에 한씨 전씨	그 다섯 성 중에는 에 황씨 방씨  에 한씨 전씨
또 뭐냐  으음 그게 뭐지  전씨 으응 방  황씨 방씨 한씨 전씨 그리고 또하난 뭐냐 으음 이 이씬가	또 뭐냐  으음 그게 뭐지  전씨 으응 방  황씨 방씨 한씨 전씨 그리고또 하난 뭐냐 으음 이 이씨인가
그거이 게 오대 오대승이야 음	그게 그게 오대 오대성이야 음
이 마을 이름 여기가 고구리자나요  이 고구리라는 이르메 유래가 이써요 이찌아 그건 어떠케 되는 거에요	이 마을 이름 여기가 고구리잖아요  이 고구리라는 이름에 유래가 있어요 있지아 그건 어떻게 되는 거예요
고구리라는 게시 예고짜에 거북꾸짜거든	고구리라는 것이고 자에 거북 구 자거든
응 예고짜는 뭐냐먼 요 요기 저수지 여기찌  그거 고구초니래니까 고 아페 저수지이짜나 고 근너 동네가 고음니야 고음니	응고 자는 뭐냐면 여 여기 저수지 여깄지  그거 고구촌이래니까 그 앞에 저수지있잖아 그 건너 동네가 고읍리야 고읍리
예고짜에 으비란 읍짜 응 도 도 고으릅짜 그게 고음닌데	예 고 자에 읍이란 읍 자 도 도 고을 읍 자 그게 고읍리인데
거기가 지그믄 인제 면사무소라고 하지 그 당시에는 며 면사무소가 아니구 여그가 옌나렌교동구니야 교동군	거기가 지금은 이제 면사무소라고 하지 그 당시에는 며 면사무소가 아니고 여기가 옛날엔교동군이야 교동군
지그믄 광와군 교동면 허지마는 그때는 광아현 교동두 현	지금은 강화군 교동면 하지만 그때는 강화현 교동도 현
그니겐 광아 광아두 지그므루 얘기함 광아두 구니구 교동두 교동구니야	그러니까 강화 강화도 지금으로 얘기하면 강화도 군이고 교동도 교동군이야
그 혀니 읍써지구선두 교동구니라구 또 구느루 별또루 이 따루 이서 광아하군 별또루 이서따구	그 현이 없어지고서도 교동군이라고 또 군으로 별도로 이 따로 있어 강화하고는 별도로 있었다고
핸는데 거기가 현감 사또 이 지금 말루 얘기허먼 군수지	했는데 거기가 현감 사또 이 지금 말로 얘기하면 군수지
군수가 거기 안저뜬 자리야 고음니 고 근너 거기가 거기가 지금두 가며는 터가 이서 안저뜬관사터가 이서	군수가 거기 앉았던 자리야 고읍리 그 건너 거기가 거기가 지금도 가면 터가 있어 앉았던관사터가 있어
즉 마라자먼 인제 군청 청 지금 얘기허먼 군 청사지	지금 말하자면 이제 군 청 청 지금 얘기하면 군 청사지
그저넨 사뚜가 안자떤 관사터가 이 지금도 이서 그래서 그기 이 거기 이따가 이 음내리루 그관사가 관사가 음내루 그 너머가뜨래서	그 전엔 사또가 앉았던 관사터가 이 지금도 이서 그래서 그기 이 거기 잇다가 이 읍내리루그 관사가 관사가 읍내리루 그 넘어갔드랬어
음내리루 너머간는데 음내루 가니깐 여기는 예도으비 데자나	읍내리로 넘어갔는데 읍내로 가니까 여기는 옛 도읍이 되잖아
그니께 고으비야 바루 옌날 읍 고음니라 마랴	그러니까 고읍이야 바로 옛날 읍 고읍리라 말야
그래서 고 예고짜가 부터이꾸	그래서 고고 자가 붙어 있고
이 동네 요동 이 동네는 거부꾸짜야	이 동네 요 동 이 동네는 거북 구 자야
게 고 구 거부꾸짜 예고짜에 거부꾸짜 고 고구린데 거부긴 왜 거부기라구 핸냐	게 고 구 거북 구짜고 자에 거북 구 자 고 고구리인데 거북이 왜 거북이라고 했냐
산 형체가 거북 형체루 생겨서	산 형체가 거북 형체로 생겼어
거북 형체루 생긴데 거부기 형체루 생긴 거이 산 하나마니 아니라 세 이게 삼개사니 세 세사니 거북 형체루 여기 생겨서	거북 형체로 생겼는데 거북이 형체로 생긴 게 산 하나만이 아니라 세 이게 세 개 산이 세세 산이 거북 형체로 여기 생겼어
여 생긴 거이 어디냐며는 바루 이 지금 위 우이 사니 쭉 나려가는 저 저리 가며는 에 저기가서 드레서 보며는 거부기 모냥으루 이러케 생기구	여기 생긴 게 어디냐면 바로 이 지금 위 위 산에 쭉 내려가넌 저 저리 가면 에 저기 가서들에서 보면 거북이 모양으로 이렇게 생기고
바루 이 들 복파네 사나나 이찌 그거이 또 거부기 형체루 생겨서	바로 이 들 복판에 산 하나 있지 그게 또 거북이 형체로 생겼어
이러케 생겨서 머리가서 요러케 생기구	이렇게 생겨서 머리가 요렇게 생기고
그니 거그이 거부기구 그 저수지 인는 데서 쭉 나려가먼 저 낭무루라구 하는 거기가 또 거북형체루 사니 생겨	그러니 거기가 거북이고 그 저수지 있는 데서 쭉 내려가면 저 낙무루라구 하는 거기가 또거북 형체로 산이 생겼어
기니간 그 거북 구짜를 따서 옏으비래는 거기두 고구리니께는 그 예고짜를 따고 여기 거부꾸짜를따구 해서 고구리래는 지명이 그러케 생긴 거야	그러니까 그 거북 구 자를 따서 옛 읍이라는 거기도 고구리니까 그고 자를 따고 여기거북 구 자를 따고 해서 고구리라는 지명이 그렇게 생긴 거야
그럼 이 마을 사람드른 주로 어떤 니를 하면서 사라요	그럼 이 마을 사람들은 주로 어떤 일을 하면서 살아요
농사지 이 교동은 대체가 농사지	농사지 이 교동은 대체가 농사지
교동 싸리 또 유명하니	교동 쌀이 또 유명하니
그럼다 다른 거 읍써 전부가 농사지	그럼다 다른 거 없어 전부 다 농사지
여기는 계나 이런 거처럼 혐녀카기 위애서 만든 모이미 이써요	여기는 계나 이런 것처럼 협력하기 위해서 만든 모임이 있어요
아유 지금 사람들 무진장 쩌그 무 다나비 만트라구	아유 지금 사람들 무진장 저 뭐 단합이 많더라고
뭐야 뭐냐 뭐 띠모임 뭐 나 나 그 띠모이믄 나이 모이미지 뭐 동창 무슨무슨 계모임	뭐야 뭐냐 뭐 띠모임 뭐 나 그 띠모임은 나이 모임이지 뭐 동창 무슨무슨 계모임
뭐 뭐 하에간 절믄 사람드른 이루 헤아릴 쑤 엄는 그 모이미 상당이 마나무청 마나 그거는	뭐 뭐 하여간 젊은 사람들은 이루 헤아릴 수 없는 그 모임이 상당히 많아무척 많아그거는
해주세요	예 해주세요
우리 교동이  이르미 마나	우리 교동이  이름이 많아
처째 고림 노플 고짜에 수풀 림짜 대운 다를씬 그리고 뭐냐 그러케 이르미 만코	첫째 고림 높을 고 자에 수풀 림 자 대운 달을신 그리고 뭐냐 그렇게 이름이 많고
예저네는 여기 교동에 상 상개며니 이서서 동면 서면 붕면	예전에는 여기 교동에 삼개면이 있었어 동면 서면 북면
삼개며 삼개며니 이서꼬 고 다메는 화개면 수정면 이개며니 이서꼬	삼개면이 있었고 그 다음에는 화개면 수정면 이개면이 있었고
그리다가 인제 교동으루 됀는데 그 당시에는 인제 저번날 얘기한 인제 광아군 교동며니 아니라교동구니거든 교동혀니거든	그러다가 이제 교동으로 됐는데 그 당시에는 이제 저번날 얘기한 이제 강화군 교동면이 아니라교동군이거든 교동현이거든
그그 저 그 뭐이 인하대하꾜에서 온 채게 아주 세밀하게 잘 나와이뜬데	그그 저 그 뭐 인하대학교에서 나온 책에 아주 세밀하게 잘 나와있던데
제가 해써써요 저 그때 와써꺼든뇨	제가 했었어요 저 그때 왔었거든요
그래가지구 혀 현가미 이서꼬 한데 이 교동이 아주 저러키니 현가므루 벼슬 군수루 나려온사라미 광아 본도보덤두 여기가 더 지끄비 게그비 노픈 사라미 와따구	그래가지고 혀 현감이 있었고 한데 이 교동이 아주 저렇게 현감으로 벼슬 군수로 내려온사람이 강화 본도보다도 여기가 더 직급이 계급이 높은 사람이 왔다고
근 왜그러냐 왜그러냐며는 여기에는 인제 사 삼군 삼도통어사가 이뜨래서	그 왜그러냐 왜그러냐면 여기에는 이제 사 삼군 삼도통어사가 있더랬어
삼도통어사는 뭐냐믄 충청도 경기도 황해도 요 삼도를 통어하는 통어사	삼도통어사는 뭐냐면 충청도 경기도 황해도 이 삼도를 통어하는 통어사
인제 수군절또사가 이꾸 수군절뚜산 인제 지금 마라자면 해군본부지	이제 수군절도사가 있고 수군절도사는 이제 지금 말하자면 해군본부지
여기 서해가 여기 이끼 때메	여기 서해가 있기 때문에
이러키 때메 그거슬 겸헐려니께는 직푸미 노픈 사라미 여기 나려오는 거지	이렇기 때문에 그것을 겸하려니까 직품이 높은 사람이 여기 내려오는 거지
그러케 인제 교동이란 데가 그러게 중요한 데구	그렇게 이제 교동이라는 데가 그렇게 중요한 데고
그저넨 여기가 이 아프루 이거이 전부 개 바단무리 들락때는 개꼴	그 전엔 여기가 이 앞으로 이게 전부 개 바닷물이 들락대는 갯골
개꼬리 여 저그서 이짜그루 뚤리구 이 중가네서 저리 저쪼그루 뚤리구	갯골이 여 저기서 이 쪽으로 뚫리고 이 중간에서 저리 저 쪽으로 뚫리고
그르껜 서미 세개가 되는 거 아냐 개꼬리 무리 미러들면 스미 세개가 되니 그래서 삼개며니  돼뜨래는 거구	그러니까 섬이 세 개가 되는 거 아냐 갯골에 물이 밀어들면 섬이 세 개가 되니 그래서 삼개면이됐더라는 거고
그리구 지금 주로 인제 할 얘기가 마는게 연산군 유배지	그리고 지금 주로 이제 할 얘기가 많은 게 연산군 유배지
연산군 유배진데 연산군 저 채게두 이찌 연산군 유배지를 세 군데를 인제 추츠글 한다 마랴	연산군 유배지인데 연산군 저 책에도 있지 연산군 유배지를 세 군데를 이제 추측을 한단말이야
하나는 음내리 하나는 저 봉소리 하나는 여기	하나는 읍내리 하나는 저 봉소리 하나는 여기
이러이 추츠글 허는데 요거 인제 지금 이 면장 지금 인는 면장 먼저 면장이 아주 거기 관심이상당히 마나뜨래서	이렇게 추측을 하는데 이거 이제 지금 이 면장 지금 있는 면장 먼저 면장이 아주 거기 관심이상당히 많았더랬어
해서 아주 인제 이 교동에 뭐뭐한 사람들 면사무소 면 현시레 수시로 뫼야 모여서 의논허구전부 결론 내구 헌 결과 어디다 자리를 정핸냐면 여 영산니 바로 요 우이 거기다 자릴 정하구	해서 아주 이제 이 교동에 뭐뭐한 사람들 면사무소 면 현실에 수시로 모여 모여서 의논하고전부 결론내고 한 결과 어디에다 자리를 정했냐면 여 영산리 바로 이 위 거기에다 자리를 정하고
비꺼지 연산저꺼지라고 유배지라고 비꺼지 인제 해다 거이 세워놘는데	비까지 연산적거지라고 유배지라고 비까지 이제 해다 거기 세워놨는데
그 사라미 그 성이 권간데 권태이린가 그 면장 이서스면 아마 그거이 돼슬껀데 그 사라미 가는바라메 비만 가따 시워노콘 그냥 방치해노쿠 말지	그 사람이 그 성이 권가인데 권태일인가 그 면장 있었으면 아마 그게 됐을 건데 그 사람이가는 바람에 비만 갖다 세워놓고는 그냥 방치해놓고 말지
이 교동이란 데가 이러케 유서기픈데	이 교동이라는 데가 이렇게 유서깊은데
행교는 또 뭐 어떠케 된냐먼 이 교동행교가 지금 나마닐때에 행교가 이백서른 이백스물세개행교가 이서	향교는 또 뭐 어떻게 됐냐면 이 교동향교가 지금 남한일대에 향교가 이백서른 이백스물세개향교가 있어
인는데 이 교동행교가 그 나만 일때 행교중에 젤 위쑤행교야	있는데 이 교동향교가 그 남한일대 향교 중에 제일 윗수향교야
나도 전교헐 때 인제 성균과네 올라가면 아우 위쑤행교 전교님 오셔따구 인제 거 거기서 그런다구	나도 전교할 때 이제 성균관에 올라가면 아우 윗수행교 전교님 오셨다고 이제 거 거기서 그런다고
근데 왜 위쑤가 뒌냐면 제일 먼저 이 행교가 언제 생견냐면 천구백이십팔련 이 고려 인종 오년오녀네 이 행교가 생겨서	그런데 왜 윗수가 됐냐면 제일 먼저 이 향교가 언제 생겼냐면 천구백이십팔년 이 고려 인종오년 오년에 이 향교가 생겼어
생겨가지구 그 인제 고 그리군 행교 생긴 멷 해 이따가 이 아뉴아냥 아냥이 이찌 이르미아냥이구 호는 이르미 아뉴고 호가 아냥이구나 그 사라미 저 거러키니 중구겔 건너가서	생겨가지고 그 이제 고 그리곤 향교 생긴 몇 해 있다가안유안향 안향이 있지 이름이안향이고 호는 이름이 안유고 호가 안향이구나 그 사람이 저 그렇게 중국에를 건너갔어
원나라 그때 원나라지	원나라 그때 원나라지
원나라에 근너가따가 공자니메 영정을 모시구 나오는데	원나라에 건너갔다가 공자님의 영정을 모시고 나오는데
지그믄 인제 뭐 배루두 댕 아이 거러키니 기차루두 댕기구 배 저 비행기루 댕기구 그러는데 그땐그런거이 웁쓰니께는 거찌 아느머는 배타고 물로 오는 거라 마리야	지금은 이제 뭐 배로도 나 아이 그렇게 기차로도 다니고 저 비행기로도 다니고 하는데 그땐그런게 없으니까는 걷지 않으면 배타고 물로 오는 거란 말이야
거기서 거러오니껜 힘드니껜 배타구 거그서 오며는 그땐 서우리 어딘냐며는 개성이란 마리야개경 고려때니껜	거기서 걸어오니까 힘드니까 배타고 거기서 오면 그땐 서울이 어딨냐며는 개성이란 말이야개경 고려 때니까
그니까 개경으루 개성으루 드러갈려 그르먼 일러리 와야된다 마리지	그러니까 개경으로 개성으로 들어가려 그러면 이리로 와야 된다 말이지
여기 교동에꺼지 와따가 어떠케보먼 그이 풍낭이 만난는지 피곤해선지 그 공자님 영정 모시고오든 배가 이 교동에 대 대서	여기 교동에까지 왔다가 어떻게 보면 그 풍랑을 만났는지 피곤해선지 그 공자님 영정 모시고오던 배가 이 교동에 댔어
교동에다 대구서 그리켄 그 교동이 대 대구나선 그 공자니메 영정을 배에다 모시기 그러니깐육찌루 인제 그 초마글 지꾸서 육찌에다 모셔놔따 실쿠선 개성으로 가따마리지	교동에대 대고서 그러니까 그 교동에 대 대고나서는 그 공자님의 영정을 배에다 모시기 그러니까육지로 이제 그 초막을 짓고서 육지에다 모셔놨다가 싣고선 개성으로 갔다 말이지
그래서 원나라에서 처음 오다가 교동에 기차글 해끼 때메 그래서 교동행교가 제일 먼저 공자님모시는 고시란 마리야 그리니케 나만 일때에 행교 중에 위쑤행교라고 허는 거지	그래서 원나라에서 처음 오다가 교동에 기착을 했기 때문에 그래서 교동향교가 제일 먼저공자님 모시는 곳이란 말이야 그러니까 남한일대의 향교 중에 윗수향교라고 하는 거지
그 행교가 인제 그 행교가 어디째냐먼 저 고음니 거이 관사터두 이 저수지 인는 저수지 인는동네가 고음 고으비거든	그 향교가 이제 그 향교가 어디께냐면 저 고읍리 그 관사터도 이 저수지 있는 동네가 고읍고읍이거든
고으 고읍 거기가 인제 관사터두 이꾸 거기서 요로게 건너보자멘 사네가 인제 행교터가 지구그게 구생교 구 구 행교터라 그르지	고으 고읍 거기가 이제 관사터도 있고 거기서 이렇게 건너보자면 산에가 이제 향교터가 지고그게 구향교 구 구 향교터라 그러지
그 행교터가 이꾸 거기 이따가 에 천칠백팔씨빌려네 그 한 오뱅년 뒌나 사뱅년 뒌나 그거기따가 음내리 지금 인는 행교루 글루 올마간 거야	그 향교터가 있고 거기 있다가 에 천칠백팔십일년에 그 한 오백년 됐나 사백년 됐나 그거기 있다가 읍내리 지금 있는 향교로 그리로 옮아간 거야
이 행교는 그런 교동행교가 그런 행교야	이 향교는 그런 교동향교가 그런 향교야
그걸 다 가추고 인는 향교두 며깨 업따구 드러써요	그걸 다 갖추고 있는 향교도 몇 개 없다고 들었어요
아냐 공잔님 영정은 다 가추고 이서	아냐 공자님 영정은 다 갖추고 있어
근데 거기서 직쩝 모셔온 잘몯 뜨런나	그런데 거기서 직접 모셔온 잘못 들었나
제기	제기
네 네	네 네
응 제 제 제기두 제기는 누가 가져완냐면 김문성이랜 사라미 아뉴 선생이 영정을 모셔오구 나서는그 후에 김문성이란 사라믈 원나라에다 보내서 원나라에서 제길 가져완는데 제기는 저 글러리가찌 교동엔 둔 건 아냐	응 제 제기도 제기는 누가 가져왔냐면 김문성이라는 사람이 안유 선생의 영정을 모셔오고나서는 그 후에 김문성이라는 사람을 원나라에다 보내서 원나라에서 제기를 가져왔는데 제기는저 그쪽으로 갔지 교동에 둔 건 아냐
에 그러며는 하라버지의 정보에 대해서 그 저글 껀데요	에 그러면 할아버지의 정보에 대해서 그 적을 건데요
하라버지에 그 정보를 여기에 저글 껀데요 즈 출쌩지가 어디세요	하라버지의 그 정보를 여기에 적을 건데요 저 출생지가 어디세요
내 출쌩지	내 출생지
우리 내 출쌩지가 지금 우리 저 하라버지가	우리 내 출생지가 지금 우리 저 할아버지가
고려 말려네  고 이 이싱게 씨가 인제 등그칼 때 고려 말려네 대사헌까지 지내신 하라버지여기 하라버지가 인제 고려 말기에 대사 그 고려 정꿔네 대사헌꺼지 지내신 하라버지가	고려 말년에  고 이 이성계 씨가 이제 등극할 떼 고려 말년에 대사헌까지 지내신 할아버지여기 할아버지가 이제 고려 말기에 대사 그 고려 정권에 대사헌까지 지내신 할아버지가
이싱게 씨가 이제 등그카면서 그 그니껜 왕씨가 무너지구 이씨가 등그컨 거 아냐	이성계 씨가 이제 등극하면서 그 그러니까 왕씨가 무너지고 이씨가 등극한 거 아냐
그 당시에 충시는 불싸이구니다 마랴	그 당시에 충신은 불사이군이다 말이야
어찌 내가 고려에 충시닌데 이씨에 또 그 조정이를 보겐냐 해가지구 그 당시에 이 교동으루나컁을 해오셔서	어찌 내가 고려의 충신인데 이씨에 또 그 조정일을 보겠냐 해서 그 당시에 이 교동으로 낙향을해오셨어
그니겐 내 대 내게 십꾸대 하라버지가 이 교동으루 오셔가지구	그러니까 내 대 내게 십구대 할아버지가 이 교동으로 오셔가지고
기니겐 나는 지금 이 교동에 오신 하라버지가 하라버지 이우로부터 이 여기 교동에 인는 게이심삼세꺼지 나려와서 이십삼 이시비대꺼지 나려와 이십사 삼대꺼지 나려와 이따 지금	그러니까 나는 지금 이 교동에 오신 할아버지가 할아버지 이후로부터 이 여기 교동에 있는게 이십삼대까지 내려와서 이십삼 이십이대까지 내려와 이십삼대까지 내려와 있다 지금
아아	아아
이러케 역싸가 교동에 아마 제일 터주때가미라구 허먼 전씨가 터주때가미라 하먼 바른말 될꺼야	이렇게 역사가 교동에 아마 제일 터줏대감이라고 하면 전씨가 터줏대감이라 하면 바른말 될거야
그러케 그러케 뿌리가 기퍼 여기가 교동에	그렇게 그렇게 뿌리가 깊어 여기가 교동에
그러면 여기 출생진 여기 고구리세요	그러면 여기 출생지는 여기 고구리세요
으응 고구리	으응 고구리
그러며는 이 조상분들도 계속 여기서 농사 지으면서 사신 거세요	그러면 이 조상분들도 계속 여기서 농사 지으면서 사신 거세요
그러치 농사 저찌	그렇지 농사 지었지
항녀근 어떠케 되세요	학력은 어떻게 되세요
항녀기래야 뭐 볼 꺼 인나 인제 그건 인제 그 당시에는 인제 내가 댕길 때는 왜정 츰 이짜어궁미나꾜라구 해가지구 궁미나꾜 좀 댕기다가	학력이래야 뭐 볼 거 있나 이제 그건 이제 그 당시에는 이제 내가 다닐 때는 왜정 처음 있잖아국민학교라고 해서 국민학교 좀 다니다가
여기 농어파꾜라고 이서가지고 농학 하꾜 쪼끔 한 일련 댕기다가 구악이나 쪼끔 일꾸 만 거지뭐	여기 농업학교라고 있어서 학교 학교 조금 한 일년 댕기다가 구학이나 조금 읽고 만 거지 뭐
허며는 군대 다녀오셔써요	그럼 군대 다녀오셨어요
그럼 군대 대녀 여그 여기 문패 모뽠나 구까유공자라구	그럼 군대 여기 문 못봤나 국가유공자라고
맞다맞다 그러면 어디로 다녀오셔써요	아 맞다맞다 그러면 어디로 다녀오셨어요
바루 전시야 유기오 때 그때 저 전쟁알 땅시야	바루 전시야 육이오 때 그 때 전쟁할 당시야
에 그 중부정 전선 금성 그마 그 그 전투에 중부전서네서 전투헌 거지	에 그 중부전 전선 금성 김화 그 그 전투에 중부전선에서 전투한 거지
그러며는 면녀니나 거기서 계셔써요	그러면 몇 년이나 거기서 계셨어요
면년 핸냐구	몇 년 했냐구
오십 칠개월	오십칠개월
오십 칠개월 우와	오십칠개월 우와
지그믄 뭐 이시빌개월 이시비개월 오십칠개 해쑤로 융년 해서 융년	지금은 뭐 이십일개월 이십이개월 오십칠개 햇수로 육년 했어 육년
어휴 그러며는 여기서 계속 농사 지으신 거세요	어휴 그러면 여기서 계속 농사 지으신 거세요
그 그럼 지금 가족 뿐드른 어트게	그럼 지금 가족 분들은 어떻게
가조근 아이드른 전부 인제 육찌루 나가이찌	가족은 아이들은 전부 이제 육지로 나가있지
크나드른 인제 서울서 고등아꾜 교사루 이꾸	큰아들은 이제 서울에서 고등학교 교사로 있고
나마지 아이드른 인천 인제 가인는데 한노믄 동사무소에 이꾸 한노믄 구청에 이꾸	나머지 아이들은 인천 가있는데 한놈은 동사무소에 있고 한놈은 구청에 있고
그러이 그러케 이찌 지그믄 게 전부 고 공지게  공지게 이서	그렇게 있지 지금은 그게 전부 고 공직에  공직에 있어
어어 성장과정은 다 끈나써요	어어 성장과정은 다 끝났어요
거 뭐 내 이력써를 부치는 거야 뭐야	거 뭐 내 이력서를 붙이는 거야 뭐야
이거는 제보자 조사표를 이러케 만드러야 돼서요 그래서 여기 간따나게 채우는 거예요	이거는 제보자 조사표를 이렇게 만들어야 돼서요 그래서 여기 간단하게 채우는 거예요
제가 저이가 어떤 하라버지한테 어떤 하라버지를 만나서 이런 말씀드를 조은 말씀드를 드러따라고증거할려고 우리가 가짜로 한 게 아니라 진짜 인는 사람 인는 하라버지를 가지구 조사를 한 거라구증거를 남겨놔야 돼서	제가 저희가 어떤 할아버지한테 어떤 할아버지를 만나서 이런 말씀들을 좋은 말씀들을 들었다라고 증거하려고 우리가 가짜로 한 게 아니라 진짜 있는 사람 있는 할아버지를 가지고 조사를한 거라고 증거를 남겨놔야 돼서
그러며는 이 마으레는 무슨 독트칸 특찡이나 자랑꺼리 가튼 게 이쓰세요 이 마을마네 특찡  가튼 거	그러면 이 마을에는 무슨 독특한 특징이나 자랑거리 같은 게 있으세요 이 마을만의 특징같은 거
어 우리 교동 우리 마을뿐마니 아니라 이 우리 교동으로서는 머 독트컨 자랑꺼리래는 건 으음별루 웁꾸	어 우리 교동 우리 마을 뿐만이 아니라 이 우리 교동으로서는 뭐 독특한 자랑거리라는 건음 별로 없고
자랑으루 내신대며는 에 공기조 공기 조쿠 물 조쿠	자랑으로 내세운다면 에 공기 조 공기 좋고 물 좋고
쌀 쌀	쌀 쌀
인심 조쿠	인심 좋고
에에 마자요	에에 맞아요
뭐 인시믄지그믄 인제 모두가 오염돼가지구 인젠 가튼 제 쌀롱살 진는다 해두 여기는아튼 아직 무리 오염데지 아나따 마랴 지금 저 육찌는 전부 오여미 데가지구 인제	뭐 인심은지금은 이제 모두가 오염되어서 이젠 같은 제 쌀농사를 짓는다 해도 여기는아직 물이 오염되지 않았다 말이야 지금 저 육지는 전부 오염이 되어가지고 이제
이 곡씩뚜 깨끄턴 물 드러간 거와 오염덴 물 드러가서 성장한 거이 그 그 차이가 만타구 허드만	이 곡식도 깨끗한 물 들어간 거와 오염된 물 들어가서 성장한 게 그 차이가 많다고 하더만
근데 여기는 아직뚜 무리 오염데지 아니껜 쌀만쿠믄 우리가 주로 식쌩화를 쌀만쿠믄 아마 교동싸리 제일 조타구 볼 수 이쓸꺼야	그런데 여기는 아직도 물이 오염되지 않으니까 쌀만큼은 우리가 주로 식생활을 쌀만큼은 아마교동쌀이 제일 좋다고 볼 수 있을 거야
뭐이 여러가지 인제 풍경이 교동에두 만치머는	뭐 여러가지 이제 풍경이 교동에도 많지만
마느 마는데 전쩌그루 다 트러볼 땐 아마 그 싸레 대해서는 제일 조타구 안 안전허구 사라메유리허다구 볼 쑤 이쓸 꺼야	많 많은데 전적으로 다 들어볼 땐 아마 그 쌀에 대해서는 제일 좋다고 안 안전하고 사람에유리하다고 볼 수 있을 거야
기니께 특찡이래머는 물 조코 공기 조코 인심 조코	그러니까 특징이라면 물 좋고 공기 좋고 인심 좋고
그 그러키 때메 우리 교동에 이런 얘기가 이서	그 그렇기 때문에 우리 교동에 이런 얘기가 있어
여기에 지 지그문 대충 교동을 다 알구 이찌마는	여기에 지 지금은 대충 교동을 다 알고 있지만
여 한 이삼심년 이저느로 거실러 올라가며는 여 공지그루 온 사람들 이따 마랴 인제 면사 면지궈느로 온대든지 지서지궈느로 온대든지	여 한 이삼십년 전으로 거슬러 올라가면 여기 공직으로 온 사람들이 있단 말야 이제 면사면직원으로 온다든지 지소 직원으로 온다든지
여기두 인제 전부 다 이 그 공청이 이시니께는 오는데 올 때는 다 울구 온대는 거야	여기도 이제 전부 다 이 그 공청이 있으니깐 오는데 올 때는 다 울고 온다는 거야
내가 이 서메가 나려와서 날 어뜨컬 지내냐 마리지	내가 이 섬에 내려와서 난 어떻게 지내냔 말이지
게 울고 와따 울고 가는 거시 교동이다 이거야	그게 울고 왔다 울고 가는 것이 교동이라 이거야
드롤 때 울고 나갈 때 울고	들어올 때 울고 나갈 때 울고
나갈 땐 왜 우냐 정드러시니까	나갈 땐 왜 우냐 정들었으니까
지금 오늘두 내 여기 인제 소포가 지금 와서 소포가 완는데	지금 오늘도 내 여기 이제 소포가 지금 왔어 소포가 왔는데
이 사라미 지금 저 안 저 그 경기도 안사네 안사네서 우체국짱으루 지금 인는 사라민데	이 사람이 지금 저 안 저 그 경기도 안산에 안산에서 우체국장으로 지금 있는 사람인데
여기 와따 간 지가 한 시보년 정도 돼찌	여기 왔다 간 지가 한 십오년 정도 됐지
와따 간 지가 시보년 됀는데	왔다 간 지가 십오년 됐는데
그 여기 올 땐 뭐 나하군 저녀 나 모루는 남나미지	그 여기 올 땐 나하고 전혀 남 모르는 남남이지
게 여기 오나가주구 나를 만 저 만나가주구 대와해 보니 배 허구 나서 나를 아버지라고	그게 여기 와서 나를 만나가지고 대화해보니 배 하고 나서 나를 아버지라고
아버지라구 허면서 그 극찐허게 여 여기 인제 지금 저기 우체국 인는 저기서 수시루 댕이먼서아버지 아버지	아버지라고 하면서 그 극진하게 여 여기 이제 지금 저기 우체국 있는 저기에서 수시로 다니면서아버지 아버지
내 이사람 보구 이거야 여보게 나거튼 사람 치내 봐야 자네 악끼레 도움 되는 거 이리 하나두업써	내가 이 사람 보고 뭐야 여보게 나 같은 사람 친해 봐야 자네 앞길에 도움될 거 일이 하나도없어
나가 뭐 자네 압끼를 무어 도우미 델 싸라민가 마리지 왜 그르냐 마리야	내가 뭐 자네 앞길을 무어 도움이 될 사람인가 말이지 왜 그러냐 말이야
아유 저는 도우믈 바라지 아느씀니다 마리지 아버지 인껴글 보구 아버지라구 함니다 마랴	아유 저는 도움을 바라지 않습니다 말이지 아버지 인격을 보고 아버지라고 합니다 말이야
게 여기서 떠난 지두 한 시 심녀니 너머서 한 시보년 데두	그게 여기서 떠난지도 한 십 십년이 넘었지 한 십오년 되어도
매번 이제 파뤌 추석 구정 이때는 이러케 소포루다 선무를 보내주는 거야	매번 이제 팔월 추석 구정 이 때는 이렇게 소포로다 선물을 보내주는 거야
이와 가치 올 때는 서글퍼서 울구 와따	이와 같이 올 때는 서글퍼서 울구 왔다
여그 와서 정에 겨 정을 부쳐가주구 떠나갈 땐 정을 몬니저섬 게 울구 와따 울고 가는 게 교동이다  마리지	여기 와서 정에 겨 정을 붙여가지고 떠나갈 땐 정을 못잊어 그게 울고 왔다 울고 가는 게교동이란 말이지
이런 얘기가 이서	이런 얘기가 있어
이 교동이란 그거시 특찡이라구 보면 특찡 될꺼야	이 교동이란 그것이 특징이라고 보면 특징 될 거야
또 특찡은 농사쌀 쌀 싸리 특찡이구	또 특징은 농사쌀 쌀 쌀이 특징이고
자랑꺼리두 이꾸 지금 이 교동 마으른 어르시니 어려쓸 때랑 비교할 때 어떻게 달라져써요	자랑거리도 있고 지금 이 교동 마을은 어르신이 어렸을 때랑 비교할 때 어떻게 달라졌어요
어터게 달라와따고	어떻게 달라왔다고
연뉵 이제 영뉴꾜도 인제 생기죠 다리 다리두 생기구 길두 뚤리구	연륙 연륙교도 이제 생기죠 다리 다리도 생기고 길도 뚫리고
예전과 지금 현재와 비교허래면 말두 모태	예전과 지금 현재와 비교하려면 말도 못해
아까두 얘기 해찌	아까도 얘기했지
겨울철 되머는 여기 배가 딱 매켜가지곤	겨울철 되면 여기 배가 딱 막혀가지고는
여기 인는 사람들끼리 그 무슨 물 물건 인제 대룡 대룡리라구 저 자네들 봐슬 거야	여기 있는 사람들끼리 그 무슨 무 물건 이제 대룡 대룡리라고 저 자네들 봤을 거야
그이 대롱리가 인제 고 가게들 이꾸 한껜 거기들 인제 사 상인드리 물건 좀 해다 논단 마랴	거기 대룡리가 이제 그 가게들 있고 하니까 거기들 이제 상인들이 물건 좀 해다 놓는단 말이야
그 물건 해단 고거 가지구 겨울 지내니께는 뭐 뭐든지 귀허먼 비싼 거 아냐 흐너면 싸구	그 물건 해선 그거 가지고 겨울 지내니까 뭐든지 귀하면 비싼 거 아냐 흔하면 싸고
게 거 물거니 고거바께 읍스니껜 거 머지 저 육찌에서는 머 시번짜리가트면 여기서는 처눤 처눠니라두 바들 수 인는 거지	게 거 물건이 그거밖에 없으니까 거 뭐지 저 육지에서는 뭐 십원짜리같으면 여기서는 천원천원이라도 받을 수 있는 거지
이러 이러케 돼꼬	이러 이렇게 됐고
이 지금 이 교동에 전기가 드러온 지가 한 이시벼녀니 돼찌	이 지금 이 교동에 전기가 들어온지가 한 이십여년이 됐지
그 인제 전기 드러오기 전까지는 여 호 호롱뿔 드 든잔뿔 요거 켜노코	그 이제 전기 들어오기 전까지는 여 호 호롱불 드 등잔불 이거 켜놓고
지금 비교허래야 비교되지 안는 거니 뭔 거니 그거도 그거지마는	지금 비교하래야 비교되지 않는 거니 뭔 거니 그것도 그거지만
옌나레는 우리 저우리 어려서가 아니라 우리 으른 뒈가지구 한 이십쌀 삼십쌀 돼서두	옛날에는 우리 저우리 어려서가 아니라 우리 어른 되어가지고 한 이십살 삼십살 되어서도
드레 나가서 인제 이런다 마랴 여름처레 이러구 밤 해가 어두워가주구 또 드러오며는	들에 나가서 이제 일한단 말야 여름철에 이러고 밤 해가 어두워가지고 또 들어오면
드러 드러와서 이게 발 거더 저 치우구서 방에 드러가머는 베룩	들어 들어와서 이게 발을 걷어 치우고서 방에 들어가면 벼룩
머 오세 이는 마랄 꺼뚜 읍꼬	뭐 옷에 이는 말할 것도 없고
벼 벼루기 다리에 새카마케 기어 올라와	벼 벼룩이 다리에 새카맣게 기어올라와
그 벼룩 뿌닌가 빈대는 을마나 마나	그 벼룩 뿐인가 빈대는 얼마나 많아
자네들 빈대 모를꺼야 아라	자네들 빈대 모를 거야 알아
빈대 모르지 허 비 빈대는 납짜커게 생겨서 납짜커이	빈대 모르지 허 비 빈대는 납작하게 생겼어 납작하게
피빠라멍는	피 빨아먹는
아이구 무진장 빠라머그먼 아파요 또	아이구 무진장 빨아먹으면 아파요 또
그게 이 지금 이러게 되베 해찌	그게 이 지금 이렇게 도배 했지
게 되베가 인나	그게 도배가 있나
그냥 흐그루다 이런 흑뼈기야 흑뼉	그냥 흙으로다 이런 흙벽이야 흙벽
흑뼈그루 발르니께니 흐기래는 건 터지자나 갈라지자나	흙벽으로 바르니까 흙이라는 건 터지잖아 갈라지잖아
갈라지니 그 새에 가 전부 드러가 끼여인는 거야 응	갈라지니 그 사이가 전부 들어가 끼여있는 거야 응
그래따 바미 되먼 거기서 나오나서 사람 드러가먼 사람 피 빠라멍는 거지	그랬다 밤이 되면 거기서 나와서 사람 들어가면 사람 피빨아먹는 거지
그러게 이 벼글 보머는 전부 빈대 가먼 손으로다 미지른다 마랴	그러게 이 벽을 보면 전부 빈대 가면 문지른다 말이야
게 미지르먼 사람 빠라머근 피가 이시겐 피가 쭉	그게 미지면 사람 빨아먹은 피가 있으니까 피가 쭉
바람뻬기 아니라 젠부 피투세이지	바람벽이 아니라 전부 피투성이지
베루기 그러치 오세는 이가 껴이찌	베루기 그렇지 옷에는 이가 껴있지
이루 헤아리지 모태	이루 헤아리지 못해
그래도 그 그 당시에 사람드른 그 그거 깨무는 주를 모르구 자서	그래도 그 그 당시에 사람들은 그 그거 깨무는 줄을 모르고 잤어
왜 잔냐 피고너니까	왜 잤냐 피곤하니까
지금 여기 아래 게 게이트볼장 이서 여기 훼관 인는 데	지금 여기 아래 게 게이트볼장 있어 여기 회관 있는 데
거기 저 가 나려가봐	거기 저 가 내려가 봐
절믄 여자드리 그 수두루커게 지금 메 메가지고 이 게트볼 친다 마랴	젊은 여자들이 그렇게 수두룩하게 지금 모 모여가지고 이 게이트볼 친단 말이야
옌나레 어디가 게이트보리 이꾸 뭐이 도 도라설 시가니 어디서	옛날에 어디가 게이트볼이 있고 뭐 이 도 돌아설 시간이 어딨어
저 나제 나와서 그냥 거 거 여긴 또 건파야	저 낮에 나와서 그냥 거 여긴 또 건파야
모두 모두 몬내	모도 모도 못내
모래는 건 모를 베씨를 이제 부어놔따가 그걸 뜨더다가 물론 쓰럭찔 해노콘 꼰는 거이 모구	모라는 건 모를 볍씨를 이제 부어놨다가 그걸 뜯어다가 물논 써레질 해놓고 꽂 게 모고
건파래는 건 마른 노늘 가라가지구 베씨를 거기다 뿌려	건파라는 건 마른 논을 갈아가지고 볍씨를 거기에다 뿌려
뿌려가지구 거기서 베 씨를 종자가 나오는 거지	뿌려가지고 거기서 벼 씨를 종자가 나오는 거지
그이 그거를 보고 산파 지그므루 얘기하면 산파라 그래 헤처서 나오니께	그게 그거를 보고 산파 지금으로 얘기하면 산파라 그래 헤쳐서 나오니까
이걸 봄내 허미를 가지구 대니면서 기믈 매는 거야 응	이걸 봄 내 호미를 가지고 다니면서 김을 매는 거야 응
그거기서 베씨만 나오나 김두 가치 나오지	그거기서 볍씨만 나오나 김도 같이 나오지
그러니게 그 잡초는 제거해줘야자나	그러게 그 잡초는 제거해 줘야잖아
그거 아마 노니랑이 여기서 저바할라꺼지 데먼 그거 기미 만케 되면 한견 내내 매 봐야 여기서저바할라까지 이랑은 요마난 푸믄 요마난 그거 한니랑바께 그니 이리 터가 나 안 터가 나지	그거 아마 논이랑 이 저밭까지 되면 그거 김이 많게 되면 한나절 내내 내 봐야 여기서 저밭까지이랑은 요만한 품은 요만한 그거 한 이랑 밖에 그러니 이리 표가 나 표가 안 나지
그러니겐 온 여름 내 그거 가지구 하지	그러니까 온 여름 내 그거 가지고 하지
저녀게 드러오면 뭘 해야 돼	저녁에 들어오면 뭘 해야 돼
방아 찌야 돼 방아	방아 쪄야 돼 방아
방안데 무슨 방아 쌀방아 거트먼 한결 나께 보리방아	방안데 무슨 방아 쌀방아 같으면 한결 낫게 보리방아
그 보리 보리를 방 보릴 찌어가지구 응 쩌야 바블 또께 해머그니께	그 보리 보리를 방 보리를 찌어가지고 응 쪄야 밥을 또 해먹으니까
싸리 어디가 이서 그러케 농사지어두 머글 싸리 부조캐	쌀이 어디 있어 그렇게 농사지어도 먹을 쌀이 부족해
그리게 이런 얘기가 인는 거야	그러게 이런 얘기가 있는 거야
따를 시지뽀낼려머는 조반석쭈기나 허는 지비냐 마리지	딸을 시집보내려면 조반석죽이나 하는 집이냔 말이지
아침빠베 저녁쭈기나 멍는 지비냐	아침 밥에 저녁 죽이나 먹는 집이냐
건 부자야	그건 부자야
아침빱 머꾸 저녀게 이 중 멍는 사라믄 건 부자야	아침밥 먹고 저녁에 이 죽 먹는 사람은 부자야
거 움는 사라믄 밤낟 아치미구 저녀기구 주 주 주기지	거 없는 사람은 밤낮 아침이고 저녁이고 주 죽이지
근데 죽뚜 무슨 주기야	그런데 죽도 무슨 죽이야
뭐 쌀주꺼튼거 그건 뭐 얼마나 마시께	뭐 쌀죽같은 거 그건 뭐 얼마나 맛있게
보리 가라서 보리마까리죽	보리 갈아서 보리 막갈이죽
밀 밀 밀 가라서 지금 밀까루들 파라다 먹 에 그런 거 가따 사서 인제 뭐야 만두두 해머꾸뭐 부 부치기두 해머꾸	밀 밀 갈아서 지금 밀가루들 사다 먹 에 그런 거 갖다 사서 이제 뭐야 만두도 해먹고 뭐부 부침개도 해 먹고
가루가 어디서 그냥 마까리야 마까리	가루가 어딨어 그냥 막갈이야 막갈이
밀 그냥  그럼 이 매루다 가는 거야 매루	밀 그냥  그럼 이 매로 가는 거야 매로
지그문 기계루다 갈구 허지만 매루다 이러 가라가지구 그거루다가 수제비라구 인제 국수가 어디서수제비라구	지금은 기계로다 갈고 하지만 매로 이렇게 갈아가지고 그걸로 수제비라고 이제 국수가 어디있어
고거 반죽 꺼풀꺼지 해서 반주캐가지구 물 끄린 데다 이제 쯔 쯔저너가지구 그거뚜 잘 멍는거야	그거 반죽 꺼풀까지 해서 반죽해가지고 물 끓인 데다 찌 찢어 넣어가지고 그것도 잘 먹는거야
이러케 해 오구	이렇게 해 오고
오시랜 건 뭐냐	옷이라는 건 뭐냐
그전과 지금 얘 비교해서 얘길 해니겐 오시랜 건 뭐냐	그 전과 지금을 얘 비교해서 얘기를 하니까 옷이란 건 뭐냐
무녕 무 무녕으루 맨든 바지저고리	무명 무 무명으로 만든 바지 저고리
그러차느먼 베 여르멘 베적쌈	그렇지 않으면 베 여름엔 베적삼
베라구 삼베라구 여기 마니 시머뜨래서	베라고 삼베라고 여기 많이 심었더랬어
에이 그거시 지금 대마야 대마  대마 대마야 그거이 사미	에이 그게 지금 대마야 대마  대마 대마야 그게 삼이
이 지금  베 베오 베옫 베오뜰 입짜나 베옫	이 지금  베 베오 베옷을 입잖아 베옷
거 사람 저 주그먼 시신 이게 감는 거이 베루다 감짜나	거 사람 저 죽으면 시신 이게 감는 게 베로 감잖아
그 베 베에 그 재료가 대마야 대마	그 베 베에 그 재료가 대마야 대마
근데 왜 그때 대마 대마 그 대마 풀리파릴 담밸 안머근지 몰라	그런데 왜 그때 대마 대마 그 대마 풀이파리를 담배를 안 먹은지 몰라
집찜마다 무진장 해신께는	집집마다 무진장 했으니깐
게 그거 그걸 그걸 하는데 하며는 이를 무지 옌날 할머니들 쪼꼼 도라서문 오주미나 누라도라슬까 똥이나 누라 도라슬까 도라슬 새가 웁서	게 그걸 그건데 하면 일을 무지 옛날 할머니들 조금 돌아서면 오줌이나 누러 돌아설까똥이나 누러 돌아설까 돌아설 새가 없어
잠두 별루 몯 게 김매구 들와서 이 보리방아 찌여서 어쩌구 해서 응	잠도 별로 못 게 김 매고 돌아와서 이 보리방아 찧어서 어쩌고 해서 응
허지아이들 또 이 떠러진 오쫌 꼬매구 이러면 잠잘 시가니 어디서 잠도	하지아이들 또 이 떨어진 옷 좀 꼬매고 이러면 잠잘 시간이 어딨어 잠도
잠두 자는 둥 마는 둥 이 이러커는 거지	잠도 자는 둥 마는 둥 이 이렇게 하는 거지
그런 판구게 서딸 그뭄 인제 요 을마 안 나마서 구정이 도라오자나	그런 판국에 섣달 그믐 이제 안 나마서 구정이 돌아오잖아
서딸 그뭄메 되머는	섣달그뭄에 되면
그래두 오시라도 빠라이버야 하자나 히끄머게	그래도 옷이라도 빨아 입어야 하잖아 희끔하게
빠라이블려면 이 벅 벅꾸 이블 오시 업써	빨아 입으려면 버 벗고 입을 옷이 없어
그 광목 바지저고리두	그 광목 바지저고리도
그니껜 헐 수 없이 버 버서서 빨라구 허군 오시 웁서서 입구 나갈 수가 웁스니께는	그러니까 할 수 없이 버 벗어서 빨라고 하곤 옷이 없어서 입고 나갈 수가 없으니깐
또 포대기 인제 둘러쓰고 아랜모케 안저 그 말 말 온 마를 때까지는 그냥 포대기 둘러 쓰고인는 거야	또 포대기 이제 둘러쓰고 아랫목에 앉아 그 말 말 옷 마를 때까지는 그냥 포대기 두꺼워쓰고 있는 거야이와 가치 지내 완는데 지금 이 시댄 어드레이와 같이 지내 왔는데 지금 이 시댄 어때
하유 진짜 아까 얘기해찌만 헐리리 읍서	하유 진짜 아까 얘기했지만 할 일이 없어
기니껜 와서 이제 게이트볼 치는 게 치 치다가 또 그거 뿌니야	그러니까 와서 이제 게이트볼 치는 게 치 치다가 또 그것 뿐이야
야 우 우리 점슴 시켜 먹자 밥뚜 아내	야 우 우리 점심 시켜먹자 밥도 안해
아 저 저놔 한 통여기 뭐쫌 가줘와 봐 하면 아이 가따 대령해주는데 응	아 전 전화 한 통여기 뭐좀 가져와봐 하면 아이 갖다 대령해주는데 응
신선 중에두 이런 신서니 윽꾸	신선 중에도 이런 신선이 없고
근데 이거시 다 왜 그러냐	그런데 이것이 다 왜 그러냐
옌나렌 왜 그러코 지그믄 왜 이러냐	옛날엔 왜 그렇고 지금은 왜 이러냐
이거이 사라미 잘라서 이러는 거 아니야 지금	이게 사람이 잘나서 이러는 거 아니야 지금
뭐 머리가 조아서 과하이 발딸대가지구 그거뚜 이찌	뭐 머리가 좋아서 과학이 발달 돼가지고 그것도 있지
허지만 사라미 머리 조은 거뚜 내 마음대루 조아지는 거이 아니여	하지만 사람이 머리 좋은 것도 내 마음대로 좋아지는 게 아니야
사라미랜 건 천지 도쑤 천지 기 기쑤 천지 기쑤 도라가는 대루 움지기는 거이 사라미거든	사람이라는 건 천지 도수 천지 기 기수 돌아가는 대로 움직이는 게 사람이거든
내 저 지금 이제 자 장년꺼지 인제 요 이 지금 광아 노인 복지 광아에 노인 복지 회관 이싱까는	내 저 지금 이제 자 작년까지도 이제 여기 지금 강화 노인 복지 강화에 노인 복지 회관 있으니까
거기 인제 거기에는 지훼 지훼구 여기 며네는 분훼구 이러케 뒈 인는 거기 이제 노인들 노인대하기 이서 대하궈니 이꾸	거기 이제 지회 지회고 여기 면에는 분회 분회고 이렇게 돼 있는 거기 노인 대학이 있어대학원이 있고
거기 인제 강의좀 해달라구 해니 강사루 인제 한 삼년 인제 대하해 대하권 강의도 내 해 줘찌마는	거기 이제 강의 좀 해달라고 그러나 강사로 이제 한 삼 년 이제 대학교 대학원 강의도 내 해줬지만
사라미 이제 지금 이 살기 조은 시대 된 거뚜 천지 기쑤에 의해서 우리가 이렇게 지 지금 살기좋지 아프로 더 조아저	사람이 이제 지금 이 살기 좋은 시대 된 것도 천지 기수에 의해서 우리가 이렇게 지 지금  살기 좋지 앞으로 더 좋아져
응 그리고 여성 상위 시대야	응 그리고 여성 상위 시대야
아니 우찌 마라	아니 웃지 마
여자가 잘라서 그런 줄 아라 에이	여자가 잘나서 그런 줄 알아 에이
천지 기우니 그렇게 도라가	천지 기운이 그렇게 돌아가
여자쪼그로 이케 도라오는 거에요 기우니	여자 쪽으로 이렇게 돌아오는 거예요 기운이
그 얘길 해주까 그러만 이거 시가니 그르케 인나	얘기를 해줄까 그러면 이거 시간이 그렇게 있나
하루에다 비춰서 얘기허께	하루에다 비춰서 얘기할게
하 예를 드러서 얘기하는 거야 하루야	하 예를 들어서 얘기하는 거야 하루야
하루는 이십사시가니 아냐 고 지지로 얘기허면 시비지야	하루는 이십사시간이 아냐 그 지지로 얘기하면 십이지야
지지가 뭐냐 자추긴묘 진사 허는 거 이짜나 고거 열뚜리거든	지지가 뭐냐 자축인묘진사 하는 거 있잖아 그거 열둘이거든
자 추 긴 묘 진 사 오 미 신 유 술 해 요거이 시비지야	자축인묘진사오미신유술해 요게 십이지야
고 그거시 뭐냐먼 요거시 시가니야	그 그것이 뭐냐면 요것이 시간이야
시간두 데구 연두 데구 응	시간도 되고 연도 되고 응
여니라먼 오래가 인제 장녀네 경인녀니고 오래 신묘년 아냐	연이라면 올해가 이제 장년에 경인년이고 올해가 신묘년 아냐
고 고거 자추긴묘로 나가는 거야 인 묘	그 그거 자축인묘로 나가는 거야
작녀네 인 인녀니께는 오래는 묘년 아냐 장년 범띠 오랜 토끼띠	작년에 이 인년이니까 올해는 묘년 아냐 작년 범띠 올핸 토끼띠
그래 고거시 그 시 고 시비지루 나가는 거야 그거이	그래 그것이 그 시 그 십이지로 나가는 거야 그게
나가는데 그이 하루에 네번 벼놔 이짜나 아침 점슴 저녁 밤	나가는데 그 하루에 네 번 변화 있잖아 아침 점심 저녁 밤
거이 요거이 네번 벼놔하는데 이십 사시간 아네 요거시 네번 벼놔가 드러이따 마랴	그게 이게 네 번 변화하는데 이십사시간 안에 이것이 네 번 변화가 들어있단 말이야
그 지지루 얘기하면 시비지지 두 시가니 한 지니께는 요 시간 내에 네번 벼놔 인는데	그 지지로 얘기하면 십이지지 두 시간이 한 지니까 요 시간 내에 네 번 변화 있는데
아치메는 해가 불끈 동쪼게서 뜨자나 뜨머는 해 그냥 시뻘거케 해가주구 크게 떠오르자나	아침에는 해가 불끈 동쪽에서 뜨잖아 뜨면 해 그냥 시뻘겋게 해가지고 크게 떠오르잖아
그 해는 여기서 떠가지구 열뚜시가늘 이건 거러갈 응 기하늘 두구서 떠오르는 해라 마랴	그 해는 여기서 떠가지고 열두시간을 이건 걸어갈 응 기한을 두고서 떠오르는 해란 말이야
그니 여기서 히미 이서야 거까지 갈 꺼 아냐 거러갈 꺼 아냐	그러니 여기서 힘이 있어야 거기까지 갈 거 아니야 걸어갈 거 아니야
껜 여기서 히미 불끈 올라오는 거지	그러니까 여기서 힘이 불끈 올라오는 거지
건 해 해는 양이거든	그건 해 해는 양이거든
그니게 발 그이 으먕이야 으먕 으먕이랜 거 만치	그러니 발 그게 음양이야 음양 음양이라는 거 많지
남녀두 응 남자두 남잔 양이구 여잔 으미구	남녀도 응 남자두 남자는 양이고 여자는 음이고
하누른 양이구 땅은 으 저이 으미구	하늘은 양이고 땅은 으 저기 음이고
해는 양이구 다른 으미구	해는 양이고 달은 음이고
이 으먕이 업스머는 조화가 업서	이 음양이 없으면 조화가 없어
그르차나 사람도 으먕이 하패져야 거기서 응 후소니 나오구 허지	그렇잖아 사람도 음양이 합해져야 거기서 응 후손이 나오고 하지
도걍으루서 자손 모뚜고 도금으로서 자손 모뚜다 마랴	독양으로서 자손 못 두고 독음으로서 자손 못 둔다 말이야
으먕이 하패 지는 가운데서 여기서 조와가 나오는 거라 마랴	음양이 합해지는 가운데서 여기서 조화가 나오는 거라 말이야
그이 그 해가 불끈 소사오를 땐 야 양이 새로 나오껜 시미 마아서 어려	그 해가 불끈 솟아오를 땐 야 양이 새로 나오니까 힘이 많으면서 어려
그르먼 그 그 당시에 해가 뽈깍 올라오먼 이 그 서서보먼 그림자 저마쿰 멀리 가 이꺼든	그러면 그 그당시에 해가 뽈깍 올라오면 이 그 서서 보면 그림자 저만큼 멀리 가있거든
그이 뭐냐 그 그느른 으미라구 해짜나	그이 뭐냐 그 그늘은 음이라고 했잖아
그럼 으믄 뭐냐 해는 뭐구 그느른 뭐냐 해는 남자 이 그림자는 여자 으먕이야 그거뚜	그러면 음은 뭐냐 해는 뭐고 그늘은 뭐냐 해는 남자 이 그림자는 여자 음양이야 그것도
겐 으미 왜 그러케 길 그림자는 왜 그러케 기냐 으믄 늘거따 마랴 늘그니까 커	그러니까 음이 왜 그렇게 길 그림자는 왜그렇게 기냐 음은 늙었단 말이야 늙으니까 커
거 왜 크냐 밤새드락 어둔 바믈 거쳐 와스니껜 으미 자랄 때루 이마큼 자라찌 그니께 크지	거 왜 크냐 밤새도록 어든 밤을 거쳐 왔으니까 음이 자랄대로 이만큼 자랐지 그러니까 크지
해는 불끈 소사오니껜 이건 첨 나오니껜 점찌	해는 불끈 솟아오니까 이건 처음 나오니까 젊지
그래서 이 옌나레는 겨로늘 남녀가 겨로늘 헐 때두 남자는 나이가 어리구 여자는 나이가 마나	그래서 이 옛날에는 결혼을 남녀가 결혼을 할 때도 남자는 나이가 어리고 여자는 나이가 많아
흐니 시고레서 더 마나 왜 실랑은 나이 한 열서너살 뒈면 장개 보내	흔히 시골에서 더 많아 왜 신랑은 나이 한 열서너살 되면 장가 보내
그리니 신부는 나이 몬 머거두 한 여릴 여릴곱쌀 머거야 시지본단 마랴	그 신부는 나이 못먹어도 한 열일 열일곱살 먹어야 시집온단 말이야
그 농초네선 또 그런 메누릴 어더야 이를 시켜먹구 그러는데열 둬서너 짜릴 디려다 무슨이를 시켜머글 수 인나	그 농촌에서는 또 그런 며느릴 얻어야 일을 시켜먹거든열두어살 짜리를 들여다 무슨 일을시켜먹을 수 있나
이를 시킬 수도 인는 거고 그나 그거슨 일 때미 아니라 천지 기우니 그러케 간 거지	일을 시킬 수도 있는 거고 그러나 그건 일 때문이 아니라 천지 기운이 그렇게 간 거지
그리만 이 해가 동쪼게만 우두커니 안자 인는 게 아니라 요 차츰차츰 올라오거든	그러면 이 해가 동쪽에만 우두커니 앉아있는 게 아니라 이 차츰차츰 올라오거든
올라오머니 정오가 돼서 정 나지 돼따구 열뚜시가 돼따구	올라오니 정오가 됐어 정 낮이 됐다고 열두시가 됐다고
열뚜시에 이러케 보머는 내 그림자가 내 미테 이짜나 저리 가지두 안쿠 이리저리 가지두 안쿠그땐 정음정양이야	열두시에 이렇게 보면 내 그림자가 내 밑에 있잖아 저리 가지도 않고 이리 가지도 않고 그땐정음정양이야
남자 궈나니나 여 그이 아침 나제는 양 양에 게 어음저냥이야 여자는 남자이 심부름꾼바께안된다 마랴	남자 권한이나 여 그 아침나절에는 양 양에 그게 어음전향이야 여자는 남자의 심부름꾼밖에안된다 말야
그르차나 남존녀비라구 해가지구 아주 아이 여자가 뭐 어디 댕길려면 그냥 얼굴 이러케 쓰구눈 하나 요러구 내노구 이러케 댕기지 아난냐 마리야	그렇잖아 남존여비라고 해가지고 아주 아이 여자가 뭐 어디 다니려면 그냥 얼굴 이렇게 쓰고눈 하나 이러고 내놓고 이렇게 다니지 않았냐 말이야
그게 여자는 체며니 업찌 머 남자 주장이지	그게 여자는 체면이 없지 뭐 남자 주장이지
그르니 남자는 그냥 뭐 첩뚜 으꾸 소실두 으꾸 뭐 심지어는 임금 노르터먼 삼천 궁녀가 이꾸	그러니 남자는 그냥 뭐 첩도 얻고 소실도 얻고 뭐 심지어는 임금 노릇하면 삼천 궁녀가 있고
남자 세워리라 마랴	남자 세월이란 말이야
그러다 여 딱 오며는 정음정양이야 양 하나하나	그러다가 여 딱 오면 정음정양야 양 하나하나
게 남녀 동등꿘 평등꿔니 나오는 거지 남자 권 궈나니나 여자 권나니나 또까치 대는 거지	게 남녀 동등권 평등권이 나오는 거지 남자 권 권한이나 여자 권한이나 똑같이 되는 거지
그리니가 나중에 지금 해가 서쪼그루 사짝 기우러저	그러니까 나중에 지금 해가 서족으로 살짝 기울어져
그르먼 이 해는 인저 질 시가니 가까워찌 온 시간보덤 질 시가니 가까워저	그러면 이 해는 이제 질 시간이 가까웠지 온 시간보다 질 시간이 가까워져
야 양에 이 해는 히미 쭈그러져드러가	양 양의 이 해는 힘이 쭈그러져 들어가
근데 으믄 성하거든 왜 저녁날래지 드러가니까는 저녀겐 으미 성하다	그런데 음은 성하거든 왜 저녁 나절에 들어가니깐 저녁에는 음이 성하다
그러키 때무네 지그믄 호니늘 해봐 실랑은 나이가 망쿠 신부는 나이가 어리구	그렇기 때문에 지금은 혼인을 해봐 신랑은 나이가 많고 신부는 나이가 어리고
천지 이치래는 건 다 그런데 이 사라믄 왜 그러냐며는	천지 이치라는 건 다 그런데 이 사람은 왜 그러냐면
우리는 우리 농초네서 볼 때는 인제 여기 농사지꾸 허는 사라믄 일려네 농사를 진는 거 이제곡씩까지구 지꾸 인제 무슨 과일거튼 거 하는 사라믄 과일 지꾸 이러지머는	우리는 우리 농촌에서 볼 때는 이제 여기 농사짓고 하는 사람은 일년에 농사를 짓는 거 이제곡식 가지고 짓고 이제 무슨 과일같은 거 하는 사람은 과일 짓고 그러지만
천지에 천지에 농사는 사람 사라믈 가지구 농사 진는 거야 사람농사 진는 거야 천지는	천지의 천지의 농사는 사람 사람을 가지고 농사 짓는 거야 사람농사 짓는 거야 천지는
그래 천지 이치는 호호창창해서 너무 광버미해서 사라미 누느로다 볼래면 뵈질 안는대는 거지	그래 천지 이치는 호호창창해서 너무 광범위해서 사람의 눈으로다 보려면 보이질 않는다는거지
안는데 사람 움지기는 걸 보면 안대는 거야천지 도쑤가 어디때 와따	않는데 사람 움직이는 걸 보면 안대는 거야천지 도수가 어디쯤 왔다
게 사라믈 일커러서 천지 동 사람두 일쫑에 동무리거든 그러차나 움직이껜 동무리야	그게 사람을 일컬어서 천지 동 사람도 일종의 동물이거든 그렇잖아 움직이니까 동물이야
동무린데 천지에 대표무른 사라미래는 거야	동물인데 천지의 대표물은 사람이라는 거야
그런데 지금 하루에 얘기해찌먼 일려늘 비춰보자구 우리	그런데 지금 하루에 얘기했지만 일년을 비춰보자고 우리
일려늘 비추며는 일려는 열뚜달 시비지 열뚜다리구 삼뱅뉴씨빌 음녀그루 삼뱅뉴씨비리구 양려근삼뱅뉴씨보이리라 마랴	일년을 비추면 일년은 열두달 십이 열두달이고 삼백육십일 음력으로 삼백육십일이고 양력은삼백육십오일이라 말이야
요 요 가운덴 네번 벼놔가 이짜나 봄 여름 가을 겨울	이 이 가운데엔 네 번 변화가 있짢아 봄 여름 가을 겨울
하루에는 이십사시가네 네번 벼놔 인는데 일려는 삼뱅뉴씨비리 네번 벼놔가 이따 마리야	하루에는 이십사시간에 네변 변하는데 일년은 삼백육십일이 네 번 변화가 있단 말이야
근 보메 허는 일 따루 이꾸 여르메 허는 일 따루 이꾸 가으레 허는 일 따루 이꾸 겨우레 허는일 거 철마다 허는 이리 따루 이따 마리지	그 봄에 하는 일 따로 있고 여름에 하는 일 따로 있고 가을에 하는 일 따로 있고 겨울에하는 일 거 철마다 하는 일이 따로 있단 말이지
그러기 때메 지금 말쎄다 말쎄다 마리야 이런 얘기드를 마니 허구 지금 선처는 가구 후처니다마리지 이런 얘기를 인제 마니들 허는데	그렇기 때문에 지금 말세다 말세다 말이야 이런 얘기들을 많이 하고 이건 선천이다 후천이다말이지 이런 얘기를 이제 많이들 하는데
후처는 뭐냐 선천과 후처는 뭘 가지고 선천과 후처늘 가련느냐	후천은 뭐냐 선천과 후천은 뭘 가지고 선천과 후천을 가렸냐
봄 여르믄 선처니구 가을 겨우른 후처니라구 한다 마랴	봄 여름은 선천이고 가을 겨울은 후천이라고 한단 말이야
근데 지금 아까 이제 점슴때가 지나서 해가 서쪼그루 기우러져따 그래찌	그런데 지금 아까 이제 점심때가 지나서 해가 서쪽으로 기울어졌다 그랬지
그거이 그기 뭐 뭐냐먼	그게 그게 뭐냐면
우리 할머이야	우리 할머니야
그이 뭐냐 뭐냐머는 봄 여름 요거 선처닌데 아침나절 즘슴나절 이거이 선처니구 오후와 바믄이제 후처니랜데	그게 뭐냐면 봄 여름 이거 선천인데 아침나절 점심나절 이게 선천이고 오후와 밤은 이제 후천이라는데
해가 서쪼그루 살짝 기우러지니께는 후천	해가 서쪽으로 살짝 기울어지니까는 후천
이제 대학생드리 와서 뭐 그대루 얘기를 허는 거야	이제 대학생들이 왔어 뭐 그대로 얘기를 하는 거야
바쁘먼 이제 고만 허구	바쁘면 이제 그만 하고
이거스루 미루어 볼 때 옌나레다 지금 가따 댈 그거시가 안 데	이것으로 미루어 볼 때 옛날에다 지금 갖다 댈 그것이 안 돼
아까 교동 얘기허다 마라찌만 그 그때는 그러케 인제 그니껜 옌나렌 여기선 그판 병나면 그냥죽 중는 거바께 업써	아까 교동 얘기하다 말았지만 그 그때는 그렇게 이제 그러니까 옛날에는 여기선 급한 병 나면그냥 죽는 것밖에 없어
병워네 가야 갈 시가니 인나	병원에 갈래야 갈 시간이 있나
근데 지그믄 이 예뽀다 살기 조아지 수시루 가니께는 전기뿔 드러와찌 이제 여기 여기두 인천서울 부럽찌 아나	그런데 지금은 이 옛보다 살기 좋아지 수시로 가니깐 전깃불 들어왔지 이제 여기도 인천서울부럽지 않아
이 도시 부럽찌 안타구 외려 도시싸람들보덤 펴나내	이 도시 부럽지 않다고 오히려 도시사람들보다 편안해
여름처렌 농사 지 농사 진는 거 어유 농사두 인제 드러눠 지여 드러눠 노 노네 드러가서 진는게 아니라 방아네 드러눠 지여	여름철엔 농사 지 농사 짓는 거 어유 농사도 인제 드러누워서 지어 드러누워서 노 논에들어가서 짓는 게 아니라 방안에 드러누워서 지어
왜 돈만 주면 돼 돈만	왜 돈만 주면 돼 돈만
거 논 가는 거 돈 주께 오나 가라	그거 논 가는 거 돈 줄께 와서 갈아
거 노타리 놔 노타린 쓰럭찔 하는 거야	거기 로타리 놔 로타리는 써레질 하는 거야
아이 그래두 가르켜 줘야지 이걸 이걸 알기 위해서 오신 거니께는	아이 그래도 가르켜 줘야지 이걸 이걸 알기 위해서 오신 거니깐
그이 베 베 비 베 벼	그 벼 벼 베
베 비는 건 돈 주먼 와서 다 벼서 가따 말려서 쌀루 찌어까지 주는데	벼 베는 건 돈 주면 와서 다 베어서 갖다 말려서 쌀로 찧어까지 주는데
김 매 아깐 저 산파 여 김 맨다 해찌 무슨 기믈 매 약싸다가 훌훌 이러케 뿌려뻐리먼 그거루끈나뻐리구	김매 아깐 저 산파 여 김맨다 그랬지 무슨 김을 매 약사다가 훌훌 이렇게 뿌려버리면 그거끝나버리고
에이려 지금 농촌 싸라미 도시 사는 사라믄 그 월급 쫌 바들려면 나미 고용사리 하다시피 가서일허구 아치메 나가따 저녀게 느께 퇴그너구 허지만 여기 싸람 내 지바네 가마니 드러눠서 농사진는 거야	오히려 지금 농촌 사람이 도시사는 사람은 그 월급 좀 받으려면 남의 고용살이 하다시피 가서일하고 아침에 나갔다 저녁에 늦게 퇴근하고 하지만 여기 사람 내 집에 가만히 드러누워 농사짓는 거야
바패 여자들 바패 밥 아내	밥해 여자들 밥해 밥 안해
허유 펴나 펴나나기 짝 바블 해 뭐래뭐 무슨 이래 저 대룡리 나가 가서 음식 뭐라는거야 음식	아이구 편안 편안하기 짝 밥을 해먹으래뭐 무슨 이래 저 대룡리 나가 가서 음식뭘 하는 거야 음식
옌나레는 그노무거 이러며는 지비서 그거 보리방아 찌어가지구 바블 해서 뭐 금치에 국쫌 맨드러가지구 여자들 참 고생 만치	옛날에는 일하면 집에서 그거 보리방아 찧어가지고 밥을 해서 뭐 김치에 국 좀 만들어가지고여자들 참 고생 많지
그면 지금 안 그래 아이 저 해 저러케 해다주는 거 머꾸 돈만 내밀만 만사는 끋 해결되는건데 뭐를 고생을 하나	그러면 지금 안 그래 아이 저 해 저렇게 해다주는 거 먹고 돈만 내밀면 만사는 끝 해결되는건데 뭐를 고생을 하나
자네들 조은 세상에 태나서 아프로 더 조아질텐데	자네들 좋은 세상에 태어났어 앞으로 더 좋아질 텐데
네에	네
그러면 오늘 지금 할머니두 오셔쓰니까 쫌 쉬시구 저히 내일 차자밸께요 오느른	그럼 오늘 지금 할머니도 오셨으니까 좀 쉬시고 저희 내일 찾아뵐게요 오늘은
그러케 해 응	그렇게 해 응
하라버님 저이 할머님두 봬짜나요	할아버님 저희 할머님도 뵈었잖아요
할머니믄 어디서 나셔써요 할머님도 교동에서 나셔써요	할머님은 어디서 나셨어요 할머님도 교동에서 나셨어요
교동면 동산니  응	교동면 동산리  응
동산니라고 저쪼게서 이서	동산리라고 저 쪽에서 있어
무항니는 이쪼기고	무학리는 이 쪽이고
동산니는 이쪼기고 저 저이 산 뵈자나 고 거 너머똥네	동산리는 이쪽이고 저 저기 산 보이잖아 그 건너 동네
거기구나 동산니에 사셔꾸나 금 동산니에서 어뜨케 여기 고구리까지 시지보셔써요	거기구나 동산리에 사셨구나 그럼 동산리에서 어떻게 여기 고구리까지 시집오셨어요
어 그때는 지그믄 여내지마는 중매야	어 그때는 지금은 연애지마는 중매야
그 아는 사라미 인제 소개가 소개해 가지구 중매	그 아는 사람이 이제 소개가 소개해가지고 중매
그 지그믄 여내애서 밤나지 만나지만 겨로날 때꺼지 여 색씨 얼굴 함번두 모뽜서	그 지금은 연애해서 밤낮으로 만나지만 결혼할 때까지 여 색시 얼굴 한 번도 못 봤어
야콘 그니껜 지그문 이제 야코니라 그르지 그땐 사주 보낸다고 해	약혼 그러니까 지금은 이제 약혼이라 그러지 그땐 사주 보낸다고 해
에 실랑찌비선 신부찌브루 사주 사주딴자는 실랑에 생년워리를 적꾸 신부의 이제 저고리나치마깜 하나 이게 해서 거기다 에 실랑의 생년워릴 해서 그걸 보내는 걸 사주 보낸다구래	에 신랑집에서 신부집으로 사주 사주단자는 신랑의 생년월일을 적고 신부의 이제 저고리나치맛감 하나 이게 해서 거기에다 에 신랑의 생년월일 해서 그걸 보내는 걸 사주 보낸다고해
사주가 뭐냐먼 네 귀둥이야  연 월 일 시 요 니 기둥을 사주라구 해서 그게 사주를보낸다는 거야	사주가 뭐냐면 네 기둥이야  연월일시 이 네 기둥을 사주라고 해서 그게 사주를 보낸다는거야
그 사 사주 그니께 지금 약 지그므루 얘기하먼 야콘시기	그 사 사주 그러니까 지금 약 지금으로 얘기하면 약혼식이
야콘식 허구두 삼년마네 겨론헌데 삼년동안색씨 얼굴도 모뽜서	약혼식 하고도 삼 년 만에 결혼했는데 삼 년 동안색시 얼굴도 못봤어
삼녀니나 기다려야 돼요	삼 년이나 기다려야 돼요
그니껜 열일굽싸레 저이키니 사주 보내구 열야덜싸레 보내구 스무사레 장개가시니께는	그러니까 열일곱살에 저렇게 사주 보내고 열여덟살에 보내고 스무살에 장가갔으니까
아아	아아
그땐 스무사리면 느즌 거야	그 땐 스무살이면 늦은 거야
그거 열려덜 싸레 보내션는데 왜 삼녀니나 기다리셔써요	그거 열여덟살에 보내셨는데 왜 삼 년이나 기다리셨어요
그건 뭐 하여간 뭐이 어떠케  어어 근데 흐니 그냥 이고짱 하는데	그건 뭐 하여간 뭐 어떻게  어어 그런데흔히 그냥 이곧장 하는데
나는 유독 인제 여기서 삼녀니라는만큼 세워리 흘러서	나는 유독 이제 여기서 삼년이라는만큼 세월이 흘렀어
그때는 남자는 열시사리면 장개가	그 때는 남자는 열세살이면 장가가
아아	아아
아 여기 여 교동에서 열 열시살 열니사레 저 어리내 난 사라미 이 이썬데 그저네 하라버지	아 여기 여 교동에서 열 열세살 열네살에 저 어린애 낳은 사람이 이 있었는데 그전에 할아버지
어머	어머
어 어머가 아냐 그 실지야	어 어머가 아냐 그 실제야
허 어떠캐 그럼 저는 마니 느전네요	허 어떡해 그럼 저는 많이 늦었네요
그니겐 실랑 그 어제 얘기애 그저껜가 얘기해짜나 그 당시만 해더래두 양에 기우니 시기 때메실랑은 나이가 즉꾸 신부는 나이가 망쿠	그러니까 신랑 그 어제 얘기에 그저께인가 얘기했잖아 그 당시만 하더라도 양의 기운이세기 때문에 신랑은 나이가 적고 신부는 나이가 많고
마자요 마자요	맞아요 맞아요
그니게는 신부는 여릴굽 여랴서쌀 머그니깐 어리낼 날 쑤 이따 마리야	그러니까 신부는 열일곱 열여섯살 먹으니까 어린애를 낳을 수 있단 말이야
마자요 마자요	맞아요 맞아요
그 이 실랑은 열시살 열니살 뒈두 어리낼 난는 거지	그러니 신랑은 열세살 열네살 되어두 어린애를 낳는 거지
근데 하라버진 스무사레 겨론하셔서	그런데 할아버지는 스무살에 결혼하셔서
스무사른 그땐 느전 거야 느저	스무살은 그땐 늦은 거야 늦어
할머니는 며쌀때	할머니는 몇살 때
여라오베  나보덤 한 살 아래야	열아홉에  나보다 한 살 아래야
이게 그 할머닌 지금 여든사리니께는	이게 그 할머니는 지금 여든살이니깐
그때는 그래두 그때 겨로내쓸 당시에는 할먼님드리 보통 더 나이가 만타구 하셔짜나요	그 때는 그래도 그 때 결혼했을 당시에는 할머님들이 보통 더 나이가 많다고 하셨잖아요
아냐 고때는 비스태서 우리만 해더래두  응 그럼	아냐 그 때는 비슷했어 우리만 하더라도  응 그럼
그때는 인제 실랑신부 나이가 비스태서 응 고때만 해더래두	그 때는 이제 신랑신부 나이가 비슷했어 응 그 때만 하더라도
응 그러구 이제 그러면 그러케 해서 사주 보내시고 삼년 이따가  이제 다시 할머니미이제 고구리로 오션네요 사주 단자 보낸 사주딴자 들고  그러치 그죠	응 그러고 이제 그러면 그렇게 해서 사주 보내시고 삼년 있다가  이제 다시 할머님이이제 고구리로 오셨네요 사주 단자 보낸 사주단자 들고  그렇지 그지요
그러고 그럼 그때 오셔쓸 때 그러며는 하라버님 부모님도 다 계시고	그러고 그럼 그 때 오셨을 때 그러면 할아버님 부모님도 다 계시고
나는 네살때 어머니가 도라가셔 내 생모가 도라가셔서	나는 네 살 때 어머니가 돌아가셔 내 생모가 돌아가셨어
이게 그 인제 그 당시에 인는 어머니는 게 게모루 게모가 나쁜 소리가 아니구	이게 그 이제 그 당시에 있는 어머니는 계 계모로 계모가 나쁜 소리가 아니고
이 어머니 대신 이어들온 분 보구 게 그 게모라구 허머는 흐니 모르는 사라믄 아주 나쁜 소리로아는데	이 어머니 대신 이어 들어온 분 보고 계 그 계모라 그러면 흔히 모르는 사람은 아주 나쁜소리로 아는데
게모는 나쁜 소리가 아냐 그 왜 저 테리비에두 게비라구 허자나  중저니 죽꾸나면 네 다시 중저늘 게비라구 허자나	계모는 나쁜 소리가 아냐 그 왜 저 텔레비전에도 계비라 그러잖아  중전이 죽고나면 네 다시 중전을 계비라 그러잖아
이어서 드러온 걸 게비라구 하는 거야	이어서 들어온 걸 계비라고 하는 거야
한짜가 게 짜가	한자가 계 자가
그럼 이을 께 짜야	그럼 이을 계 자야
으응	으응
그 그러기 때메 내 생모는 도라가시구 게모가 게셔찌	그 그렇기 때문에 내 생모는 돌아가시고 계모가 계셨지
그부니랑 그럼 아버니미랑	그 분이랑 그럼 아버님이랑
아 아버니는 생존애 아부지가 생조낸께 게 게모를  드 드러와찌	아 아버지는 생전에 아버지가 생전이니까 계모를  드 들어왔지
그리구 그러면 뭐 하라버니믄 그러면 어떠케 돼세요 형제가	그리고 그러면 뭐 할아버님은 그러면 어떻게 되세요 형제가
형제 나는 형제 형님 하나에 누님 한 부니야	형제 나는 형제 형님 하나에 누님 한 분이야
그럼 그때 할머님 오셔쓸 때 형니미랑 누니미랑 다 나가셔껜네요	그럼 그 때 할머님 오셨을 때 형님이랑 누님이랑 다 나가셨겠네요
그러치 출가해찌 그지	그렇지 출가했지 그지
출가하셔껜네요 그러면	출가하셨겠네요 그러면
근데 나두 내 어머니두 내 어머니두 게모야	그런데 나도 내 어머니도 내 어머니도 계모야
아버지가 세버늘 취처해싱께는	아버지가 세 번을 취처했으니까
크너머니가 도라 크너머니가 인제 내 형허구 누님허구 나쿠선 도라가시니겐 우리 어머니께 바루또 장갈 가신 거야 그냥 데려온 거이 아니구	큰어머니가 돌아 큰어머니가 이제 내 형하고 누남하고 낳고선 돌아가시니까 우리 어머니꼐바로 또 장가를 가신 거야 그냥 데려온 게 아니고
장개 가서 인제 어머닐 인제 모셔완는데 또 어머니가 나 나쿠는 도라가셔서	장가 와서 이제 어머니를 이제 모셔왔는데 또 어머니가 나 낳고는 돌아가셨어
응 그게 다시 또 인제 어머닐 모신 거지	응 그게 다시 또 이제 어머니를 모신 거지
내 팔자가 이래	내 팔자가 이래
그러면 그때에는 그러면 그러케 사주 하고 나서 이제 겨론시글 또 치르자나요 요새는 예식장가서 이케 서양시그로 하자나요	그러면 그 때에는 그러면 그렇게 사주 하고 나서 이제 결혼식을 또 치르잖아요 요새는 예식장가서 이렇게 서양식으로 하잖아요
으응	으응
그때는 이르케 마쩌라고  밥 가운데 노코 사 사무관대 한대는 거야그건 예	그 때는 이렇게 맞절하고  밥 가운데 놓고 사 사모관대 한다는  거야 그건 예
사모는 이거 쓰고 관 관대는 요거 요 요거 띠 띠고 사무관대 한대는 거야 여자는 쪽뚜리 쓰고	사모는 이거 쓰고 관 관대는 요거 요거 띠고 사모관대 한대는 거야 여자는 쪽두리 쓰고
그 실랑찝 아페서요	그 신랑집 앞에서요
신부찝 아페서지	신부집 앞에서지
신부찝 아페서 그면 할머님 아니 하라번니미  동산니까지 가셔껜네요 가서	신부집 앞에서 그러면 할머님 아니 할아버님이  동산리까지가셨겠네요 가서
그 인제 초레 지꼬 초 초레라 그래 초레 지내군 데루구 오는 거지	그 이제 초례 짓고 초 초례라 그래 초례 지내고는 데리고 오는 거지
그럼 그때는 보통 잔치하자나요 마을잔치  뭐 뭐 먹어요	그러면 그 때는 보통 잔치하잖아요 마을잔치  뭐 뭐 먹어요
잔치국쑤라 그러자나 흐 흐니 국쑤 국쑤야	잔치국수라 그러잖아 흐 흔히 국수 국수야
요새 그래서 그런 마리 괘 괘니 인는 게 아니 언제 국쑤 머겨줄꺼야 이런 거 언제 겨로날 꺼야할 때 국쑤 머겨줄 꺼야 하는게	요새 그래서 그런 말이 괘 괜히 있는 게 아니 언제 국수 먹여줄 거야 이런 거 언제 결혼할거야 할 때 국수 먹여줄 거야 하는 게
그게 그 유래야 그거이	그게 그 유래야 그게
거기서부터 그러며는 그때 국쑤 드시고	거기서부터 그러면 그 때 국수 드시고
뭐 뭐 내놔요 뭐 이러케 국쑤 다 이러케 마을 사람드란테 돌리는 거에요	뭐 뭐 내놔요 뭐 이렇게 국수 다 이렇게 마을 사람들한테 돌리는 거예요
그이 잔치지 뭐야	그게 잔치지 뭐야
그러면 그 음시근 누가 해요 저긷 지베서	그러면 그 음식은 누가 해요 저기 집에서
아 저 지베서두 허구 이 지베서두 하지	아 저 집에서도 하고 이 집에서도 하지
두번 해요	두번 해요
아니 두번 허는 게 아니라 저짐넨 자기네 친처글 불르는 거구 여기는 우리 동네싸람허구 우리친척 불르는 거구	아니 두 번은 아니라 저집네는 자기네 친척을 부르는 거고 여기는 우리 동네 사람하고 우리친척 부르는 거고
두번 하는 거 아니고	두 번 하는 거 아니고
아 두버니 아니지 저 짐네는 한 저 짐네도 한 번 여기서두 한 버니지	두 번이 아니지 저 집네는 한 저 집네도 한 번 여기서도 한 번이지
그니까 저쪽 한 번 이쪽 한 번	그러니까 저 쪽 한 번 이 쪽 한 번
그럼 두진네가 다 한 번씩 하는 거지 머	그럼 두집네가 다 한 번씩 하는 거지 뭐
그러쿠나 그러면 어떠케 지내셔써요 재미쓰셔써요	그렇구나 그러면 어떻게 지내셨어요 재밌으셨어요
재미래는 거는 에 그 당시에 그 당시에 내가 장개 가던 해가 경인녀니야 바로 유기오 나던해야	재미 라는 거는 에 그 당시에 그 당시에 내가 장가 가던 해가 경인년이야 바로 육이오 나던해야
힘드셔껜네	힘드셨겠네
유 유기오 난는데 그때는 이 교동이 아주 흉녀니야	유 육이오 났는데 그때는 이 교동이 아주 흉년이야
응 그냥 머 곡씨기라먼 벼 벼 심꼬 헝 게 하나도 머근 게 웁써	응 그냥 뭐 곡식이라면 벼 벼심고 하나도 먹은 게 없어
그게 가무러가주구	그게 가물어가지고
지그믄 이제 저수지가 이서서 무리 이서가지구 이게 모들 내구 이게 그 흉년 업시 농사 지찌만그때는 하눌만 바라보는 거야 하눌만	지금은 이제 저수지가 있어서 물이 있어가지고 이게 모들 내고 이게 그 흉년 없이 농사 짓지만그때는 하늘만 바라보는 거야 하늘만
그니껜 저번날 얘기한 대루 논 저 보메 갈구선 베씨를 산파루 뿌리 뿌려노쿠선 거기서 인제씨 나먼 그거 호미 가지구 나중에 저 그 매구	그러니까 저번에 얘기한 대로 논 저 봄에 갈고선 벼씨를 상판에 뿌리 뿌려놓구선 거기에서이제 씨 나면 그거 호미 가지고 나중에 저기 매고
그니껜 수왁두 을마 웁써 그껜 그러니께는 얘기해짜나 아침빠베 저녁 묵냐 조반석쭈기나 허냐	그러니까 수확도 얼마 없어 그러니까 그러니까는 얘기했잖아 아침밥에 저녁 먹냐 조반석죽이나 하냐
흐 흐니 허는 마리 그 호니날 때	흐 흔히 하는 말이 그 혼인할 때
응 신랑찌비서 인지 신부찌비 인지 중매 노코 오머는 신부찌비서 그런 얘기 한단 마리야	응 신랑집에서 이제 신부집에 이제 중매 놓고 오면 신부집에서 그런 얘기 한단 말이야
고 신랑찌비 어떠케 조반석쭈기나 하나 아침빠베 저녀기나 멍나	그 신랑집이 어떻게 조반석죽이나 하나 아침밥에 저녁이나 먹나
아침빠베 저녁 머구머는 저 저녁 죽 머그머는 그건 부자니까는	아침밥에 저녁 먹으면 저 저녁 죽 먹으면 그건 부자니깐
그 그 그러케 하는데 비가 경인녀네 유기오 나던 해는 비가 아주 안와서	그 그렇게 하는데 비가 경인년에 육이오 나던 해는 비가 아주 안왔어
베가 이래 자라다가 패지 모터구 그냥 전부 말라 주근 거야	벼가 이렇게 자라다가 패지 못하고 그냥 전부 말라 죽은 거야
그런데다가 여기 교동 싸람들 무척 고생 마니 한 사람이야 이거 그 당시에 교동국 교동민구기라해서 대한민구기 아니라 교동민가라 해서	그런데다가 여기 교동 사람들 무척 고생 많이 한 사람들이야 이거 그 당시에 교동국 교동민국이라 그랬어 대한민국이 아니라 교동민이라 그랬어
그 유기오 나니까는 전부 피란 나간다 마리야	그럼 육이오 나니깐 전부 피난 나간다 말이야
그러쿠나	그렇구나
전부 피 피란 나간는데 그 그때 유기오 때는 미처 다 나가지 유기오 나먼서 바짝 드러오니까는나가지 모태서	전부 피 피난 나갔는데 그 그때 육이오 떄는 미처 다 나가지 육이오 나가서 바짝 들어오니까는나가지 못했어
여기 나두 그 당시에 여기두 이꾸 여기두 인민구니 여기 드러와꾸	나도 그 당시에 여기도 있고 여기도 인민군이 여기 들어왔고
아아	아아
인민구니 드 드러와가지구 뭐 행패 마니 부려찌 인민군드리	인민군이 드 들어와가지고 뭐 행패 많이 부렸지 인민군들이
그거이 지금 자네드른 몰라	그게 지금 자네들은 몰라
공산당이래두 아우 그거뚜 거 사람 사는 데지 뭐 조치 뭐 해가지구 지금 이부글 가따 공산지녕을가따 차냥하는 절믄 사람도 이찌만 그거 정신 빠진 사라미라구	공산당이래도 아우 그것도 거 사람 사는 데지 뭐 좋지 뭐 해가지고 지금 이북을 갖다 공산진영을갖다 찬양하는 젊은 사람들도 있지만 그거 정신 빠진 사람이라고
그 겨꺼본 사라믄 공산당이먼 체 체머리 들렁들렁 흔드러	그 겪어본 사람은 공산당이면 체 체머리를 들렁들렁 흔들어
그래 가지구 그 사람드리 여기 드러와 이따가 구이팔 구월이시파릴랄 여기서 매가더 장구니 인천상류카지 아나서 어	그래가지고 그 사람들이 여기 들어와 있다가 구이팔 구월 이십팔일날 여기서 맥아더 장군이인천 상륙하지 않았어 어
사 상육 해서 인제 치민 거이 구월이시파리라 구이파리라 마랴	사 상륙 해서 이제 치민 게 구월 이십팔일이라 구이팔이라 말이야
구이파레 얘드리 쬐껴 드러가꺼든	구이팔에 얘들이 쫓겨 들어왔거든
쬐껴드러 드러가 드러완는데 여 국꾼드리 난 그땐 구니네 안 나가찌	쫓겨들어 들어가 들어왔는데 여 국군들이 난 그땐 군인에 안 나갔지
에 구꾼드리 저 암녹깡까지 건 건저 다 미러완는데 중공구니 내몰리지 아나서	에 국군들이 저 압록강까지 건 거진 다 밀어왔는데 중공군이 내몰리지 않았어
고거 일사후퇴야 이뤌사일 일사후퇴야	그게 일사후퇴야 일월사일 일사후퇴야
일사후퇴에 전부 인제 절문 사람들 전부 저리 나려간 거야 아래루낭	일사후퇴에 전부 이제 젊은 사람들 전부 저리 내려간 거야 아래로
그땐 나두 청방으루 이 이 교동에 처 청방으루 뛰언는데	그땐 나도 청방으로 이 교동에 처 청방으로 뛰었는데
이 교동사람들두 전부 광아루 근너가서 광아서 인제 저그 김포루 근너가서 아래 아랜녀그루 전부피란 나려간 거지	이 교동사람들도 전부 강화로 건너가서 강화에서 이제 저기 김포로 건너가서 아래 아랫녘에전부 피난 내려간 거지
그 당시에 저러키니 뭐 저 뭐야 수원 대전까지두 인제 중공군 인민군드리 또 나려가구 핸는데두교동에는 그 그 사람드리 드러오지 안 모태 안 안 와서	그 당시에 저렇게 뭐 저 뭐야 수원 대전까지도 이제 중공군 인민군들이 또 내려가고 했는데도교동에는 그 그 사람들이 들어오지 못해 안 했어
그건 왜 그러냐 교동이 떠러진 서미거든	그건 왜 그러냐 교동이 떨어진 섬이거든
저리만 내려가뿌먼 여긴 자동저그루 와따가따 하는 데란 마랴 그껜 여긴 드러오진 아난는데 여긴뭐 이선냐 타이커 여다니라는 거 이서서 타이커 여단	저리만 내려가 버리면 여긴 자동적으로 왔다갔다 하면 된단 말야 그러니까 여긴 들어오지않는데 여긴 무엇이 있었냐 타이커 여단이라는 것이 있었어 타이커 여단
타이커 여단	타이커 여단
타이커 여단 거 미 미군 미 팔구네 소속 이 그 이 마라자면 그런데 그 사람드리 뭐냐머는 저이부게서 연백 이부게서 쬐껴나온 사람드리야 절문 사람 거 절문 사람드리지	타이커 여단 거 미 미군 미 팔군에 소속 이 그 이 그 말하자면 그런데 그 사람들이 뭐냐면저 이북에서 연변 이북에서 쫓겨나온 사람들이야 젊은 사람 거 젊은 사람들이지
거 거그서 이제 이부게서 그 사람들두 이제 절머스니까 뭐 청방이니 뭐니 해따는데 쟤드란테쬐껴선 혼나구 혼나선 나려온 거지	거 거기서 이제 이북에서 그 사람들도 이제 젊으니까 뭐 청방이니 뭐니 하였다는데 쟤들한테쫓겨선 혼나구 혼나선 내려온 거지
나려와서 이 교동으로 건너와서 교동서 그 사람드리 행팰 부린 거야	내려와서 이 교동을 건너와서 교동에서 그 사람들이 행패를 부린 거야
인민군보덤두 더 행패를 부린 거야 이 사람드리	인민군보다도 더 행패를 부린 거야 이 사람들이
버비 웁꺼든 뭐 경차리고 치안이 여기 하나두 웁쓰니껜	법이 없거든 뭐 경찰이고 치안이 여기 하나도 없으니까
에 그이게는 그냥 거기서 너 너머온데 피란 온 사람드리 즈이만 너머오나 가족뜰두 데리구와찌	에 그러니까 그냥 거기서 너 넘어오는 데 피란 온 사람들이 자기들만 넘어오나 가족들도데리고 왔지
가족뜨른 나미 사랑만 이스먼 여 바로 쳐	가족들은 남의 사랑방만 있으면 바로 쳐
거기 가따 노쿠 낭구 해오나	그걸 가져다 놓고 나무 해와
즈이가 해오는 게 아니라 여기 나믄 사람들 보구 낭구 해오나	저희가 해오는 게 아니라 여기 남은 사람들 보고 나무 해와라
즈이는 가마니 안자가지구 낭구해오나 낭구 해오먼 인제 불 땐다 마리야	저희는 가만히 앉아 가지고 나무 해와라 나무 해오면 인제 불 땐단 말이야
그리구 즈이들 싱량은 뭐냐문 미 팔구네서 이 알량미라구 이서	그리고 자기들 식량은 뭐냐면 미 팔군에서 이 안남미라고 있어
알량미 거튼 걸 인제 주 주는데 이 교동 사람드리 알량미가 뭐야 응	안남미 같은 걸 인제 주 주는데 이 교동 사람들이 안남미가 뭐야 응
저븐날 얘기해뜬 밀마까리 밀마까리는 호사야 밀기우리	저번날 얘기했던 밀가루 밀가루는 호사야 밀기울
지그므루 마라면 밀 가라가지구 이제 가루는 뽑짜나 뽀브면 찌끄기 남짜나 그이 글 밀기우리라한단 마리야	지금으로 말하면 밀 갈아서 이제 가루는 뽑잖아 뽑으면 찌꺼기 남잖아 그것을 밀기울이라한단 말이야
밀기울 이걸 사 사다가 그거루다 주글 끄리는 거야 그걸 죽 근데 그거뚜 웁서서	밀기울 이걸 사 사다가 그거로다 죽을 끓이는 거야 그걸 죽 근데 그것도 없었어
콩 콩 콩나물 요마난 거 기르면 이마나자나 질 마나지지나 콩나물 길러가지구 거기다 콩나물너가지구 배가 고프니까는	콩 콩콩나물 이만한 거 기르면 이만하잖아 제일 많아지잖아 콩나물 길러 가지고 거기다 콩나물넣어 가지고 배가 고프니까
그거뚜 그거뚜 모태 노니 그때 인제 가무러선 노니 전부 무거시니께 아무거도 모태 거기에기미 나	그것 그것도 못해 논이 그때 인제 가물어선 논이 전부 묵었으니까 아무것도 못해 거기에김이 나
비 기미 난 데 세비르미라는 인제 푸리 이서 여 여기 대가 구 굴꾸 인제 쫌 물렁물렁허야	비 김이 난 데 쇠비름이라는 인제 풀이 있어 여 여기 대가 구 굵고 인제 좀 물렁물렁해
그걸 그걸 뜨더다 그걸 살마서 멍는데 그거만 살마머금 이래 부증이 나 부어	그걸 그걸 뜯어다 그걸 삶아서 먹는데 그것만 삶아 먹으면 이리 부증이 나 부어
아아	아아
부으 머 며칠 굴므머 주 츠 주러드는 거야	부으면 며 며칠 굶으면 주 줄어드는 거야
근데 그 밀끼우리 쪼끔 머 쪼끔 웬마난 사라믄 밀끼우리 사다가 콩나물 너코 그걸 훌훌 좀 마시머는그거 으다 머그러 드러오는 사라미 대무니 산해 가치 좀 머급시다 가치 좀 머급시다	근데 그 밀기울이 조금 뭐 조금 웬만한 사람은 밀기울 사다가 콩나물 넣고 그걸 훌훌 좀 마시면그거 얻어 먹으러 들어오는 사람이 대문에 산해 같이 좀 먹읍시다 같이 좀 먹읍시다
이런데 거기에 인제 그 이 너머온 그 사람드른 이 즈이들 알량미 보리쌀 이런 거 주머는 이걸일반 가정에 가따 그 그 사람들 바블 집찜마다 돌려가면서 해메겨	이런데 거기에 이제 그 이 넘어온 그 사람들은 저희들 안남미 보리쌀 이런 거 주면 이걸일반 가정에 갖다 그 그 사람들 밥을 집집마다 돌려가면서 해 먹여
오눌 저 저 아치믄 이짐네서 허구 저녀근 저짐네서 허구 허는데 그 싸를 한데빡 주머는 어서구허든지 싸를 구해다 쌀바블 해줘야대	오늘 저 저 아침은 이 집에서 하고 저녁은 저 집에서 하고 하는데 그 쌀을 한 됫박 주면은어디서 구하든지 쌀을 구해다 쌀밥을 해 줘야돼
아내주머는 그냥 불 붇짜바다 막 드리 패니껜	안 해주면 그냥 붙잡아다 막 들이 패니까
그니 매일 무서우니께는 무슨 도둑찌리라두 해서라두 싸를 어드런 수단을 서서라두 싸를 구해다바블 해 바쳐야대 그럼	그러니 매일 무서우니까 무슨 도둑질이라도 해서라도 쌀을 어떤 수단을 써서라도 쌀을 구해다밥을 해 바쳐야 돼 그럼
이와 가치 교동엔 해온 이 일짜리야	이와 같이 교동엔 해온 일자리야
그이 게다 그뿌닌가 사람도 마이 주거찌 그사람드란테	그 게다 그 뿐인가 사람도 많이 죽었지 그 사람들한테
즈이드리 그 빨갱이드란테 호니 나끼 때메 여기서 빨갱이 활동 한 사라미 미처 피란 모깐 사라믄전부 부짜바다 쏴주겨따 마랴	저희들이 그 빨갱이들한테 혼이 났기 때문에 여기서 빨갱이 활동 한 사람이 미처 피난 못간 사람은 전부 붙잡아다 쏴 죽였단 말야
그 당시에 난 구니넬 나가찌	그 당시에 난 군인엘 나갔지
아아	아아
구 구니는 구니네 나가 나가서 그땐 구닌 고생도 마니 해서	구 군인은 군인에 나가 나가서 그땐 군인 고생도 많이 했어
뭐 지금지금 구닌드른 그 뭐 저 뭐라 그래 저 소풍가서 뭐 저러키니 여행이나 가따올까그 정도지	뭐 지금지금 군인들은 그 뭐 저 뭐라그래 저 소풍 가서 뭐 저렇게 여행이나 갔다 올까그 정도지
훌련소에서 훌련 받 바든데 바 반는데 지그믄 이래는 걸 모르자나	훈련소에서 훈련 받 받는데 바 받는데 지금은 이라는 걸 모르잖아
이 오슬 버꼬 화장시레 가서 버꼬 보머는 저 이가 걍 새카매	이 옷을 벗고 화장실에 가서 벗고 보면 저 이가 그냥 새까매
이이 근데 흐니 오센니는 하야코 머린니는 거머커든	이 근데 흔히 옷엣니는 하얗고 머릿니는 거멓거든
오세니가 그 새카매 그 때에 무더서 그런지	옷엣니가 그 새카매 그 때에 묻어서 그런지
그니 이건 자바 주길 수가 웁써 버서서 이 이 터 터는 거지	그러니 이것은 잡아죽일 수가 없어 벗어서 이 이 터 터는 거지
게다가 뭐 띠 띠야기라고 뿌려노면 그건 때만 때만 끼지 뭐	게다가 뭐 띠 띠약이라고 뿌려 놓으면 그건 때만 때만 끼지 뭐
근데 그거이 그거꺼지 존데 배가 고파	그런데 그것이 그것까지 좋은데 배가 고파
배가 고파서 그리 잠 잠도 제대로 모짜지	배가 고파서 그리 잠 잠도 제대로 못 자지
그이 후 훌련소에만 그런 게 아니라 그래선 그리구나선 인제 전방에 전투하라 싸머러 전방에나가	그이 후 훈련소에만 그런 게 아니래 그래서 그리고 나선 이제 전방에 전투하러 싸움하러전방에 나가
나가 거기 나가서두 배가 고파	나가 거기 나가서도 배가 고파
금새 쥐기 저 싸우다가 주글 주글 사라민데 왜그러게 배를 골려	금세 죽이 저 싸우다가 죽을 죽을 사람인데 왜 그렇게 배를 곯려
근데 하루 싱냥은 제 양은 그런대루 머글 만큼 나오는데 중가네서 다 띠어머거챈다마랴 이 너픈너픈 사람드리 응	그런데 하루 식량은 제 양은 그런대로 먹을 만큼 나오는데 중간에서 다 떼먹어챈단 말야 이높은 높은 사람들이 응
그거 그 지금 주굴찌 내일 주굴찌 모르는 사람 모르는 그 인제 군 병 병사드를 그러구 배를골려논단 마랴	그거 그 지금 죽을지 내일 죽을지 모르는 사람 모르는 그 인제 군 병사들을 그렇게 배를곯려 놓는단 말야
그러니 보촌 서야지 보초 언제 어르러케 될 줄 모르니껜 보초 서야지 그껜 잠도 제대로 몯자지 배는 고프지	그러니 보초는 서야지 보초 언제 어떻게 될 줄 모르니까 보초 서야지 그러니깐 잠도 제대로못자지 배는 고프지
그니껜 원 너 뭐이 워니냐면 배불리 한 번 머꼬 잠 한 번 실컫 자며는 그냥 누가 와서 목 당장후려 가두 원 웁까따 마랴	그러니깐 원 너 무엇이 원이냐면 배불리 한번 먹고 잠 한번 실컷 자면은 그냥 누가 와서 목당장 베어 가도 원 없겠단 말야
왜그르냐면 어채피 주거야 된다 마랴 주거야지 온다 마랴 응	왜 그러냐면 어차피 죽어야 된단 말야 죽어야지 온단 말야 응
그땐 제대란 마리 저녀 웁스니께는	그땐 제대란 말이 전혀 없으니까
그니 전 그이 후방에 인는 사람들이 외려 전 거이 전방에서 전투 허다가 여 곧 잠깐 좀 쉴라고우 후방 부대허구 교첼 헌단 마랴 교체하먼 저저끔 전방으루 나갈려구 나갈려 그래	그러니 전 그런 후방에 있는 사람들이 외려 전 거의 전방에서 전투하다가 여기 곧 잠깐좀 쉬려고 우 후방 부대하고 교체를 한단 말야 교체하면 제가끔 전방으로 나가려고 해
저기 나오먼 주굴쭐 알면서두 어채피 주글 꺼니께는 에 싸우다 주까따 마리야 응	적이 나오면 죽을 줄 알면서도 어차피 죽을 거니까 싸우다 죽겠단 말이야
배고픈 고생허구 잠 모짜는 고생하니 어채피 주글 꺼니껜 나가서 싸우 저놈들 하나 주기군 나주그먼 응 펴나가따 마리지	배고픈 고생하고 잠 못자면 고생하니 어차피 죽을 거니까 나가서 싸워 저놈들 하나 죽이곤나 죽으면 편하겠단 말이지
이 생가기니껜 허지지금처럼 펴나내 봐 누가 전방에 나가거 주그라먼 거기 나갈려는 사람인나 그러케 되니껜 전투가 되드라구	이 생각이니까 하지지금처럼 편안해 봐 누가 전방에 나가 죽으라면 거기 나가려는 사람있나 그렇게 되니깐 전투가 되더라고
그러케 허는 걸 오심유깨월 똥아늘 군대생와 해서 내가	그렇게 하는 걸 오십육개월 동안을 군대 생활했어 내가
그럼 할머닌 그동안 계속 교동에서 기다리셔꾸요  그 시부몬님 모시고 그럼	그럼 할머닌 그동안 계속 교동에서 기다리셨고요  그 시부모님 모시고 그럼
기니 뭐뭐 머글 꺼 웁써 중 머그먼서 응 나무가 인나 그이 사네 올라가서 이 풀 까까야 하는데내가 업스닌게 누가 해	그러니 뭐뭐 먹을 거 없어 죽 먹으면서 응 나무가 있나 그러니 산에 올라가서 이 풀 깎아야하는데 내가 없으니까 누가 해
이 할머이가 인제 새색씨지 새색씨가 치마 치마저고리 이꼬 가서 이 풀 까까선 이 이여다가불 때구	이 할머니가 인제 새색시지 새색시가 치마 치마저고리 입고 가서 이 풀 깎아선 이 이어다가불 때고
그때 할머니 그럼 그 자식분이 계셔  그땐 업쓰셔꼬  응	그때 할머니 그럼 그 자식분이 계셔  그땐 없으셨고  응
장개는 스무 저러키니 스무사레 가서두 우리 큰 따를 내 스물 여서세 나 여 스물 일곱쌀 먹뜬보메 나꾸나	장가는 스무 저러니까 스무살에 갔어도 우리 큰딸을 나 스물 여섯에 나 여 스물 일곱살먹던 봄에 낳았구나
장가 가시구 그럼  군대는 언제 가신 거예요 군대 가자마자  응 장가 가고그 이드메  응 그 이드메 간 거지	장가 가시고 그럼  군대는 언제 가신 거에요 군대 가자마자  응 장가가고 그 이듬해  응 그 이듬해 간 거지
하먼 할머님두 저긴데 신혼 때 힘드셔껜네요  겨론 하자마자 서방 보내구  어유지금 그 얘기해봐 어이구 눈물 흘리지 네	하면 할머니도 저긴데 신혼 때 힘드셨겠네요  결혼 하자마자 서방 보내고  어유지금 그 얘기해 봐 어이구 눈물 흘리지
혼자 시부몬니믈 융년똥안 모시구	혼자 시부모님을 육년동안 모시고
그거이 내 뭐 인는 거 인나 배는 고프구 이른 해야되가꾸	그거 뭐 있는 거 있나 배는 고프고 일은 해야 되겠고
아 시어머 시아버이 보고 일허라구 헐 쑨 읍꾸 마리지 그러차나 고생 마니 헌 사라미야	아 시어머 시아버지 보고 일 하라고 할 순 없고 말이지 그렇잖아 고생 많이 한 사람이야
근데 그래두 융년똥안 자식뿌늘 먼저 나으셔쓰면 융년똥안 자식 키우시면서 그래두	근데 그래도 육년동안 자식분을 먼저 낳으셨으면 육년동안 자식 키우시면서 그래도
그 그 그러치 거 거기다 정 들 껀데  아무거뚜 읍쓰니껜 내 몸뚱아리하나지 뭐	그 그 그렇지 거 거기다 정 들 건데  아무것도 없으니까 내 몸뚱아리하나지 뭐
그러며는 군대에서 이제 오시고 그러고 인제 그때부터 아든님 아든님 세분 다 아든니미신가요	그러면 군대에서 이제 오시고 그러고 인제 그때부터 아드님 아드님 세분 다 아드님이신가요
세 세슨 아들 아드리고 하나는 따리야 그이 마지가 따리야 지금 마지가 지금 쉰다서싸리야그 그때 난 따리	세 셋은 아들 아들이고 하나는 딸이야 그 맏이가 딸이야 지금 맏이가 지금 쉰다섯 살이야그 그때 낳은 딸이
다녀오시구 군대에서 인제 오시구  그 다음에 나셔꾸나	다녀오시고 군대에서 인제 오시고  그 다음에 낳으셨구나
그러며는 그때에도 인제 배길잔치랑 이런 거 다 하셔써요	그러면 그때에도 인제 백일 잔치랑 이런 거 다 하셨어요
배길잔치 헐 여유가 업서  머글 꺼 이꾸 뭐 이서야 배길잔치두 허지	백일잔치 할 여유가 없어  먹을 거 있고 뭐 있어야 백일잔치도 하지 백일잔치할 여유가 없어
그러면 그 욱 융년똥안  그러면 어머님 할먼니메 부모님드른 동산니에 계셔쓸 꺼 아니에요그러며는 그동안 좀 이르케 오가고 하셔쓸까요	그러면 그 육 육년동안  그러면 어머님 할머님의 부모님들은 동산리에 계셨을 거 아니에요 그러면 그동안 좀 이렇게 오가고 하셨을까요
그러케 그랟까지 뭐 그건 친정에 와따가따 해까찌	그렇게 그랬겠지 뭐 그건 친정에 왔다갔다 했겠지
그리구 군 군대생와럴 때에 군대생와랄 때 얘기 좀 해 주지	그리고 군 군대생활할 때에 군대생활할 때 얘기 좀 해 주지
배가 고픈껜 말야 배가 고프니께는 후 훌련소에선 훌련소에선 고 훌련병드리 죽 지그믄 식땅이구허지만 그땐 저 취사바니 이서 지금 밥 허는 데가 이서	배가 고프니깐 말야 배가 고프니까 후 훈련소에선 훈련소에선 그 훈련병들이 죽 지금은식당이고 하지만 그떈 저 취사반이 있어 지금 밥 하는 데가 있어
밥 허는 데가 이스먼 그 저 즘 조바니구 즘시미구 저녀기구 하루 세번식 이 빠께쓰를 들구 가서바블 타와	밥 하는 데가 있으면 그 저 점 조반이고 점심이고 저녁이고 하루 세번씩 이 양동이를 들고가서 밥을 타와
바블 타오는데 인제 고 이제 부 분대 분대 별루 분대 별루 열 명이면 열 명치 주구	밥을 타오는데 이제 고 이제 부 분대 분대별로 분대별로 열 명이면 열 명치 주고
이 야 열명인데 사브루다 찔러서 사브루다 이 재서 주는 거지	이 야 열 명인데 삽으로 찔러서 삽으로 재서 주는 거지
한 면명 면명에 요거 한삽 준대는 그거루 해가지구 사브루다 찔러서 인제 이 빠께스다 주구	한 몇 명 몇 명에 요거 한 삽 준대면 그걸로 해 가지고 삽으로 찔러서 인제 이 양동이에다주고
이제 국 구기래는 건 저러키니 겨우레는 콩나물두 과해 시래기꾹	이제 국 국이라는 건 저렇게 겨울에는 콩나물도 과해 시래기국
게 그거 된장두 소 소구미지 소굼 응	그 그거 된장도 소 소금이지 소금 응
이거는 이러그 저 빠께스다 주머는 항고라고 이서 지금 자네드리 항고를 알간는지 모르간네황고라고 요로케 생긴 그르시 이서	이거는 이러고 저 양동이를 주면 한고라고 있어 지금 자네들이 한고를 알는지 모르겠네 환고라고 여렇게 생긴 그릇이 있어
헌데 한고 속따까리가 이꾸 거따까리가 이서 속따까리 이리 누르고 거따까리	그런데 한고 속뚜껑이 있고 겉뚜껑이 있어 속뚜껑 이렇게 누렇고 겉뚜껑
그 한고에다 한고는 뭐에 피료하냐먼 전투때에 이 배낭 여이다 지구 댕기다가 여 배고프면그 항고에다 뭘 끄려서 이 거러노코 불 때먼 이 소테 이 냄비 행세두 헌다구	그 한고에다 한고는 뭐에 필요하냐면 전투때에 이 배낭 여기다 지고 다니다가 여 배고프면그 한고에다 뭘 끓여서 이 걸어놓고 불 때면 이 솥에 이 냄비 행세도 한다고
그러케 머 멍는 그 항고가 이서	그렇게 머 먹는 그 한고가 있어
그니 항고 따까리라고 속따까리라고 쪼끄마 해찌 거 쪼그마 해 거따까린 좀 크구	그러니 한고 뚜껑이라고 속뚜껑이라고 조그맣게 노란 거 조그마해 겉뚜껑은 좀 크고
건 항고 속따까리에 바블 퍼서 요러게 다므먼 아마 크게 수깔루 뜨먼 다서쑤까리나 여서쑤깔뜨먼 다 될꺼야	건 한고 속뚜껑에 밥을 퍼서 요렇게 담으면 아마 크게 숟갈로 뜨면 다섯 숟갈이나 여섯 숟갈뜨면 다 될 거야
그리구 그 거뚜 거뚜꺼리에는 건지가 어디서 궁 소 궁마루 말구기지	그리고 그 겉뚜 겉뚜껑에는 건지가 어디 있어고 국 소 국물 국물이지
그거 이래 주머는 그걸 머꾸장정드리 그거 배 가네 기벼리나 가나	그거 이렇게 주면 그걸 먹고장정들이 그거 배 간에 기별이나 가나
그냥 노냥 굼따가 고 당버늘 도라가먼서 해	그냥 노상 굶다가 고 당번을 돌아가면서 해
도라가 도라가먼서 허머는 그 당번 되기만 허먼 되기만 기다리는 거야 그럼	돌아가 돌아가면서 하면은 그 당번 되기만 하면 되기만 기다리는 거야  그럼
조 조바늘 일찌거치 주니께는 인제 그 내무바네 가따노코 이 구 구서게다 가따노먼 껌꺼매서잘 쭉 식사대형으로 안저 하면 쭉 두 줄로 이짜게 이짜게 두 줄로 안는단 마랴	조 조반을 일찌감치 주니까 인제 그 내무반에 갖다 놓고 이 구 구석에다 갖다 놓으면 깜깜해서잘 쭉 식사대형으로 앉아 하면 쭉 두 줄로 이쪽에 이쪽에 두줄로 앉는단 말야
그 안즈먼서 안자서 저 바라봐야 뵈지도 아너 컴컴허니껜	그 앉으면서 앉아서 저 바라봐야 보이지도 않아 깜깜하니까
기니까는 이 밥 푸먼서 그냥 이 소느로 푸먼서 이 소느로 집 그냥 막 지버 넌는 거지 머 응	그러니까 이 밥 푸면서 그냥 이 손으로 푸면서 이 손으로 집 그냥 막 집어 넣는 거지 뭐 응
아 내 배버텀 채우 그러니껜 당번허고 나면 설싸한다구 그냥 누니 퀭허게 드러가 버려	아 내 배부터 채우 그러니까 당번하고 나면 설사한다고 그냥 눈이 퀭하게 들어가 버려
안먹따가 머그니	안먹다가 먹으니
그럼 그건 누구든지 당번허구 나먼 그건 으레 설싸헐 줄 아라야 하는 거니께는	그럼 그건 누구든지 당번하고 나면 그건 으레 설사할 줄 알아야 하는 거니까
그니깐 당번하면 저누믄 또 오늘 실컫 처머꾸 인제 설싸하가따	그러니까 당번하면 저놈은 또 오늘 실컷 처먹고 인제 설사하겠다
이와 가치 군대 생화를 한 거야	이와 같이 군대 생활을 한 거야
그럼 짐 아드니미랑 따니미랑 다 서우레 계세요 따님도 서우레 계세요	그럼 지금 아드님이랑 따님이랑 다 서울에 계세요 따님도 서울에 계세요
이 인처니 이서  크 크나이는 인제 서울서고등아꾜 교사루 이찌  네	이 인천에 있어  크 큰 아이는 인제 서울서고등학교 교사로 있지  네
그르구 뭐 공무원 다들 공무워니시라고	그리고 뭐 공무원 다들 공무원이시라고
둘째어구 둘째하구 세째는 인제 인천서 한노믄 구청에 이꾸 한노믄 동사무소에 이꾸 그러치	둘째하고 둘째하고 셋째는 인제 인천서 한놈은 구청에 있고 한놈은 동사무소에 있고 그렇지
그러며는 며느니미랑 다 이제 와요 설랄때 뭐 그러케 교동 드러와요 그지여	그러면 며느님이랑 다 이제 와요 설날 때 뭐 그렇게 교동 들어와요 그렇지요
그런데 아놀 수 인나 은데 크닐 나서 저 어름 때메 오 오늘두 가 간덴누미 저놔해서 아유 어르미 꽉 차때는데 어드러케요	그런데 안올 수 있나 그런데 큰일 났어 저 얼음 때문에 오 오늘도 가 가운뎃놈이 전화해서 아유 얼음이 꽉 찼대는데 어떡해요
어름 차스면 모 아노면 될 거 아냐 허긴 해찌마는 에그 어름때메 야다니야	얼음 찼으면 모 안 오면 될 거 아냐 하긴 했지만 에그 얼음 때문에 야단이야
이월따레는 그래도 어름 쫌 풀릴 거 가타요	아 이월달에는 그래도 얼음 좀 풀릴 거 같아요
아유 뭐 이뤌따리 지금 뭐 여 한 여를바께 안나만는데 뭐	아유 뭐 일월달이 지금 뭐 여 한 열흘밖에 안 남았는데 뭐
안 풀리면 저이도 몬나가요 안돼요	안 풀리면 저희도 못 나가요 안돼요
게 게다가 차가 여기 좀 만카네	게 게다가 차가 여기 좀 많아
아유  여 집찜마다 다 이따시피 헌데 뭘	아유  여기 집집마다 다 있다시피 한데 뭘
헌데 거기서 오는 늠드른 다 차몰고 온다 마리야	그런데 거기서 오는 놈들은 다 차 몰고 온단 말이야
차 차모는 거 웁음 또 뭐 어때	차 차몰 없으면 또 뭐 어때
그러면 환갑짠치는어트게 하셔써요	그러면 환갑잔치는어떻게 하셨어요
어어 한갑짠치 저 저 위에 항갑짠치 사진 걸려따구 마루에	어어 환갑잔치 저 저 위에 환갑잔치 사진 걸렸다고 마루에
봐떤 거다	아 봤던 거다
그이 하 한갑짠친 인천서 해찌	그이 화 환갑잔치는 인천서 했지
인천가서 하셔꾸나 인처네 저기 큰따니미 해주셔써요	인천 가서 하셨구나 인천에 저기 큰 따님이 해주셨어요
어 큰따니미 핸냐구	어 큰따님이 했냐고
에 인처네 따님 큰따님 계신다구	에 인천에 따님 큰따님 계신다고
어어 인처네 큰딸두 이꾸 아들두 이꾸 헌데	어어 인천에 큰딸도 있고 아들도 있고 한데
아들두 인천	아들도 인천
뭐 걔드리 해 준 저거 다름 읍찌 뭐	뭐 걔들이 해준 거나 다름 없지 뭐
그러며는 환갑 저는 환갑짠치 한 번두 안가봐꺼든뇨 환갑짠친 상을 어터게 차려요 보통	그러면 환갑 저는 환갑잔치 한 번도 안 가봤거든요 환갑잔치는 상을 어떻게 차려요 보통
어어 항갑잔치 상이라며는	어어 환갑잔치 상이라면은
예저니랑 요즈미랑 달라요	예전이랑 요즘이랑 달라요
글쎄 요조믄 뭐 내가 나이 머거시니겐 그런 데 가보지 아나서 모루간는데	글쎄 요즘은 뭐 내가 나이 먹었으니까 그런 데 가보지 않아서 모르겠는데
한갑짠치라구 하는 거슨 지그믄 간소와 마니 돼찌 근데	환갑잔치라고 하는 것은 지금은 간소화 많이 됐지 근데
예저네는 환갑까지 살면 굉장히 오래 산 거연는데  요새는	예전에는 환갑까지 살면 굉장히 오래 산 거였는데  요새는
아 저기 저 한번 그 사진 봐봐	아 저기 저 한번 그 사진 봐봐
그럭허구 뭐 행사허는 거 행사허는 건 자시 자식뜨리 저 부모에게 잔 올리먼서 절허는 거지	그렇게 허고 뭐 행사하는 거 행사하는 건 자시 자식들이 저 부모에게 잔 올리면서 절하는거지
그러면 이제 사라미 주그면 장례를 치르자나요 거면 요새는 이르케 마니들 그거 하자나요그 납꼴땅에 마니 이르케 하자나요 예저네는 무조껀 묘를 저짜나요  그러면 그 전통저긴그런게 어터게 돼요	그러면 이제 사람이 죽으면 장례를 치르잖아요 그러면 요새는 이렇게 많이들 그거 하잖아요그 납골당에 많이 이렇게 하잖아요 예전에는 무조건 묘를 지었잖아요  그러면 그전통적인 그런 게 어떻게 돼요
긴데 사라미 인제 일쌩일싸야 한번 나먼 한번 중는 건 정헌 이친데	그런데 사람이 인제 일생일사야 한번 나면 한번 죽는 건 정한 이치인데
사라미 어려서 인제 태어난다마랴	사람이 어려서 인제 태어난단 말야
태어나 노머는 그 어리 어리내가 세살까진 부모에 소니 가야만 키운다 마랴	태어나 놓으면 그 어리 어린애가 세 살까진 부모의 손이 가야만 키운단 말야
그러차나 저 세살 세살 더 머꾸 나서는 모르지만 세살까지는 까지는 기자구 가라 껴줘야 하구전 메겨야 돼구 응	그렇잖아 저 세 살 세 살 더 먹고 나서는 모르지만 세 살까지는 까지는 기저귀 갈아 껴 줘야되고 젖 먹여야 돼고 응
전부 부모가 가꿔서 기 길러야 덴다 마랴	전부 부모가 가꿔서 기 길러야 된단 말야
그냥 내뚜면 죽짜나	그냥 놔두면 죽잖아
헌데 부모가 도라가시먼 지그믄 그냥 사네서 그냥 댕일루 그냥  또 잘허는 사라믄 인제이 사밀만에 탈 그걸 보구 탈쌍한다 그래 이 상을 번는다구 허구 헌데	헌데 부모가 돌아가시면 지금은 그냥 산에서 그냥 댕일로 그냥  또 잘 하는 사람은인제 이 삼일만에 탈 그걸 보고 탈상한다 그래 이 상을 벗는다고 하고 그런데
예저넨 삼년상이야	예전엔 삼년상이야
게 삼년상을 왜 삼년상을 긴 그 삼년 똥아이나 긴 시가늘	그 삼년상을 왜 삼년상을 긴 그 삼 년 동안이란 긴 시간을
효 효자는 삼년 삼년똥아는 매일가지 성묘하구 상온닙구 이러커구 이따 마리지	효 효자는 삼 년 삼 년 동안은 매일같이 성묘하고 상옷 입고 이렇게 하고 있단 말이지
그 왜 그르 비담스럽게 하냐 마리지	그 왜 그러 유난스럽게 하냔 말이지
부모의 은더글 감는 거야	부모의 은덕을 갚는 거야
나 나 나 나서 우리 부모가 삼년똥아늘 그만큼 고생을 하셔꺼든	나 나 나 낳아서 우리 부모가 삼 년 동안을 그만큼 고생을 하셨거든
나두 부모의 그 으녜를 삼년똥아늘 가파주 가파야  도 도리 아냐	나도 부모의 그 은혜를 삼 년 동안을 갚아 주 갚아야  도 도리 아냐
그래서 삼년상이 이뜬 건데	그래서 삼년상이 있던 건데
지그믄 내 그 저 강이할 때 내 그러지	지금은 내 그 저 강의할 때 내 그러지
지금 왜 저러키니 도레 도레 버꾸 당일 버꾸 효도 왜 안하냐구 효도 바라지 마라 지그믄	지금 왜 저렇게 돌에 돌에 벗고 당일 벗고 효도 왜 안하냐고 효도 바라지 마라 지금은
엔나레는 그냥 전메기구 기자구 갈구 지그믄 나노면 그냥 송아지젇 가따 소 우유가따 드려 메겨노쿠선 무에 효도를 바라는가 마리지	옛날에는 그냥 젖 먹이고 기저귀 갈구 지금은 낳아 놓으면 그냥 송아지젖 갖다 소 우유갖다들여먹여놓고선 무에 효도를 바라는가 말이지
이런 얘기두 우스먼서 해찌마는	이런 얘기도 웃으면서 했지만
지그믄 시대가 이러케 배껴 근겐 인전 나만 노머는 엄마 웁서두 자라 응	지금은 시대가 이렇게 바뀌어 그러니까 이제는 낳아만 놓으면 엄마 없어도 자라 응
그냥 기자구나 좀 가라 채주고 인제 보살피문 되는 거이	그냥 기저귀나 좀 갈아 채워 주고 인제 보살피면 되는 거야
게 부모가 지금 부모 노르슬 다 모터고 인는 거야	그러니 부모가 지금 부모 노릇을 다 못하고 있는 거야
등안시해지 소오래 자시게게	등한시하지 소홀해 자식에게
그니 자식두 부모에 대해 소오랄 수바께 더이서	그러니 자식도 부모에 대해 소홀할 수밖에 더 있어
나는 그저 자시게게 아무러카곤 자식뜨른 내게 효도허라구 그거 부 불공평허지	나는 그저 자식에게 아무렇게 하곤 자식들은 내게 효도하라고 그거 부 불공평하지
그니겐 그 당시엔 그러게 돼서 인제 사라미 주그며는 제사를 열뚜번 지내	그러니깐 그 당시엔 그렇게 되어서 인제 사람이 죽으면 제사를 열두번 지내
아마 그 제사 이름 꼬부래먼 잘 꼼는 사람 웁슬꺼야	아마 그 제사 이름 꼽으라면 잘 꼽는 사람 없을 거야
거 한 번 꼬바 보까	그거 한 번 꼽아 볼까
저는 모꼬바요 꼬바주세요	저는 못 꼽아요 꼽아주세요
트키 자네드른 근 생각뚜 모털꺼지	특히 자네들은 그것은 생각도 못할 거지
주그믄 보통 처메 초완부터 모여 초완	죽으면 보통 처음에 초혼부터 모여 초혼
이제 성보글 해 성보기래는 건 보글 입끼 시자카는 거지	이제 성복을 해 성복이라는 건 복을 입기 시작하는 거지
또 고다메는 인제 이 이꽌 과네다 너머는 인제 이꽌예가 이찌	또 그 다음에는 인제 이 입관 관에다 넣으면 인제 입관례가 있지
또 그 과늘 하여간 시시는 가주구 움지긴 대루 고해야대 과늘 엥기게 대면 천 천고 강고 천강고	또 그 관을 하여간 시신은 가지고 움직인 대로 고해야 돼 관을 옮기게 되면 천 천고 감고
그리구 나서는 에에 뭐냐먼 조전 조저니라구 이서 조전	그리고 나서는 에에 뭐냐면 조전 조전이라고 있어 조전
조전 지내구 나서는 인제 바린 상여 나갈 나갈 나갈 때 바린	조전 지내고 나서는 인제 발인 상여 나갈 나갈 나갈 때 발인
바린 바리내 가먼 사네 가서 에 참파투 지내 산시네게 참파투 지내지	발인 발인해 가면 산에 가서 에 참파토 지내 산신에게 참파토 지내지
또 그거이 고 다메 이제 참파투 지내는 건 산시네게 여기 누구 가따 무끼 위애서 구데이 팜니다이 구슬 파니께는	또 그것이 고 다음에 이제 참파토 지내는 것은 산신에게 여기 누구 갖다 묻기 위해서 구덩이팝니다 이 곳을 파니까
그리군 이 시시는 제 하관허구 나선 바로 그다멘 평토라고 이서 그 평토 평토젤 지네	그리곤 이 시신은 이제 하관하고 나선 바로 그 다음엔 평토라고 있어 그 평토 평토제를지내
그 평토 평토 지내구나서는 뚜 뭐냐먼 거기서 인제 반혼제를 반혼 인제 도라감니다 마랴 인제도라감니다	그 평토 평토 지내고 나서는 또 뭐냐면 거기서 인제 반혼제 반혼 인제 돌아갑니다 말야인제 돌아갑니다
도 도라갑니다 하고 또 제 지내지 지비 와서는 또 초우젤 지내	도 돌아갑니다 하고 또 제 지내지 집에 와서는 또 초우제를 지내
초우제는 이제 사 초우 재우 사무 이러케 지내 지내거든	초우제는 이제 사 초우 재우 삼우 이렇게 지내 지내거든
그께 초우제 지내지 그 이 그 이튼날 아치메 재우제 지내지	그러니까 초우제 지내지 그 이 그 이튿날 아침에 재우제 지내지
그 다음 거 거 이틀랄 밤쭘 사무라 그먼 흐니 사흘마네 사을째 되는 날 지낸 줄 아는데 그건에유 잘몯 쌩가카는 거야	그 다음 거 거 이튿날 밤쯤 삼우라 그러면 흔히 사흘 만에 사흘째 되는 날 지낸 줄 아는데그건 에유 잘못 생각하는 거야
장사 지내구 이틀째 된 날 밤쭝에 지내는 거야 밤쭝에 거이 사무라구 하는 거야	장사 지내고 이틀째 된 날 밤중에 지내는 거야 밤중에 그것을 삼우라고 하는 거야
그니 이러케 되먼 열뚜버니 되는 거지	그러니 이렇게 되면 열두번이 되는 거지
그이 지내는데 왜 지사는 바메 지내냐	그 지내는데 왜 제사는 밤에 지내냐
시는 구시는 어둔 걸 조아해 엉 발근 걸 시러허거든	신은 귀신은 어두운 걸 좋아해 응 밝은 걸 싫어하거든
게 도깨비 놀다두 다기 울고 개가 지즈먼 웁써진다구 허자나 그게 시는 시는 발근 걸 시러허구  어둔걸 조아하기 때메 밤쭝	그러니 도깨비 놀다가도 닭이 울고 개가 짖으면 없어진다고 하잖아 그게 신은 신은 밝은걸 싫어하고 어두운 걸 좋아하기 때문에 밤중
게 그걸 조아하기 때메 밤쭝에 제사는 그니 바메 지내자나 이치가 그런 거야	그러니 그걸 좋아하기 때문에 밤중에 제사는 그러니 밤에 지내잖아 이치가 그런 거야
그럼 이러케 지구 가면서 왜 노래두 부르구  에에 운구하는소리 어트게 내요 뭐	그럼 이렇게 지고 가면서 왜 노래도 부르고  에에운구하는 소리 어떻게 내요 뭐
아 그건 자 자기드리 자 자이 저이들 맘대루 꾸며서 부 허는 거야 건 뭐 뭐  노 노래마냥가사가 인는 거이 아냐	아 그건 자 자기들이 자 자이 자기들 맘대로 꾸며서 부 하는 거야 건 뭐 뭐  노노래마냥 가사가 있는 것이 아냐
그러며는 겨론해쓸 때에는 그 잔치국쑤 머거짜나요  그면 장녜애쓸 때에는 뭐 머거써요	그러면 결혼했을 때에는 그 잔치국수 먹었잖아요  그러면 장례했을 때에는 뭐 먹었어요
어 국빠비야  그래 으응	어 국밥이야  그래 으응
초상에는 정시넙꾸 국빠베만 정시이꾸	초상에는 정신없고 국밥에만 정신있고
저 저레 저러키니 불공 드리러 가먼 저 정 정성엔 정시넙꾸 제빱 그 또 저레선 제빠비라구 해	저 저래 저랬으니 불공 드리러 가면 저 정 정성엔 정신없고 젯밥 그 또 절에선 젯밥이라고 해
제빠베만 정시니때는 그 속따메들 허 얘기허자나  제빠비 저레서 하는 거야	젯밥에만 정신판 그 속담에들 허 얘기하잖아  젯밥이 절에서 하는 거야
그러면 제사 음시기랑 그런 거는 다 이제 며느리나 이제 어머니미랑 이러케 다 해가주구 다바치구 사람들 나나주구	그러면 제사 음식이랑 그런 거는 다 이제 며느리나 이제 어머님이랑 이렇게 다 해가지고 다바치고 사람들 나눠주고
그러지 나너멍는 거지	그렇지 나눠먹는 거지
제사는 그럼 제사에는 저이는 잘 모르는데요 제사 이러케 음식 상을 아까두 여쩌봔는데 어느음시기 어느쪼게 꼭 가야되고  불근 음시근 이쪼게 가야대고 뭐 이케 뭐라고 하자나요 응동일  진설 그이 진서리라구 해 진설 진설 그게 어트게 돼요	제사는 그럼 제사에는 저희는 잘 모르는데요 제사 이렇게 음식 상을 아까도 여쭤 봤는데어느 음식이 어느 쪽에 꼭 가야 되고  붉은 음식은 이쪽에 가야 되고 뭐 이렇게 뭐라고하잖아요 응 동일  진설 그것을 진설이라고 해 진설 진설 그게 어떻게 돼요
진서를 허는데 지금 여기서 허는 진서러고 여이 테레비 나온 인제 설라리나 추서게 인제 제사쌍차린 그 인제 진설한 거 나온다 마랴 근데	진설을 하는데 지금 여기서 하는 진설하고 여기 텔레비전에 나온 인제 설날이나 추석에 인제제삿상 차린 그 인제 진설한 거 나온단 말야 근데
거기 그 사람드리 하는 거터고 여기 교동에 허는 사람드러군 참 시기 달라	거기 사람들이 하는 것하고 여기 교동에 하는 사람들하곤 참 식이 달라
고장마다 조금씩 다르고	고장마다 조금씩 다르고
에 그리 근데 요거는 가타 홍동백써  조율이시  조유리시 외정내탕 어동육써	에 그리 그런데 이것은 같아 홍동백서  조율이시  조율이시 외적내탕어동육서
고그 그거는 그거는 가 말루는 가튼데 노는 위치가 달라저	고그 그거는 그거는 가 말로는 같은데 놓는 위치가 달라져
조금씩 위치도  음식뚜 그니까 종류두 그 지방에서 나는 생서느루 올라가니까 그 그러치 그거뚜 조금씩 달라지구  그러치 고거 뚜 좀 달르구 으응	조금씩 위치도  음식도 그러니까 종류도 그 지방에서 나는 생선으로 올라가니까 그그렇지 그것도 조금씩 달라지고 그렇지 그것도 좀 다르고
그럼 여기에는 뭐뭐 올라가요 교동은	그럼 여기에는 뭐뭐 올라가요 교동은
도라가신 지 아버지랑 어머니 제사 지낸다 마리지 논는 순서는 아무러케 놔도 된다	돌아가신 지 아버지랑 어머니 제사 지낸다 말이지 놓는 순서는 아무렇게 놔도 된다
아니 뭐 뭐 그 논는 순서 모르는 사라믄 지사두 모찌내게	아니 뭐 뭐 그 놓는 순서 모르는 사람은 제사도 못 지내게
제술 장만헐 때 마니 장마나면 더 조치먼	제수를 장만할 때 많이 장만하면 더 좋지만
살리미 비 저러키 비나나며는 마니 장마날 수 웁서	살림이 비 저렇게 빈한하면 많이 장만할 수 없어
한 가지 두 가지 장마내때두 내 정성껃 내 성이껃 제수 장마내가지구 내 정성껃 부모에 제살드려라	한 가지 두 가지 장만했대도 내 정성껏 내 성의껏 제수 장만해가지고 내 정성껏 부모에게제사를 드려라
그리 그리먼 그거시 바루 효 정성이다	그리 그러면 그것이 바로 효 정성이다
그냥 마니 차려노쿠 이깐 뭐 지사 지내 무해 응 메누리가 지 저 지사음식 만들며 이까이꺼뭐 이거 무슨 노무 지살 지낸다구 이러먼 그이 뱅만가지 상 차려놔 봐야 그건 불경이야	그냥 많이 차려놓고 이깟 뭐 제사 지내 뭐해 응 며느리가 지 저 제사음식 만들며 이까짓꺼뭐 이거 무슨 놈의 제살 지낸다고 이러면 그것이 백만가지 상 차려놔 봐야 그건 불경이야
그니까 하나를 차려두 내 성이가 드러가구 정성이 드러간 거 응	그러니까 하나를 차려도 내 성의가 들어가고 정성이 들어간 거 응
그 음식 노쿠 내 정성껃 성이껃 제사 지내먼 그거시 효도다 이거지	그 음식 놓고 내 정성껏 성의껏 제사 지내면 그것이 효도다 이거지
그러면	그러면
근데 예저넨 그거이 아니야	그런데 예전엔 그것이 아니야
이 저어키니 소상 대상 왜 그 주근지 일련마네 지 지 고 일련되는 그 도라가신 날 그날 지내는걸 소상이라 그래	이 저어기 소상 대상 왜 그 죽은 지 일 년 만에 지 지 고 일 년 되는 그 돌아가신 날 그날지내는 걸 소상이라 그래
그리구 삼년째 되는 그날 가따 대상이라구 그이 대상 지나먼서 탈쌍을 허지 인제 그땐 상오슬다 버서 태워버리구	그리고 삼 년 째 되는 그날을 대상이라고 하고 그리고 대상 지나면서 탈상을 하지 인제 그땐상옷을 다 벗어 태워버리고
근데 소대상이믄 그리 상 차라 노쿠 이 상주는 에고에고 하구 인제 고글 허먼 조문 조객뜨리온다 마랴	그런데 소 대상이면 그리 상 차려 놓고 이 상주는 에고에고 하고 인제 곡을 하면 조문 조객들이온단 말야
조객뜨리 오머는 이 드러서 제청에 드러서 조문 얼른 조문허는 게 아니라 이 지사쌍 차려논거부터 휘 둘러봐	조객들이 오면은 이 들어와서 제청에 들어서 조문 얼른 조문하는 게 아니라 이 제삿상 차려놓은것부터 휘 둘러봐
이 지바네두 제대루 저 진설헐 줄 아는 사라미 인나 움나 이거 아는 유세를 그거 우리 조상드른그 습꽈니 망허다는거야	이 집안에도 제대로 저 진설할 줄 아는 사람이 있나 없나 이거 아는 유세를 그거 우리 조상들은그 습관이 망하다는 거야
점 안 점 안대는 사라믄 모르는 사람 무시해치구 만다 마랴	좀 안 좀 안대는 사람은 모르는 사람 무시하고 만단 말이야
그 그걸 때메 이거 여기두 진설 조그미라두 허는 사라미 인나 엄나 하구 휘 도라보군	그 그것 때문에 이거 여기도 진설 조금이라도 하는 사람이 있나 없나 하고 휘 돌아보곤
우리 조상드리 그 근성이 틀려서	우리 조상들이 그 근성이 틀렸어
뭐 아무러케나 놔슴 어더킬래 근 디려다보구 뭐 그 나미 지사에 왜 나미 지사에 감 나라 배나라 해 그자나	뭐 아무렇게나 놔두면 어떻길래 그걸 들여다보고 뭐 그 남의 상에 왜 남의 상에 감놔라 배놔라해 그렇잖아
근데 진설도이가 조율이시루 인는 데가 이꾸 조율시이가 이 이는 뭐냐먼 배 이 시는 감 시짜거든	그런데 진설도가 조율이시로 있는 데가 있고 조율시이가 이 이는 뭐냐면 배 이 시는 감 시자거든
가미 먼저 드러가는 데가 이꾸 배가 먼저 드러가는 데가 이서	감이 먼저 들어가는 데가 있고 배가 먼저 들어가는 데가 있어
그니 나미 지사에 뭐 감나라 배나라 해	그러니 남의 상에 뭐 감놔라 배놔라 해
그래서 감놔라 배놔라구나	그래서 감놔라 배놔라구나
그러치 그거이 그 그래서 뭘 허먼 그 나미 지사에 뭐 감나라 배나라를 왜 해	그렇지 그게 그 그래서 뭘 하면 그 남의 상에 뭐 감놔라 배놔라를 왜 해
그 그마리 거기 인는 거야	그 그 말이 거기 있는 거야
그러쿠나	그렇구나
그러믄 교동은 교동에 싸리 되게 유명하자나요 벼가  그러며는 이게 다른 거에요 품종이벼 품종이 지역마다	그러면 교동은 교동에 쌀이 되게 유명하잖아요 벼가  그러면 이게 다른 거에요 품종이벼 품종이 지역마다
품종이 교동에두 마나  그럼	품종이 교동에도 많아  그럼
교동 쌀 뭐라고 하던데 이르미 이떤데	교동 쌀 뭐라고 하던데 이름이 있던데
고품 고시히까리  저 추청 인 저 아끼바리  저 고시히까리	고품 고시히카리  저 추청 인 저 아끼바리  저 고시히까리
고시히까리 드러본 거 가태요 교동 해가지구	고시히까리 들어본 것 같아요 교동 해가지고
그럼 벼 농사는 그 품종에 상관 업씨 여기는 그 건판	그럼 벼 농사는 그 품종에 상관 없이 여기는 그 건판
지그믄 건파 웁찌	지금은 건파 없지
지그믄 건파 업꾸	지금은 건파 없고
아우 웁찌 누가 건파를 해  그럼 아이 무리 무리 사방에 철렁철렁한데 이제 저수지 마나서 그럼	아우 없지 누가 건파를 해  그럼 아이 물이 물이 사방에 철렁철렁한데 이제 저수지 많아서 그럼
이제 건파는 몰라	이제 건파는 몰라
이제는 어떠케 해요 이젠 건파 안하고 모  모 놔따가	이제는 어떻게 해요 이젠 건파 안하고 모  모 놨다가
모는 모두 모허는데두 상자가 이서	모는 모두 모한대도 상자가 있어
여그여그 퇘똘 미테 두구 그저네 상자가 이찌만 지그문 농사 모찌니께는 쓰질 안치만	여기여기 툇돌 밑에 두고 그전에 상자가 있지만 지금은 농사 못 지으니깐 쓰질 않지만
그 상자에다가 보메 어득카냐면 상 그니겐 펴나난 거야 펴나내	그 상자에다가 봄에 어떡하냐면 상 그게 편안한 거야 편안해
그저넨 흐글 파다 핸는데 인젠 흑뚜 안파구 상토흐글 사와	그전엔 흙을 파다 했는데 인젠 흙도 안 파고 상토흙을 사와
상토흑 상토흐글 여이 파 파는 걸 농여베서 이 사다 줘	상토흙 상토흙을 여기 파 파는 걸 농협에서 이 사다 줘
그믄 돈만 내믄 되는 그야	그러면 돈만 내면 되는 거야
상토흐게다가 베씰 그거뚜 기게루 허는 거야 사라미 허는 게 아니라 그거이	상토흙에다가 볍씨를 그것도 기계로 하는 거야 사람이 하는 게 아니라 그것이
기게다 이 이러이 상자 이러케 기게다 너머는 이게 상자가 죽 가먼 여기서 상토흐기 떠러저가지구요 쪼끔 가먼 씨가 요기 놔지구	거기다 이 이렇게 상자 이렇게 기계에다 넣으면 이게 상자가 죽 가면 여기서 상토흙이 떨어져가지고 요 조금 가면 씨가 요기 놔지고
또 조쯤 나가먼 더플 덥꾸	또 저기쯤 나가면 덮을 덮고
기니껜 씨 놔서 더픈 거 사라미 가따 인제 가따 싸키만 허는 거야	그러니깐 씨 놔서 덮은 거 사람이 가져다 인제 갖다 쌓기만 하는 거야
싸으먼 고그 요 며칠 가머는 바라가 되거든 싸기 요러케 나오거든	쌓으면 거기 요 며칠 가면 발아가 되거든 싹이 요렇게 나오거든
거 쌍나먼 노네 가따 모짜리에다 가따 이 죽 놔	그거 싹 나면 논에 갖다 못자리에다 갖다 이 죽 놔
노 노믄 거기서 이제 거 비닐 위에 씨어 씨워 노면 거기서 자라거든	노 놓으면 거기서 이제 그거 비닐 위에 세워 세워 놓으면 거기서 자라거든
자라다가 이마쿰 자라며는 그땐 노 노네 물 저 나라시러지	자라다가 이만큼 자라면 그땐 노 논에 물 저
로타리 놔서 쪽 고르게 맨든 거 기게가 와서 그이 상자에 띠어다가 기게 위루 노쿤 기게 노쿤기게 물른 위 기게 위 안자서 죽 몰구 가먼 뒤에가 다 꼬치는 거지 머	로타리 놔서 쪽 고르게 만든 거 기계가 와서 그이 상자에 떼어다가 기계 위로 놓고 기계 놓고기게 놓고 그냥 기계 위 기계 위 앉아서 죽 몰고 가면 뒤쪽이 다 꽂히는 거지 뭐
농사꾸니 젤 펴나내 도시싸람덜 그저넨 저이 그 건파 매구 보리마당 이러구	농사꾼이 제일 편안해 도시 사람들 그전엔 저기 그 건파 매구 보리마당 이러구
이루 말 모터지 보리마당 하면 따미 비 비오드터는데 그 껄꺼란 거 이거 저러키니 땀 쏘게서보리 태지러구 그럴러먼 증말 연날 옌날 하라버이들 고생 무척 헌 거야	이루 말 못하지 보리마당 하면 땀이 비 비오듯 하는데 그 껄껄한 거 이거 저렇게 땀 속에서보리 태질하고 그럴려면 정말 옛날 옛날 할아버지들 고생 무척 한 거야
데 도시싸람드른 아치메 나가 출그내가지구 가서 돈버느라구 무슨 나미 나미 회사에 가서 나미눈치 보구	그런데 도시 사람들은 아침에 나가 출근해 가지고 가서 돈 버느라구 무슨 남의 남의 회사에가서 남의 눈치 보구
이건 뭐 눈치 볼 껀 무어 이서 내 맘대루 자구시프먼 자구 놀구시프먼 놀구	이건 뭐 눈치 볼 것 뭐 있어 내 맘대로 자고 싶으면 자고 놀고 싶으면 놀고
이 농촌 사람드리 젤 펴나내	이 농촌 사람들이 젤 편안해
지금 봐 도시싸람들 지금 전부 출그내가지구 이 전부 가서 인제 일허구 인제 헐 꺼라구	지금 봐 도시 사람들 지금 전부 출근해가지고 이 전부 가서 인제 일하고 인제 할 거라고
여기 아래 인는 게이트볼 장에 가봐 자네거튼 절믄 여자들 서서 이 게이트볼 친다구	여기 아래 있는 게이트볼 장에 가봐 자네 같은 젊은 여자들 서서 이 게이트볼 친다구
즘스믄 떠꾸캐다 노쿠선 즘슴 끄려머꾸 이르케 펴난해	점심은 떡국해다 놓고선 점심 끓여 먹고 이렇게 편안해
예저네는 그 무리 업써서 힘드런는데	예전에는 그 물이 없어서 힘들었는데
그럼 아이 무리 마느니께는	그럼 아이 물이 많으니까
이젠 물 그럼 물 어트케 여기까지 다 끌구와요 뭐 이케	이젠 물 그럼 물 어떻게 여기까지 다 끌고 와요 뭐 이케
아이 수로가 이찌 그럼 그 수로루 다	아이 수로가 있지 그럼 그 수로로 다
논마다 수로 저 가선 요 요러케 문짱만 열면 무리 쾅쾅  응	논마다 수로 저기 가서는 이 이렇게 문짝만 열면 물이 콸콸  응
나메 노네 물	남의 논에 물 아우 물도둑찌를 왜 그래 업찌 그이 물도둑찌른 아유 무리 펑펑 나리는데 나미 노네 무를아우 물도둑질을 왜 그래 없지 그게 물도둑질은 아유 물이 펑펑 내리는데 남의 논에 물을
옌나레는 이 그 저 운노네 물 이스먼 바메 나가서 슬그머이 터러서 허구 해찌만	옛날에는 이 그 저 웃논에 물 있으면 밤에 나가서 슬그머니 틀어서 하고 했지만
지그믄 무리 그냥 저러케 헤갈려 인네 뭐	지금은 물이 그냥 저렇게 흔한데 뭐
옌나레 건파할 시저레는 무를 어터케 해써요 무를 그 그때두 그래두 무를 끌구 와야 되저	옛날에 건파 할 시절에는 물을 어떻게 했어요 물을 그 그때도 그래도 물을 끌고 와야 되죠
끌구 오긴 뭘 끌구 와 무리 이서야 끄러오지 하느레서 비 떠러저야지 그럼 천수다비야 그거이	끌고오긴 뭘 끌고 와 물이 있어야 끌어오지 하늘에서 비 떨어져야지 그럼 천수답이야 그것이
하느레서 비 줘야지 비 어서 어디에 무슨 무리 이서서 무를 끄러와  그러치 거 하늘만 처다보구 인는 거지 머	하늘에서 비 줘야지 비 어서 어디에 무슨 물이 있어서 물을 끌어와  그렇지 거 하늘만 쳐다보구 있는 거지뭐
뭐 이러케 뭐 이러케 뭐 펌프루 뭐 이러케 하구 그런 거 업써써요	뭐 이렇게 뭐 이렇게 뭐 펌프로 뭐 이렇게 하고 그런 거 없었어요
그 그 그거뚜 이 글려네	그 그 그것도 이 근년에
요 글려네 와서 지아수라구 그거뚜 좀 머리가 발딸되니께는 이 땅쏘그루 뚤쿠서는 응 빠이프디려 바가가지구 기게루다 뽀바 올리는 거지	요 근년에 와서 지하수라고 그것도 좀 머리가 발달되니까 이 땅속을 뚫고서는 응 파이프 들여박아가지고 기계로 뽑아 올리는 거지
그거뚜 이 글려네 생긴 거야 이 글려네	그것도 이 근년에 생긴 거야 이 근년에
그 왜 초벌 매구 두벌 매구 뭐 아이 매구 뭐 이런	그 왜 초벌 매구 두벌 매구 뭐 아이 매구 뭐 이런
애 매구 두벌 매구 애 애 첨 매는 걸 애 맨다구 허지	애 매구 두벌 매구 애 애 처음 매는 걸 애 맨다고 하지  처음엔 애 맨다 그래요
애불 맨다구 허는 거야	애불 맨다구 하는 거야
왜 왜 애 맨다 그래요	왜 왜 애 맨다 그래요
첨 매는 걸 가주구 애불 맨다 그래	처음 매는 걸 가지고 애불 맨다 그래
그 뭐가 달라요 애불 매는 거랑 두벌 매는 거랑	그 뭐가 달라요 애불 매는 거랑 두벌 매는 거랑
애불 매는 덴 에유 건 베 시머노쿠서 츰 인제 매니껜 기미 다 요이 자질구레헌 건 마니 나오지고거이 애불 매는 거구	애불 매는 덴 에유 건 벼 심어 놓고서 처음 인제 매니깐 김이 다 요이 자질구레한 건 많이나오지 그것이 애불 매는 거고
두부레는 기미 저 빠져떤 기미 자라올라오니깐 기미 크지	두벌에는 김이 저다 빠졌던 김이 자라 올라오니깐 김이 크지
그래서 기미 다 업써질 때까지 애불 매고  두불 매구 세불 매구	그래서 김이 다 없어질 때까지 애불 매고  두불 매고 세불 매고
세 세불까지 맬 수 인는 시가니 업찌	세 세불까지 맬 수 있는 시간이 없지
그럼 여기는 싸리 유명해서 노니 마는데 그럼 바슨 업써요	그럼 여기는 쌀이 유명해서 논이 많은데 그럼 밭은 없어요
여기 교동에는 받뽀덤두 노니 마나	여기 교동에는 밭보다도 논이 많아
검 바슨 별루 엄네요	그럼 밭은 별로 없네요
아이 바뚜 이낀 이찌머는  그러찌 고구마는 바테 심는거지 콩이나 고구마는 바테 심는 거	아이 밭도 있긴 있지만  그렇지 고구마는 밭에심는 거지 콩이나 고구마는 밭에 심는 거
그러면 고구마는 어터케 해요 바세서	그러면 고구마는 어떻게 해요 밭에서
고구마 고구마 고구마는 그 아네 수머이짜나요 이러케 입싸귀 크게 나고  그러며는그거를 이러케 이랑 고랑 마처가지구 그거는 그거뚜 이러케 기게 있아이 아이야 그건 소느루그건 소느루 해요	고구마 고구마 고구마는 그 안에 숨어 있잖아요 이렇게 잎사귀 크게 나고  그러면그거를 이렇게 이랑 고랑 맞춰 가지고 그거는 그럿도 이렇게 기계 안에 있 아이 아니야그건 손으로
건 받 이랑은 기게루다 맨들지 반니랑은 기게루다 맨든데 심는 건 소느루다 심는 거야	건 밭 이랑은 기계로 만들지 밭이랑은 기계로 만드는 데 심는 건 손으로 심는 거야
그러면 요새는 예저네는 반농사가 더 쉬워쓸쓰두 인는데 요새는 논농사가 훨씬 쉽껜네요 요새는기 논농사는 기게루 다 할수 이쓰니	그러면 요새는 예전에는 밭농사가 더 쉬웠을 수도 있는데 요새는 논농사가 훨씬 쉽겠네요요새는 기 논농사는 기계로 다 할 수 있으니
그럼	그럼
반농사도 김 매요	밭농사도 김 매요
어 그럼 반농사도 기 김매 바텐 김 안 나나	어 그럼 밭농사도 기 김 매 밭엔 김 안 나나
금 반농사도 애불매고	그럼 밭농사도 애불 매고
아 그 그럼  그 근데 지그믄 바테두 반니랑에다 전부 비니를 씨어 뻐려	아 그 그럼  그 그런데 지금은 밭에도 밭이랑에다 전부 비닐을 씌워버려
그러면 기미 안나나	그러면 김이 안 나나
비니루 씬데 비니루 어트게 기 기미 나오나 몬나오지	비닐을 씌워 놨는데 비닐로 어떻게 기 김이 나오나 못 나오지
그믄 왜 바세 이케 콩 심꼬 고구마 심꼬 하면 그니까 노네서 벼는 일려늘 가을까지 죽 애가자라야 하니까 모타는데 이제 고구마나 콩 가튼 거는 서리해오고 그러자나요	그러면 왜 밭에 이렇게 콩 심고 고구마 심고 하면 그러니까 논에서 벼는 일년을 가을까지죽 애가 자라야 하니까 못 하는데 이제 고구마나 콩 같은 거는 서리해오고 그러잖아요
나미꺼	남의 꺼
응 아니면 자기집 거뚜 도중에 이르케 아버지 몰래 이러케 서리 해오 아니	응 아니면 자기집 것도 도중에 이렇게 아버지 몰래 이렇게 서리 해오 아니
제 꺼야 뭐러이허든 거 서리래는 건 도둑찌린데	제 꺼야 뭘 어이 하든 거 서리라는 건 도둑질인데
서리 서리	서리 서리
서 서리랜 남 모 몰래 가서 개오는 거 서리라 헌다 마랴  쪼끔 말 딛끼 조으라구  도둑지리라구 허잔쿠 서리한다 그르지	서 서리란 남 모 몰래 가서 가져오는 걸 서리라고 한단 말야  조금 말 듣기좋으라고 도둑질이라고 하지 않고 서리한다고 그러지
그러쿠나 그럼 교동에선 서리 별루 아내 아나셔써요	아 그렇구나 그럼 교동에선 서리 별로 안 해 안 하셨어요
그저네는 고구마나 그런 거뚜 서리두 야깐 이찌머는 그저넨 여기다 채밀 마니 놔서	그전에는 고구마나 그런 것도 서리도 약간 있지만 그전엔 여기다 참외를 많이 놨어
채미	참외
어어 기니껜 건파만 부치니께는 노니 전부 무거	어어 그러니까 건파만 붙이니까 논이 전부 묵어
무근껜 물 잘 빠지는 덴 이 하느레서 비가 와두 무리 잘 빠져야 바슬 허지	묵으니까 덴 물 잘 빠진 데는 이 하늘에서 비가 와도 물이 잘 빠져야 밭을 하지
기니 그런데는 이 콩두 심구 채밀 마니 심지	그러니 그런 데는 이 콩도 심고 참외를 많이 심지
에 채미 시믄 원두마기 수읍씨 거 지킨다구 마글 지어노쿠는	에 참외 심은 원두막이 수없이 거 지킨다고 막을 지어 놓구는
그런 덴 채미 서리라구 해 그건 절믄 사람들 뫼야안자서 야 우리 채미서리 가자 마랴	그런 덴 참외 서리라고 해 그건 젊은 사람들 모여 앉아서 야 우리 참외서리 가자 말야
그 나미 바테 드러가선 따다 멍는 거 그걸 그걸 보고 서리라 구래는 거야	그 남의 밭에 들어가선 따다 먹는 거 그걸 그걸 보고 서리라고 하는 거야
그 왜 어제 어젠지 어끄젠지 말씀하실 때 왜 무슨 방아는 살만하게 보리방아는 힘들지 뭐그러셔짜나요  그게 방아사 보리방아랑 또 모가 이써요 방아가	그 왜 어제 어젠지 엊그젠지 말씀 하실 때 왜 무슨 방아는 살만하게 보리방아는 힘들지뭐 그러셨잖아요  그게 방아가 보리방아랑 또 뭐가 있어요 방아가
보리 보리방안가 보리방아뿌니가 베두 방아 쩌야지	보리 보리방아인가 보리마방뿐인가 벼도 방아 찧어야지
그 방아두 종류가 여러가지가 이짜나요	그 방아도 종류가 여러가지가 있잖아요
베 베방아 베 이 글려네 이 그거뚜 이 글려네 생긴 거야 이제 발똥기라고	벼 벼방아 벼 이 근년에 이 그것도 이 근년에 생긴 거야 이제 발동기라고
기게가 도라가문서 해서 싸를 이러케 뽀바내 맨드러내는데 그저네는 그거이 아냐	기계가 돌아가면서 해서 쌀을 이렇게 뽑아내 만들어내는데 그전에는 그것이 아냐
쌀두 이 베두 탈고캐서 인제 이 베아를 거둬노먼 그걸 절 절구에다 찌어야 대 싸를	쌀도 이 벼도 탈곡해서 이제 이 벼알을 거둬놓으면 그걸 절 절구에다 찧어야 돼 쌀을
그럼 밀방아 보리방아 뭐 이르케  인는 거죠 그게 좀 다르죠 어트게 달라요 하는거	그럼 밀방아 보리방아 뭐 이렇게  있는 거죠 그게 좀 다르죠 어떻게 달라요 하는거
아이 찐는 건 다 마찬가지지	아이 찧는 건 다 마찬가지지
모양두 또까꾸요	모양도 똑같고요
그르치 그 절구에 너쿠서 그 도 돌구에다 찐는 거지 머	그렇지 그 절구에 넣고서 그 도 돌구에다 찧는 거지 뭐
그럼 밀방아랑 보리방아랑 또까튼 거에요 그럼	그럼 밀방아랑 보리방아랑 똑같은 거에요 그럼
그러면 그런 건 다른 거자나요 그냥 뭐 디딜방아  물레방아 연자방아 이런 거다르게 생긴 거죠 다	그러면 그런 건 다른 거잖아요 그냥 뭐 디딜방아  물레방아 연자방아 이런 건다르게 생긴 거죠 다
디딜방아는 발루다 이러는 거이 디딜빵아	디딜방아는 발로 이러는 것이 디딜방아
물레방아는 저이 무자위 모냥 무리 도라가서 이 쿵덕쿵덕 허는 게 물레방아	물레방아는 저기 무자위 모양으로 물이 돌아가서 이 쿵덕쿵덕 하는 게 물레방아
앤데 여긴 그런 거이 웁 연자방안 이서서	그런데 여긴 그런 것이 없 연자방아는 있었어
연자방안 머에요	연자방아는 뭐에요
연자방아연자방아는 미테 그이 매또리야 매똘 그거이 매라고 아나	연자방아연자방아는 밑에 그것이 맷돌이야 맷돌 그것이 매라고 아나
에 이르케 이러케  응	에 이렇게 이렇게  응
매또리야 그런 매또리 크지 이 미테가 커	맷돌이야 그런 맷돌이 크지 이 밑에가 커
크군 우이가 뚱그런 도 동매야 그건 동매가 이서가지구 여기 가운데 기둥을 시구 여기인제이 동매 구녀글 뚜러가지구 구 그러키니 연겨를 시켜야 된다마랴	크고 위가 동그런 도 돌멩이야 그건 돌멩이가 있어가지고 여기 가운데 기둥을 세우고 여기인제 이 돌멩이 구멍을 뚫어 가지고 그 그렇게 연결을 시켜야 된단 말야
연결시켜노쿠 옆싸라미 막때기를 매노콘 소 소를 이제 이 막때기다 미구서는 소를 모라	연결시켜 놓고 옆사람이 막대기를 매 놓고 소 소를 이제 이 막대기에다 매구서는 소를 몰아
소 몰머는 이거이 이러구 한 쪼근 조꾸 한쪼근 이러 널브니껜 이러이 빙빙 돌꺼 아냐	소 몰면 이게 이렇고 한 쪽은 좁구 한쪽은 이러 넓으니까 이렇게 빙빙 돌 거 아냐
이러케 이러이 빙빙빙빙 도는 거야 그거이 연자방아야	이렇게 빙빙빙빙 도는 거야 그것이 연자방아야
연자방아가 제일 펴나겐네요 사람 히미	연자방아가 제일 편하겠네요 사람 힘이
그르치 그이 연자방아 인제 그냥 이 이러카면 이 삐져나오거든 기니껜 인제 거 거무래 가지구이래 디려 디려 미러만 주먼 되는 거지	그렇지 그 연자방아 인제 그냥 이 이렇게 하면 이 삐져나오거든 그러니까 인제 고 고무래가지고 이렇게 들여 들여 밀어만 주면 되는 거지
그러면 곡씨글 이케 타자글 하자나요 타작하구나서 이케 갈무리를 이르케 벼를 걸 어트게이르케 해요	그러면 곡식을 이렇게 타작을 하잖아요 타작하고 나서 이렇게 갈무리를 이렇게 벼를 그걸어떻게 이렇게 해요
옌나레는 그걸 일리리 이르케 어트케 싸아써요 요새는 기게로 싸아주죠	옛날에는 그걸 일일이 어떻게 쌓았어요 요새는 기계로 쌓아주죠
싸아	쌓아
기 벼 일케 다 추수하구 나서 나믄 걸  옌나레는 일이리 손으루 이러케 무꺼써요	기 벼 이렇게 다 추수하고 나서 남은 걸  옛날에는 일일이 손으로 이렇게 묶었어요
묵꺼찌 소느로 무꺼찌 머	묶었지 손으로 묶었지 뭐
일이리 이러케 다 주서서 하시고  요새는 어트게 요새는 기게루 그냥 다 해주저	일일이 이렇게 다 주워서 하시고  요새는 어떻게 요새는 기계로 그냥 다 해주죠
아이 지그믄 무꾸 자시구 할 꺼이 웁써	아이 지금은 묶고 자시고 할 게 없어
저 베 이러게 자라먼 콤바이 가따 드리대먼 콤바이가 이러이 쭉 지나가먼 여기서 이 비자나	저 벼 이렇게 자라면 콤바인 갖다 들이대면 콤바인이 이렇게 쭉 지나가면 여기서 이 베잖아
비먼 이노미 이러이 올라가서 탈고글 해 기게에서	베면 이놈이 이렇게 올라가서 탈곡을 해 기계에서
여기서 탈곡허먼 여기서 또 불려 기게에서 근 비먼서 이제 탈고캐서 불리머는 요이 알매이만욜루 쏙 빠져나와	여기서 탈곡하면 여기서 또 불려 기계에서 근 베면서 인제 탈곡해서 불리면 요 알맹이만이리로 쏙 빠져나와
알매이만 쏙 빠져나오먼 알매미 거이 큰 잘래기에다 다마서 건조기루 바루 시 싸간다 마랴	알맹이만 쏙 빠져나오면 알맹이 그걸 큰 자루에다 담아서 건조기로 바로 쌓아간단 말야
건조기에 가면 건조기서 딱 마려서 그냥 싸아놔두지 뭐	건조기에 가면 건조기서 딱 말려서 그냥 쌓아놔 두지 뭐
기면 가서 저거 우리 거기 좀 도정해 찌어	그러면 가서 저거 우리 거기 좀 도정해 찧어
허먼 싸 쌀루 나오는 거지 아이 서서 소꾸락찔만 하믄 돼 그럼	하면 싸 쌀로 나오는 거지 아이 서서 손가락질만 하면 돼 그럼
그러며는 옌나레는 겨우레 머글 음시글 따루 저장애놔짜나요  요새는 그냥 뭐 다 비닐하우스에서 겨울려름 뭐 할 꺼 업씨 나오는데 응	그러면 옛날에는 겨울에 먹을 음식을 따로 저장해 놨잖아요  요새는 그냥 뭐 다 비닐하우스에서 겨울 여름 뭐 할 거 없이 나오는데 응
그러며는 여기두 이르케 뭐 파서 어디다 너노쿠 그래써요	그러면 여기도 이렇게 뭐 파서 어디다 넣어 놓고 그랬어요
아아  땅 파서 뭐 곡씨글 땅파서 무찐 안쿠	아아  땅 파서 뭐 곡식을 땅 파서 묻진 않고
겨우레 머글꺼 인제 쌀 거튼 건 인제 지 뭐 글쎄 쌀 마니두 머 아나니께 이거 찌 찌어서 멍는거니껜 조금씩 찌먼 도기짜나 독	겨울에 먹을 거 인제 쌀 같은 건 인제 지 뭐 글쎄 쌀 많이도 뭐 안 하니까 이거 찌 찧어서먹는 거니까 조금씩 찧으면 독 있잖아 독
도게 너노 너노쿠 멍는 거지 뭐	독에 넣어 넣어 놓고 먹는 거지 뭐
그러면 여기 전기 드러온지 한 이심년	그러면 여기 전기 들어온 지 한 이십 년
이심년 좀 너머슬껄 아마	이십 년 좀 넘었을 걸 아마
그정도바께 안돼따고 하션는데 그럼 그전까지는 무슨 불로 다	그 정도밖에 안 됐다고 하셨는데 그럼 그전까지는 무슨 불로 다
든잔뿔	등잔불
등잔뿔 등잔뿔도 종류 여러개 인는 거 아녜요 뭐 호롱뿔	등잔불 등잔불도 종류 여러 개 있는 거 아녜요 뭐 호롱불
드 든잔뿌리라군 요 막때 막때기가 요러케 이 인는데 요 요기다 인제 종발거튼 거 그거이등자니야	드 등잔불이라곤 요 막대 막대기가 이렇게 이 있는데 여기다 인제 접시같은 거 그것이 등잔이야
드 등자네 기름 너쿠 심지해서 키구	드 등잔에 기름 넣고 심지해서 켜고
그 이저네는 이제 서규거튼 거 웁슬 때는 쩌 무슨 기름 이 시규 기름 무슨 기름 이 기름거튼거 요러케 요러케 조 종바레다 요러케 다마 담꾸선 새발심지라구 자근 거 마라서 요러케 뻐처노쿤그면 요 요이 기르메 대서 여가 부리 분는다 그래	그 이전에는 이제 석유같은 게 없을 때는 저 무슨 기름 이 식유 기름 무슨 기름 이 기름같은거 이렇게 이렇게 저 접시에다 이렇게 담아 담고선 새발심지라고 작은 거 말아서 요렇게 뻗쳐놓곤그면 요 요기 기름에 대서 여기가 불이 붙는다 그래
꼬거 고거시 새발심지라구 허는 거지	그거 그것이 새발심지라고 하는 거지
게 그러케 해서 불키 불키는 거지	그게 그렇게 해서 불키 불 켜는 거지
뭐 그 그거 말고 초뿔 양초 이런 거뚜	뭐 그 그거 말고 촛불 양초 이런 것도
아유 초뿌른 이 글려네 생 중가네 생긴 거지 초뿌리 어디가 인나 초뿌리	아유 촛불은 이 근년에 생 중간에 생긴 거지 촛불이 어디가 있나 촛불이
그러며는 전기 드러오기 전까지는	그러면 전기 들어오기 전까지는
초뿌리 초뿔두 이뜨래찌만 초뿔두 비싸니간 모 모싸서	촛불이 촛불도 있더랬지만 촛불도 비싸니깐 모 못 샀어
그냥 든 든잔뿌레 그 어둔 든잔뿌레서 그냥 여자드른 양말 기꾸	그냥 등 등잔불에 그 어두운 등잔불에서 그냥 여자들은 양말 깁구
양마리 새 양마리 어디가 이서 뚜러지면 기꾸 버서니지 버선	양말이 새 양말이 어디가 있어 뚫어지면 깁고 버선이지 버선
요새 소 날리자나요 구제역 소 무슨	요새 소 난리잖아요 구제역 소 무슨
구제역	구제역
에 소 날린데 엔나레는 여기 교동에서두 소 길러쪼 지금두 기르저	에 소 난리인데 옛날에는 여기 교동에서도 소 길렀죠 지금도 기르죠
아유 소 소가 재사닌데 소가 이서야 노늘 갈지	아유 소 소가 재산인데 소가 있어야 논을 갈지
그저그저  그러며는 여기두 이제 뭐 마구깐 어터게 다들 공동으루	그죠그죠  그러면 여기도 이제 뭐 마굿간 어떻게 다들 공동으로
아 이 공동이 아니라 한 마리 저 한 마리 가주구 두 지비서 얼러 메기기두 허구 세 지비 얼러서메기기두 허구	아이 공동이 아니라 한 마리 저 한 마리 가지고 두 집에서 얼러서 먹이기도 하고 세 집이함께 먹이기도 하고
겐 그 집찜마다 그 지베 저 바까테 우 우엥까니라구 이서 그걸 보구 우엥까니라구 헌다구	그 그 집집마다 그 집에 저 바깥에 우 외양간이라고 있어 그걸 보고 외양간이라구 한다고
쇠 우 짜 우엥까니라구 이서 이제 겨우렌 드려 매구 여르멘 한데 매구 허는 거지	소 우 자 외양간이라고 있어 이제 겨울엔 들여 매고 여름엔 한데 매고 하는 거지
집찜마다 소 몬메겨 어이그 그거 뭐 부자게	집집마다 소 못 먹여 어이그 그거 뭐 부자게
그러면 그 뭐지 뭐 여물죽	그러면 그 뭐지 뭐 여물죽
여물죽	여물죽
여물죽 그건 뭐 뭐메기는 거에요 벼지비랑	여물죽 그건 뭐 뭐 먹이는 거에요 벼짚이랑
벼찌비야 벼찝	볏짚이야 볏짚
벼찜만 메기는 거에요 뭐 뜨거운 물 부어 주구	볏짚만 먹이는 거에요 뭐 뜨거운 물 부어 주고
벼찌블 영을 쓰러가지구 큰 가마솓 가마소테다 가따 너쿠선 부를 때 이켜 그래섬 주는 거지	볏짚을 이엉을 쓸어가지고 큰 가마솥 가마솥에다 갖다 넣고선 불을 때 익혀 그래서 주는거지
왜 그냥 주면 안돼요	왜 그냥 주면 안돼요
그저넨 그러케 안줘서 지그믄 마느니께 그냥 생집 가따주구 허지 그저넨 꼭 게 쇠죽쑨다 그지	그전엔 그렇게 안 줘서 지금은 많으니까 그냥 생짚 갖다주구 하지 그전엔 꼭 그 쇠죽 쑨다고그러지
그게 소 잘머그라구 그런 거뚜 이찌만 양이 마나지는군뇨 그조	아 그게 소 잘 먹으라고 그런 것도 있지만 양이 많아지는군요 그죠
쇠죽쑨다는 거야	쇠죽 쑨다는 거야
그러면 혹시 그러면 그 각 짐마다 다 소가 업따고 하셔짜나요	아 그러면 혹시 그러면 각 집마다 다 소가 없다고 하셨잖아요
배낻쏘라고 해서 이르케 나메집 소 이러케 대신 길러주구	배냇소라고 해서 이렇게 남의 집 소 이렇게 대신 길러주고
어어 반 반재기  그 그이 반재기라 그래	어어 반 반재기  그 그것을 반재기라고 해
그 가주 가따가 송아지 가따 길러노쿠 큰소되먼 바는 내꺼되구 바는 주인네 꺼이 그이 반재기라구래	그 가주 가지고 송아지 가져다 길러놓고 큰 소 되면 반은 내꺼 되고 반은 주인네 것 그것을반재기라고 해
반재기 그러며는 그게 크면 절반 절반 이러기루 조껀 하고 기르는 거네요	반재기 그러면 그게 크면 절반 절반 이러기로 조건 하고 기르는 거네요
그러치	그렇지
그러며는 소 길드릴 때 왜 이케	그러면 소 길들일 때 왜 이렇게
코 코뚤른다 그러지 굽뜰 그거 굽뜨리야 굽뜨리 이 코 막대기에다 끼야 굽뜨리	코 코 뚫는다 그러지 굽뜰 그거 코뚜레야 코뚜레 이 코 막대기에다 끼워 코뚜레
그르구 거기에 이르케 다라서 고비  고삐 해가지구 이르케 그러먼 뭐 이르케 이랴이랴뭐	그리고 거기에 이렇게 달아서 고비  고삐 해가지고 이렇게 그러면 뭐 이렇게 이랴이랴뭐
고 고 뭐야 고삐 축축 챈다 그자나	고 고 뭐야 고삐 축축 챈다 그러잖아
그까 그르면 고삐를 축축 채면서 소를 부리자나요 인제  연자방아가튼 거 할 경우에일루 도라라 해야되고 그럼 뭐 오른쪼그로 도라라 할 때는 뭐	그러니까 그러면 고삐를 축축 채면서 소를 부리잖아요 인제  연자방아 같은 거 할경우에 이리로 돌아야 해야 되고 그럼 뭐 오른쪽으로 돌아라 할 때는 뭐
오려 마려 오른쪼기면 오려오려	오려 마려 오른쪽이면 오려오려
오려오려 하고 왼쪼그로 하면	오려오려 하고 왼쪽으로 하면
마려마려	마려마려
마려마려 하고 아프로 가라는	마려마려 하고 앞으로 가라는
근 이려	그건 이려
이려 머 멈추는 게 이려	이려 머 멈추는 게 이려
멈추는 건 워  이려이려하는 게 가는 거고 가는 거고 멈추는 거 워 하고 응 그럼	멈추는 건 워  이려이려 하는 게 가는 거고 가는 거고 멈추는 거 워 하고 응그럼
걔가 다 아라드러요 소가	걔가 다 알아들어요 소가
어 다 아지	어 다 알지
다 아라 워 하먼 딱 스구	다 알아 워 하면 딱 서고
이건 이케 고삐를 해서 애가 아는 게 아니라 말	이건 이케 고삐를 해서 애가 아는 게 아니라 말
그러치 이랴 하면 가지	그렇지 이랴 하면 가지
그러쿠나 소두 근데 종류가 만차나요	아 그렇구나 소도 근데 종류가 많잖아요
여기에 인는 소드른 다 무슨 소에요 그냥저기 황소 얼룩쏘 뭐 황소	여기에 있는 소들은 다 무슨 소에요 그냥저기 황소 얼룩소 뭐 황소
얼루근 저 터리 그 얼룩얼루컨 거를 얼룩쏘리구 누러먼 황소구 암소 수쏘	얼룩은 저 털이 얼룩얼룩한 것을 얼룩소라고 하고 누러면 황소고 암소 수소
보통 여긴 다	보통 여긴 다
누렁 누렁 누렁 누렁이야 누릉	누렁 누렁 누렁 누렁이야 누렁
그러믄 소두 이르케 뿌리 이써요  그럼 소 뿔 모양에 따라서	그러면 소도 이렇게 뿔이 있어요  그럼 소 뿔 모양에 따라서
으응 이러케 나온 삼태뿔 이러케 나오먼 그냥 꼳 그냥 그건 뿌리구	으응 이렇게 나오면 삼태기 뿔 이렇게 나오면 그냥 꼳 그냥 그건 뿔이고
응 삼태뿌리 조아요	응 삼태뿔이 좋아요
아이 조나 마나 이거 뭐 뿌 뿔 달린 거니껜 뭐 삼태뿌리라 그래서 특쑤하게 무슨 여콸 허는건 아니니께는	아이 좋으나 마나 이거 뭐 뿌 뿔 달린 거니깐 뭐 삼태뿔이라 그래서 특수하게 무슨 역할  하는 건 아니니까
그럼 소두 나이를 뭐 이러케 세는 게 이써요 우리는 한살 두살	그럼 소도 나이를 뭐 이렇게 세는 게 있어요 우리는 한살 두살
건 소는 이빨 보고 아라  이블 이 아가리를 들추지 그 운니빨 보구선 아라	그건 소는 이빨 보고 알아  입을 이 아가리를 들추지 그 웃이빨 보고선 알아
그럼 뭐 마느면 나이가 점점	그럼 뭐 많으면 나이가 점점
아이 마는 게 아니라 이빠리 크구 자근 거	아이 많은 게 아니라 이빨이 크고 작은 거
아아 그러면 걔두 뭐 나이를 이케 하릅 두릅 이런	아아 그러면 걔도 뭐 나이를 이케 하릅 두릅 이런
음 사릅쏘 세사리면 사르비야	음 사릅소 세 살이면 사릅이야
세 사리면 차릅 사릅	세 살이면 차릅 사릅
나릅	나릅
나릅	나릅
네 사른 나릅	네 살은 나릅
네 살 나릅	네 살 나릅
그러면 조은 소는 이르케 봐쓸 때 뭐 이가 튼트나고 뭐 이런 조꺼니 이써요	그러면 좋은 소는 이렇게 봤을 때 뭐 이가 튼튼하고 뭐 이런 조건이 있어요
물론 이 이가 잘생긴 소도 이꾸 모쌩긴 소두 이찌 이에 이에두 달려찌	물론 이 이가 잘생긴 소도 있고 못생긴 소도 있지 이에 이에도 달렸지
근데 조은 왜 우시장 가면 조은 소 골라서 사와야 되자나요 그러면 뭘 보고 이케 뭐	그런데 좋은 왜 우시장 가면 좋은 소 골라서 사와야 되잖아요 그러면 뭘 보고 이렇게 뭐
으 으 응뎅이가 펀퍼내야 새낄 잘란데  난 소장사 안해니께 그건 몰루지	으엉덩이가 펀펀해야 새낄 잘 낳는대 난 소장사 안하니까 그건 모르지
그러쿠나 그러며는 그 교동에두 머스미 이써써요 계속	아 그렇구나 그러면 그 교동에도 머슴이 있었어요 계속
머슴 이찌	머슴 있지
머슴 그러면	머슴 그러면
움는 사라미 머슴 사는 거지	없는 사람이 머슴 사는 거지
이러케 나메 지베 드러가서 엽 겨빵에서 살구	이렇게 남의 집에 들어가서 옆 곁방에서 살고
사랑방에서	사랑방에서
그러며는 그 머슴드른 어트게 줘요 푸믈	그러면 그 머슴들은 어떻게 줘요 품을
베루 주 베루두 주고 허지 벼 나락	벼로 주 벼로도 주고 하지 벼 나락
매일 줘요 아니면	매일 줘요 아니면
아유 일련삭	아유 일 년 삯
일려네 인제 일려네 열까만 열까마 인제 일구까만 일구까마 인제 지정을 허구서는 허는 거지	일 년에 인제 일 년에 열 가마면 열 가마 인제 일곱가마는 일곱 가마 인제 지정을 하고서는하는 거지
그며는 그 뭐 새해에 시자카자마자 주는 거에요	그러면 그 뭐 새해애 시작하자마자 주는 거에요
아니 일 끈나야 주지	아니 일 끝나야 주지
끈내야 그럼 마레	끝내야 그럼 말에
그럼	그럼
아아 그러면 여기두 푸마시랑 한대짜나요	아아 그러면 여기도 품앗이랑 한댔잖아요
푸마시 자래 마니해찌	품앗이 잘해 많이 했지
그러며는 그거 어터케요 오늘 뭐 어느네 지비다 하고  순서가 이르케정해져 이써요	그러면 그거 어떻게 해요 오늘 뭐 어느 네 집이다 하고  순서가이렇게 정해져 있어요
그러치 그거이 인제	그렇지 그것이 인제
내 개별루 인제 사는 거슨 인제 도늘 주고 인제 좀 해달라 해달라니께 이건 맘대루지만 고푸마시 허는 사람드러군 열씨기문 열씩 다서씨기면 다서씩 메서 의노늘 허지	내 개별로 인제 사는 것은 인제 돈을 주고 인제 좀 해달라 해달라니까 이건 맘대로지만 고품앗이 하는 사람들하고는 열이면 열 다섯이면 다섯이 모여서 의논을 하지
거 누짐네가 먼저하고 누짐네 순번저그루 차례차례	거 누구네가 먼저 하고 누구네 순번적으로 차례차례
그러면 여기서는 오슬 여기서도 이제 어먼님드리 베틀로 옫 지어써요	그러면 여기서는 옷을 여기서 이제 어머님들이 베틀로 옷 지었어요
어우 그럼	어우 그럼
그럼 여기서 모콰랑 이런 거뚜 다 길러써요 모콰를여기서 여기서도 모콰를 엉 시머찌 그럼 그럼 모콰가튼 거는 어먼님드리 재배하세요	그럼 여기서 목화랑 이런 것도 다 길렀어요 목화를여기서 여기서도 목화를 엉 심었지 그럼 그럼 목화같은 거는 어머님들이 재배하세요
아이 거 재배어는 거는 뭐 남자허구 여자하구 구벼리 인나 뭐 싱꾸 따구 허는 거야	아이 거 재배하는 거는 뭐 남자하고 여자하고 구별이 있나 뭐 심고 따고 하는 거야
그럼 모콰는 언제 시머요	그럼 목화는 언제 심어요
보메 심찌	봄에 심지
모콰도 보메 심꼬  걔 언제 거더요	목화도 봄에 심고  걔 언제 거둬요
그이 치뤄레	그거 칠월에
걘 좀 빨리 건네요	아 걔는 좀 빨리 걷네요
그러면 걔는 이케 어뜨케 벼는 이르케 기계로 이르케 요샌 하는데 요새는 모카 아나저	그러면 걔는 이렇게 어떻게 벼는 이렇게 기계로 이렇게 요샌 하는데 요새는 목화 안하죠
아내	안해
요샌 안하고 예저네는 그럼 그거 어떠케 따써요	요샌 안하고 예전에는 그럼 그거 어떻게 땄어요
거 소느루다 따는 거지  그럼	거 손으로다 따는 거지
모카 모카 송아리가 요로케 똥그라케 인게 나중에 이게 여 저기 여물 다 되머는 요이아가리가딱 버그러져 뻐그러지면 소미 요러케 삐조커게 나와	목화 목화 송아리가 이렇게 동그랗게 이렇게 나중에 이게 여 저기 여물 다 되며는 이 아아가리가 딱 버그러져 뻐그러지면 솜이 요렇게 삐죽하게 나와
그거 소믈 좀 솜만 요러 빼는 거지	그거 솜을 좀 솜만 요렇게 빼는 거지
빼요  그럼 소미 이러케 쑹 빠저요 그럼	빼요  그럼 솜이 이렇게 쑥 빠져요 그럼
그러믄 모콰로 해서는 이제 면 만들고	그러면 목화로 해서는 이제 면 만들고
그거 모 모콰는 인제 씨를 빼거든	그거 모 목화는 인제 씨를 빼거든
씨 빼가지구 물레 물레다 해가지구 씨를 빼는 거지	씨 빼가지고 물레 물레로 해서 씨를 빼는 거지
그러며는 여기 삼베가 대마라구 하셔짜나요 대마두 여기서 길러껜네요  그럼 대마는언제 시머요	그러면 여기 삼베가 대마라고 하셨잖아요 대마도 여기서 길렀겠네요  그럼 대마는언제 심어요
대마 그거뚜 보메 시머	대마 그것도 봄에 심어
그거뚜 사멀쯔메  그럼 걔두 치뤄레 그치 그거뚜 치뤄레	그것도 삼월쯤에  그럼 걔도 칠월에 그치 그것도 칠월에
걔네는 다 옫 애드리 그럼 모시도 또 만드션나요	걔네는 다 옷 애들이 그럼 모시도 또 만드셨나요
여긴 모 여긴 모신 업서	여긴 모 여긴 모시는 없어
여긴 모신 업써요 그러면그게 다 달러요 무명이나 삼 그 뭐지 베나 삼베나 필 이라구하자나요 한 필 그 기리가 또까태요 다	여긴 모시는 없어요 그러면그게 다 달라요 무명이나 삼 그 뭐지 베나 삼베나 필이라고 하잖아요 한 필 그 길이가 똑같아요 다
스무 자 한 피리지	스무 자 한 필이지
그러면 여기서 그럼 비단두 짜써요	그러면 여기서 그럼 비단도 짰어요
으응 그런 건 웁서	으응 그런 건 없어
그러며는 어먼님들 이케 옫 옫 다 지베서 옌나렌 만드셔껜네요 저히 할머님두 그럼 옫 만드셔써요 그 베틀로다가	그러면 어머님들 이렇게 옷 옷 다 집에서 옛날엔 만드셨겠네요 저희 할머님도 그럼 옷 만드셨어요  그 베틀로다가
으응	으응
그러면 어느집 누가 옫 뭐 자란다더라 뭐 이러고	그러면 어느 집 누가 옷 뭐 잘한다더라 뭐 이러고
그 바누질 자라는 사라미 이찌	그 바느질 잘하는 사람이 있지
그러쿠나 그러면 저히는 요새 한보글 안이버서 잘 모르자나요	그렇구나 그러면 저희는 요새 한복을 안 입어서 잘 모르잖아요
이런 보면 이게 명칭이 뭐 이런 흰색 이건 동정 뭐  긷	이런 보면 이게 명칭이 뭐 이런 흰색 이건 동정 뭐  깃
요 소매	이건 소매
소매 여기 여기 이름 여기 고름	소매 여기 여기 이름 여기 고름
여기 오꼬름	여기 옷고름
오꼬름 그리구 저기 뭐지 그럼 이런 거를 어먼님드리 다 이러케 바느지를 하시자나요 바느지를 일이리 해서 이러케 한복 만드셔쓸 거 아녜요 예저네는	옷고름 그리구 저기 뭐지 그럼 이런 거를 어머님들이 다 이렇게 바느질을 하시잖아요 바느질을 일일이 해서 이렇게 한복 만드셨을 거 아녜요 예전에는
그러며는 이건 뭐 그 어트케 해요 바느지를 뭐 이르케 뭐라고 하지 호 혼다고 해요 아니면	그러면 이건 뭐 그 어떻게 해요 바느질을 뭐 이렇게 뭐라고 하지 호 혼다고 해요 아니면
혼 츠메 허는 건 호는 거구 나중에 찌저진 거는 꼬매는 거구	혼 처음에 하는 건 호는 거고 나중에 찢어진 거는 꿰매는 거고
그럼옌나레는 어먼님들 빨래를 세타끼 업써쓰니까 다 가서 하셔쓸 거 아녜요	아 그럼옛날에는 어머님들 빨래를 세탁기 없었으니까 다 가서 하셨을 거 아녜요
내 내까우레두 가서 허구 운물까에서두 허구	내 냇가울에도 가서 하고 우물가에서도 하고
여기가 내까가 고구촌	여기가 냇가가 고구촌
내까 그저네 여기 저 큰 내까가 이서서 근데 지그믄 전부 이제 상수도 허구 허느라고 말랐지	냇가 그전에 여기 저 큰 냇가가 있었어 그런데 지금은 전부 이제 상수도 하고 하느라고 말랐지
그러며는 빨래두 다 하시구 이제 다리미두 인두루 하시구  다 그러케 하셔꾸나그러면 그때 여기서 염색뚜 다 해서 이브셔써요	음 그러면 빨래도 다 하시고 이제 다리미도 인두로 하시고  다 그렇게 하셨구나그러면 그떄 여기서 염색도 다 해서 입으셨어요
염새근 인제 물까미라구 이찌 이 고 인제 꺼먼 꺼먼 물깜 파란 물깜 빨간 물깜 거 물까미 이서	염색은 인제 물감이라고 있지 이 고 인제 검은 검은 물감 파란 물감 빨간 물감 거 물감이있어
요기는 인제 그 뭐 봄 대면  봄 대면 이르케 사니나 드레 가서 나물 뜨더다 먹짜나요	여기는 이제 그 뭐 봄 되면  봄 되면 이렇게 산이나 들에 가서 나물 뜯어다 먹잖아요
그러치	그렇지
그럼 어떤 나물 뜨더다 뭐 이르케 어터게 해 잡수꾸 그러셔써요	그럼 어떤 나물 뜯어다 뭐 이렇게 어떻게 해 잡숫고 그러셨어요
어어 여기서는 흔히 저기야 저기 저 부칸 저기 바라다 보이는 데 거기 가서 저 취나물 그런거 저기허지 뭐	어어 여기서는 흔히 저기야 저기 저 북한 저기 바라다 보이는 데 거기 가서 저 취나물 그런거 저기하지 뭐
산나물  저 고사리 고로 고사리 그런 거 취나물 고사리	산나물  저 고사리 고사리 그런 거 취나물 고사리
그런거허구 또 요기 드레 이르케 논뚜러메 다니민 인제 저기 고돌빼기 그런 거 캐다가 고돌빼기김치 담구	그런 거하구 또 여기 들에 이렇게 논두렁에 다니면 이제 저기 고들빼기 그런 거 캐다가 고들빼기김치 담고
또 나물 씀바구 뭐 사라구 그런 거 해다가 머꾸 그르지 뭐 흐니 보메는 여기는	또 나물 씀바귀 뭐 사라구 그런 거 해다가 먹고 그러지 뭐 흔히 봄에는 여기는
고러케 캐다가 그러면 지베서 인제 반차늘 해머글래먼 어터케	그렇게 캐다가 그러면 집에서 이제 반찬을 해먹으려면 어떻게
고돌빼기는 기냥 이러케 저기 액쩌세다 인제 김치둠 담그구 취나물 가튼 거는 쌀마서 뽀까머꾸그러지 머 고사리 그런 거	고들빼기는 그냥 이렇게 저기 액젓에다 이제 김치도 담그고 취나물 같은 거는 삶아서 볶아먹구그러지 뭐 고사리 그런 거
저기허구 저 사 씀바구 그런 거뚜 쌀마서 말려따두 보까머꾸 저장해따 멍는 거는	저기하구 저 씀바귀 그런 것도 삶아서 말렸다도 볶아 먹고 저장했다 먹는 거는
그러케두 해머꾸 지금더른 장아찌 만이 당으니깐 또 장 끄려붜서 장아찌로도 당아서 머꾸 그래	그렇게두 해 먹고 지금들은 장아찌 많이 담그니까 또 장 끓여서 장아찌로도 담가서 먹고 그래
고돌빼기 김치두 허지마는 인제 이 씀바구 그런 거는 뚜 끄려붜두 머꾸 그래 장 끄려붜서	고들빼기 김치도 하지만 이제 이 씀바귀 그런 거는 또 끓여서도 먹고 그래 장 끓여서
그러면 저기 그러케 사네서 캐고 드레서 캐는 거 말고  바테서 심는 거는 뭐 어떤채소들 주로 시머서 머꾸 그러나요	아 그러면 저기 그렇게 산에서 캐고 들에서 캐는 거 말고  밭에서 심는 거는 뭐 어떤채소들 주로 심어서 먹고 그러나요
보메	봄에
아니 뭐 보미든 뭐 여르미든	아니 뭐 봄이든 뭐 여름이든
여그서는 흐니 저기 이른 보메는 인제 이 명일만 쇠마는 시근치 시근치 바테다가 뿌리구 뿌려서해서 길러서 나물 해먹구	여기서는 흔히 저기 이른 봄에는 이제 이 명일만 쇠면 시금치 시금치 밭에다가 뿌리고 뿌려서해서 길러서 나물해 먹고
또 봄빼추 시머따가 저러케 그냥 해서 김치 담가 머꾸 봄무이 심꾸  상추싱꾸	또 봄배추 심었다가 저렇게 그냥 해서 김치 담가 먹고 봄무 심고  상추심고
인저는 저런 걸 마니 하니까 옌나레는 상추만 시머 머건는데 지그문 뭐 양생추 뭐 저런 거 다씨아시 이시니깐 다 사다 시머서 해머거	이제는 저런 걸 많이 하니까 옛날에는 상추만 심어 먹었는데 지금은 뭐 양상추 뭐 저런 거다 씨앗이 있으니깐 다 사다 심어서 해먹어
뭐 쑤카시고 뭐 뭐 근대 뭐 그런 거 주로 다 시머서 해먹찌 뭐 지금도 다 모 붜노쿠서	뭐 쑥갓이고 뭐 뭐 근대 뭐 그런 거 주로 다 심어서 해먹지 뭐 지금도 다 모 부어놓고서
음 민들레  치커리  으응 치커리 그런 거 다 시머서 치커리뭐 민들레 거 민들레가 조타 그러자나	음 민들레  치커리  으응 치커리 그런 거 다 심어서치커리 뭐 민들레 거 민들레가 좋다 그러잖아
다 시머	다 심어
우덜도 가따 저러케 시믄걸  민들레 그거 인제 캐다가서는뿌리할라 캐다가서는 그냥 깨끄시 시처서 그느레다가 그느레다 말려서 쌀마서 그 무를 머그만 그거그러케 가네 조태자나	우리들도 갖다 저렇게 심은걸  민들레 그거 이제캐다가서는 뿌리까지 캐다가서는 그냥 깨끗이 씻어서 그늘에다가 그늘에다 말려서 삶아서 그물을 먹으면 그거 그렇게 간에 좋대잖아
우리도 인제 또 저기 채다네 말려논 다 말라가네 조기 그느레다가 해놔뜨니	우리도 이제 또 저기 채반에 말려 놓은 다 말라가네 저기 그늘에다가 해놨더니
그러믄 여긴 뭐 채소 가튼 거는 사다 멍는 건 업꾸 다 그냥 길러서	그러면 여긴 뭐 채소 같은 거는 사다 먹는 건 없고 다 그냥 길러서
그러치 그럼	그렇지 그럼
아 그리게 우리 사위 마리 이짜나 요좀도 어끄저께두 다 인천서 와떤 손님드리 그르게 그저나가만 뭐 그저 덴장 그냥 끄려서 꼬추고 뭐고 다 그냥 뜨더다가 멍는 거지 뭐 사나	그러게 우리 사위 말이 있잖아 요즘도 엊그저께도 다 인천에서 왔던 손님들이 그러게그저 나가면 뭐 그저 된장 그냥 끓여서 고추고 뭐고 다 그냥 뜯어다가 먹는 거지 뭐 사나
우리 큰사위 말쭐로 여르메 오믄 나가먼 해오니까는 저기 깡이라구 야채깡이라구 그리자나 다  저기 해다 머그니깐	우리 큰사위 말줄로 여름에 오면 나가면 해 오니까는 저기 밭이라고 야채밭이라고 그러잖아다 저기 해다 먹으니깐
바테 나가먼 근데 우리더리 그러케 마니 심찌 우리는 아더리 식땅을 허니깐 배추고 뭐구 그러게인제 가연 할머이두 올라오민 배추 또 모 붠네 그러게 붜서 또 모 붜서 인제 한 판 또 나짜나	밭에 나가면 그런데 우리들이 그렇게 많이 심지 우리는 아들이 식당을 하니까 배추고 뭐고그러게 이제 가연 할머니도 올라오면 배추 또 모 붰네 그러게 붜서 또 모 붜서 이제 한 판또 났잖아
그냥 또 저 해가구	그냥 또 저 해 가고
저기허구 인제 회과네두 인제 그냥 다 김치 해가구 무이 시머따네가 깍띠기 해서 어저께 다시러다가 놔 놘는데	저기하고 이제 회관에도 이제 그냥 다 김치 해 가고 무 심어놨다가 깍두기 해서 어저께 다실어다가 놔 놨는데
우린 저 인천서 아이들 식땅에두 다 여기서 해가	우린 저 인천서 아이들 식당에도 다 여기서 해 가
그냥 무이두 다 뽀바가구 배추두 다 해서 뽀바서 실꾸 가구 우더리 바빠서 모까면 아더리 또오나서 시러 가구	그냥 무도 다 뽑아가고 배추도 다 해서 뽑아서 싣고 가고 우리들이 바빠서 못 가면 아들이또 와서 실어 가고
그러케 머그니깐 머거본 사람드리 마시 달르대	그렇게 먹으니깐 먹어본 사람들이 맛이 다르대
그러쵸	그렇죠
꼬추까루도 다 여기 꼬추까루만 쓰는데 오래는 비가 이러케 너무 장마가 일찍 와서 비가 마니와가지구 꼬추니 뭐니 다 틀려서	고추가루도 다 여기 고추가루만 쓰는데 올해는 비가 이렇게 너무 장마가 일찍 와서 비가 많이와가지고 고추니 뭐니 다 틀렸어
인제가테서 다 해서 떠러지구 저러케 그르자나 이파리 그런 거 저기해서	이제같아서 다 해서 떨어지고 저렇게 그러잖아 이파리 그런 거 저기해서
그럼 이제 가을 되면 이제 그 김장을 해야 되자나요	그럼 이제 가을 되면 이제 그 김장을 해야 되잖아요
인제 이 파뤌 인제 한 심뉴길 십치릴 되마는 인제 김장배추 다 또 이제 모 분는 거야 이 파뤌	이제 이 팔월 이제 한 십육일 십칠일 되면 이제 김장배추 다 또 이제 모 붓는 거야 이 팔월
그저넨 이 파뤌 이 저기 시보이리만 다 배추 모붜따 하고 그랜는데 인제는 좀 일찍 허니깐 너무소기 딴따나게 들러두 김장허기두 힘들구 틀리더라구	그 전엔 이 팔월 이 저기 십오일이면 다 배추 모 붰다 하고 그랬는데 이제는 좀 일찍 하니까너무 속이 너무 단단하게 틀어도 김장하기도 힘들고 틀리더라고
그래서 인전 십치릴서버텀 한 이시빌 경에 그러케 모를 붜	그래서 이제 십칠일서부터 한 이십일 경에 그렇게 모를 부어
그러케 붜따 허마는 퍼서커구 그러마는 김장 허기두 조쿠 저기 마시써 대레 딴따너게 드런  거보더	그렇게 붰다 하면 퍼석하고 그러면 김장 하기도 좋고 저기 맛있어 대개 단단하게 들은 것보다
그럼 그 김장할 때 인제 어트게 하는지 순서가 어트게 대고 방버비 어트게 대고 요런 거 좀알려주시게써요	그럼 그 김장할 때 이제 어떻게 하는지 순서가 어떻게 되고 방법이 어떻게 되고 이런 거 좀알려주시겠어요
김장 인저 그러케 시머따가서는 김장할 때 되마는 입똥 인제 저기 허마는 뭐 대레 입똥이 구월입똥에는 대레 안꾸 허구 시월 입똥은 지구 헌다 그리구	김장 이제 그렇게 심었다가서는 김장할 때 되면 입동 이제 저기 하면 뭐 대개 입동이 구월입동에는 대개 안고 하고 시월 입동은 지고 한다 그러고
그리는데 인제 날씨 추워지만 그냥 뭐 입똥만 지나만 그냥 그쪼게버터믄 여기 싸람드른 기냥 김장해	그러는데 이제 날씨 추워지면 그냥 뭐 입동만 지나면 그냥 그쪽에부터는 여기 사람들은 그냥김장 해
배추 뽀바서 저기 허우리마는소금 간꾹 타서 저려서	그런데 김장하는 과정을 배추 뽑아서 다듬어가지고 절여 절여서
저려서 인제 오늘거치  인제 오늘거치 기냥 이맘때 저리마는	
저려서 인제 오늘거치  인제 오늘거치 기냥 이맘때 저리마는	절여서 이제 오늘같이  이제 오늘같이 그냥 이맘때 절이면
인제 그냥 한 저녁때 되마는 인제 뒤저려서 그냥 꾹꾹 인제 간꾸개서 뒤저려	이제 그냥 한 저녁때 되면 이제 뒤절여서 그냥 꾹꾹 이제 간국 해서 뒤절여
인제 우이꺼는 들 절자나요 그리닌까는 그 우이꺼는 이르케 통에다 다마노꼬	이제 위의 거는 덜 절잖아요 그러니깐 그 위의 거는 이렇게 통에다 담아놓고
인제 그 미테꺼를 또 건저서 인제 다른 통에다 당꾸 우이꺼 건저논 걸 미트루 느쿠 그러케해서 저려따가서는	이제 그 밑의 거를 또 건져서 이제 다른 통에다 담고 위의 거 건져놓은 걸 밑으로 넣고 그렇게해서 절였다가서는
그 이튼날 오늘거치 저리만 낼 이맘때 저기허만 시처	그 이튿날 오늘같이 절이면 내일 이맘때 저기하면 씻어
시처서 다 건저놔따가서는 물 쪽 삐마는 다 속 버무려서 인제 속뚜 무이채 양녀믈 다 저녀게해 노치	씻어서 다 건져놨다가서는 물 쪽 빠지면 다 속 버무려서 이제 속도 무채 양념을 다 저녁에해 놓지
다 쓰러서 해 놔따가서는 그러케 해따가서는 인제 배추 씨처노코 그러커고 인제 소글 다 버무려	다 썰어서 해놨다가서는 그렇게 했다가서는 이제 배추 씻어놓고 그렇게 하고 이제 속을 다버무려
버무려서 간 머꾸 그리마는 인제 그 배추 물 쪽 빼온 거 인제 그쪼게는 속 싸는 거지 뭐	버무려서 간 먹고 그러면 이제 그 배추 물 쪽 뺀 거 이제 그쪽에는 속 싸는 거지 뭐
그러케 허지 뭐 어뜨케	그렇게 하지 뭐 어떡해
김치도 여러 종류가 있자나요  그때 뭐뭐 그러케 담그세요	김치도 여러 종류가 있잖아요  그때 뭐뭐 그렇게 담그세요
여기서는 주로 저기야 배추김치하구  하구 인제 저기 이찌 그냥 석빡찌루두 무이김치두 담그구	여기서는 주로 저기야 배추김치하고  하고 이제 저기 있지 그냥 석박지로도무김치도 담그고
파금치두 허구 수무금치허구 그런 거 허는 거지 뭐 주로	파김치도 하고 순무김치 하고 그런 거 하는 거지 뭐 주로
저 아랜녀게선 갇끔치 그런 걸 마니 허지  알타리 그조 알타리김치	저 아랫녘에선 갓김치 그런 걸 많이 하지  알타리 그렇죠알타리김치
수무금치 그냥 또 석빡찌로따가 무이 그냥 쩍쩍 뻐글러서 그러케두 허구	순무김치 그냥 또 석박지로다 무 그냥 쩍쩍 뻐개서 그렇게도 하고
그리구 파금치두 허구 파금치	그리고 파김치도 하고 파김치
주로 여기 시고레선 그냥 그거 허는 거야	주로 여기 시골에선 그냥 그거 하는 거야
파금치 머 갇끔치 그런 건 아내 가슬 가슬 시머따가 이제 배추 속 싸는데다 쓰러너쿠 마니나므만 또 냉중에 쪼끔 또 해보기도 하구 그르지	파김치 뭐 갓김치 그런 건 안 해 갓을 갓을 심었다가 이제 배추 속 싸는 데다 쓸어넣고 많이남으면 또 나중에 조금 또 해보기도 하고 그러지
뭐 생새우 사다가 놔따가서는 생새우 치구 저꾹 여그서 인제 저 남산포 알자나 거 새우젇 짬는데	뭐 생새우 사다가 놨다가서는 생새우 치고 젓국 여기서 이제 저 남산포 알잖아 거 새우젓잡는 데
거그서 새우젇 사다가 저려따가 그거 느쿠 생새우 너쿠 아이 근데 지그믄 저꾸근 마니 안처	거기서 새우젓 사다가 절였다가 그거 넣고 생새우 넣고 아이 근데 지금은 젓국은 많이 안쳐
생새우 인제 느쿠 그냥 저꾹 사완 거 그거 조금씩 느쿠 그러커구 그냥 버무리지	생새우 이제 넣고 그냥 젓국 사온 거 그거 조금씩 넣고 그렇게 하고 그냥 버무리지
옌날처럼 저꾸글 마니 그러케 안처	옛날처럼 젓국을 많이 그렇게 안 쳐
생새우 마니 치구 그리구 보메 머글 꺼는 생새우도 마니 치만 틀리드라구 여르메 머글 꺼는	생새우 많이 치고 그리고 봄에 먹을 거는 생새우도 많이 치면 틀리더라고 여름에 먹을 거는
그러케 허지 뭐 그냥 주로 그러케 허는 거야 김치	그렇게 하지 뭐 그냥 주로 그렇게 하는 거야 김치
그럼 이제 김장해노쿠 이제 설 되면 설 되면 또 설 음식 준비해야 되자나요  그럼 설음식 줌 어떤 음식 어트게 준비하는지 그걸 줌 말쓰메 주시게써요	그럼 이제 김장해놓고 이제 설 되면 설 되면 또 설 음식 준비해야 되잖아요  그럼 설음식 좀 어떤 음식을 어떻게 준비하는지 그걸 좀 말씀해 주시겠어요
여기서 여기 시고레서는 설 인제 음식 장만한 데야	여기서 여기 시골에서는 설 이제 음식 장만한 데야
흐니 인제 여기서는 인제 제사지내마는 저런데서는 뭐 그냥 뭐 동태전 뭐 이런 무슨 저늘 마니들허드만	흔히 이제 여기서는 이제 제사지내면 저런 데서는 뭐 그냥 동태전 뭐 이런 무슨 전을 많이들하더만
여기선 주로 그냥 그저 그저네 옌날시그로 우리드른 어태 쌀 바다가 찹싸라구 멥싸라구 서꺼서바다가 그냥 흔 지지미루다가 제사상에 노는 거 똥그라케 이러케 해 부치기	여기선 주로 그냥 그저 그전에 옛날식으로 우리들은 여태 쌀 빻아다가 찹쌀하고 멥쌀하고섞어서 빻아다가 그냥 흔 지지미로다가 제삿상에 놓는 거 동그랗게 이렇게 해  부치기
그러케 허구 또 행적 네모지게 이러케 해서 또 여기다 김치 너쿠 인제 파를 느튼지 김치를 느튼지김치를 주로 마니 너 무근김치	그렇게 하고 또 행적 네모지게 이렇게 해서 또 여기다 김치 넣고 이제 파를 넣든지 김치를넣든지 김치를 주로 마니 넣어 묵은 김치
그냥 이마너케 짤라서 여기 가운데다가서는 하낙씩 세개씩 이러케 여기다 이러케 노쿠	그냥 이만하게 잘라서 여기 가운데다가서는 하나씩 세개씩 이렇게 여기다 이렇게 놓고
그러케 해서 네모지게 해 커다라케 두투머게	그렇게 해서 네모지게 해 커다랗게 두툼하게
그러케 해서 뒤지버서 이그마는 거기다 겨란 노란자에 이펴 이러케 이러케 수깔로다 이펴서 그러케해서 또 허구	그렇게 해서 뒤집어서 익으면 거기다 계란 노른자에 입혀 이렇게 이렇게 숟갈로 입혀서 그렇게해서 또 하고
또 겨란 부치기도 허구 녹두 녹두 부치기 이제 막 머글 꺼는 돼지고기 인제 가라다 너쿠 김치쓰러 느쿠	또 계란부치기도 하고 녹두 녹두부치기 이제 막 먹을 거는 돼지고기 이제 갈아다 넣고 김치쓸어 넣고
다 양념 해서 그러케 해서 그건 크다너케 이러케 허구	다 양념해서 그렇게 해서 그건 커다랗게 이렇게 하고
또 제사쌍에 논는 건 요러케 똥그라케 그냥 고러케 하구	또 제사상에 놓는 건 이렇게 동그랗게 그냥 그렇게 하고
그러케 해서 허구 두부 부치구	그렇게 해서 하고 두부 부치고
그리구 동태 여기서 흐니 이제 명일 음식 저기허만 동태전 인제 부치구 또 뭐 다른 거 좀 그냥사다가 해서 그냥 좀 전 좀 이르케 해서	그리고 동태 여기서 흔히 이제 명일 음식 저기하면 동태전 이제 부치고 또 뭐 다른 거 좀그냥 사다가 해서 그냥 좀 전 좀 이렇게 해서
그냥 뭐 똥그랭땡두 두부 허구 고기 느쿠 양냠해서 똥그랑땡	그냥 뭐 동그랑땡도 두부 하고 고기 넣고 양념해서 동그랑땡
그러캐서 양냐매서 또 겨란 이펴서 그러케서 허구	그렇게 해서 양념해서 또 계란 입혀서 그렇게서 하고
다른 거 인제 저기허구 그르만 뭐 그냥 도라지 가튼 거뚜 허구 저	다른 거 이제 저기하고 그러면 뭐 그냥 도라지 같은 것도 하고 저
그런 거 주로 그냥 여기선 그런 거 해 저런 아랜녀게선 뭐 그 저기드만 그냥 여러가지 다 해서너트만	그런 거 주로 그냥 여기선 그런 거 해 저런 아랫녘에선 뭐 그 저기더만 그냥 여러가지 다해서 넣더만
아랜녀겐 고기두 그러쿠	아랫녘엔 고기도 그렇고여기선 제사상에 넌는 건 부거 노쿠 또 저기 숭어 이짜나 숭어 그거 말려따가 그거 쩌서 노쿠여기선 제삿상에 넣는 건 북어 노고 또 저기 숭어 있잖아 숭어 그거 말려다가 그거 쪄서넣고
조기 느쿠 노쿠 여기선 기냥 제사상에 그런 거 그러케 놔	조기 넣고 놓고 여기선 그냥 제사상에 그런 거 그렇게 놔
과일 삼색 과일 노쿠 인전 근데 뭐  그럼 수정과 가튼거 그런 거 허구 그저 그러는 거지	과일 삼색 과일 놓구 이젠 그런데 뭐  그럼 수정과같은 거 그런 거 하고 그저 그러는 거지
다 또까태 저런 데서 멍는 거 다 또까태 그러케 해	다 똑같아 저런 데서 먹는 거 다 똑같아 그렇게 해
여슨 안 고으셔써요	엿은 안 고으셨어요
엳 여슨 안 고으	엿 엿은 안 고으
옌나레는 관는데 지그믄 지금두 저기야 떡 찌거머꾸 그리니라구 엳 그거 싸래기 잔싸래기 싸레서띠어진 그런거루다가 곤는 사람도 이써	옛날에는 고았는데 지금은 지금도 저기야 떡 찍어먹고 그러느라고 엿 그거 싸래기 잔싸래기쌀에서 떨어진 그런 거로다가 고는 사람도 있어
근데 우더른 여뚜 안머거 그냥 저기야 꼬추장 보메 꼬추장 당글 때 찹쌀 바다가 인제 꼬추장인제 저기 새겨가지구 저기허마는 그 저기 그 여시 방부제 세껴서 저기자나	그런데 우리들은 엿도 안 먹어 그냥 저기야 고추장 봄에 고추장 담글 때 찹쌀 빻아다가 이제고추장 이제 저기 삭혀가지고 저기하면 그 저기 그 엿이 방부제 섞여서 저기잖아
너으마는 꼬추장두 꼬시 안나드만 저런 데서 사멍는 거 모냥으루	넣으면 고추장도 꼬시 안 나더만 저런 데서 사먹는 거 모양으로
그리닌껜 기냥 고런 거 쪼끄만 거 하나 사다가 찹쌀 인제 바다가서는 소테다가 새겨서 인제 그거장작뿔 때구 인제 그거 쪼려	그러니까 그냥 그런 거 조그만 거 하나 사다가 찹쌀 이제 빻아다가는 솥에다가 삭혀서 이제  그거 장작불 때고 이제 그거 졸여
쪼리마는 쪼끄만 거 하나 사다가서는 끄를 때	졸이면 조그만 거 하나 사다가서는 끓을 때
여끼리미 사다가 그거 새켜서 인제 인제 저기 해가지구 끄리자나 그리마는 인제 엳 그걸 너어야인제 꼬시 들 나드라구	엿기름 사다가 그거 삭혀서 이제 저기 해가지고 끓이잖아 그러면 이제 엿 그걸 넣어야 이제꼬시 들 나더라고
그 인제 막 어드런 사라믄 엳꼬추장만 당그구 그리는데 우더른 그런 거 저기허니깐 쪼끄만 거하나 사다가 그거 다 끄러서 쪼를 때 좀 쏘다서 허만 꼬시 들 나드라구	그 이제 막 어떤 사람은 엿고추장만 담그고 그러는데 우리들은 그런 거 저기하니까 조그만거 하나 사다가 그거 다 끓어서 졸을 때 좀 쏟아서 하면 꼬시 들 나더라고
그래서 그냥 고거 쪼그만 거 하나 사다가 그러케 해서 다마서 꼬추장두 머꾸 그르지 그냥 뭐엳 그런 거 마니 사다 안너	그래서 그냥 그거 조그만 거 하나 사다가 그렇게 해서 담아서 고추장도 먹고 그러지 그냥뭐 엿 그런 거 많이 사다 안 넣어
그리구 그냥 저기 요리당 여시라구 이짜나 병에 요런 데 드렁거	그리고 그냥 저기 요리당 엿이라고 있잖아 병에 이런 데 들은 거
그렁 거 인제 그냥 며르치라도 보꾸 그냥 그럴 때 좀씩 쓰이라구 고런 거 사다가 그냥 이르케쓰구 그래	그런 거 이제 그냥 멸치라도 볶고 그냥 그럴 때 조금씩 쓰느라고 그런 거 사다가 그냥 이렇게쓰고 그래
근데 그 옌나레 엳 고으실 때는  그때는 어트게 고안는지 옌날 생각하면서	그런데 그 옛날에 엿 고으실 때는  그 때는 어떻게 고았는지 옛날 생각하면서
아우 옌나레 그르게 아유 술두 마니 허구 여뚜 마니 고꾸 그냥 가마소테다가서는 엳 그거 그냥과가지구서는 해가지구 쌀 튀기구 콩 튀기구 그런 거 해다 다 강정하지 뭐	아우 옛날에 그러게 아유 술도 많이 하고 엿도 많이 고고 그냥 가마솥에다가서는 엿 그거그냥 고아가지고서는 해가지고 쌀 튀기고 콩 튀기고 그런 거 해다 다 강정하지 뭐
강정해서 짤라서 그러캐서 쓰구 머꾸 그래서 근데 인젠 안해 귀차느니까 그렁거	강정해서 잘라서 그렇게 해서 쓰고 먹고 그래서 근데 이젠 안 해 귀찮으니까 그런 거
누가 그러케 그거 머거 또 그냥 쩌끅쩌끌 이베 무꾸 그런 거	누가 그렇게 그거 먹어 또 그냥 쩍쩍 입에 묻고 그런 거
애들두 머거 인제 그런 거 그리킨 안해 그런 거	애들도 먹어 이제 그런 거 그러니까 안 해 그런 거
그저네는 그냥 아주 엳 그러케 과서 아주 그거이 멩일때만 아주 그거 하니라구 그거이 아주 저기야	그 전에는 그냥 아주 엿 그렇게 고아서 아주 그게 명일 때면 아주 그거 하느라고 그게 아주저기야
쌀 그냥 한 메떼씩 튀겨다가서는 그냥 그거 상에다가 그냥 비니루 깔구서는 해서 쪽 해서 그냥해놔따 다 짤라서 그러케 해서	쌀 그냥 한 몇 되씩 튀겨다가서는 그냥 그거 상에다가 비닐 깔고서는 해서 쪽 해서 그냥 해놨다다 짤라서 그렇게 해서
저기 허구 콩두 튀겨다 그러커구 근데 지그믄 아내	저기하고 콩도 튀겨다 할 거고 그런데 지금은 안 해
그냥 펴나나게 사 사는 세상이 돼서	그냥 편안하게 사는 세상이 돼서
그럼  그러케  엳꼴려면 그냥 그 이런 온돌빵에다가 장작 가따 드려 때구 메칠씩봐야 되거든	그럼  그렇게 엿 골려면 그냥 그 이런 온돌방에다가 장작 갖다 들여 때고 며칠씩봐야 되거든
그럼 옌나렌 여기 인제 소딴지 걸구서는 다 거기다 허구 그냥 이거이 다 낭구까니야 어끄저께두우리 인천서 옌나레 여기 살던 사람드리 저 인처느루 가서 이사가서 사는데 여그 오나서 여그서하루빰들 자구 그러카구 가찌만	그럼 옛날엔 여기 이제 솥단지 걸고선 다 거기다 하고 그냥 이게 다 나뭇간이야 엊그저께도우리 인천에서 옛날에 여기 살던 사람들이 저 인천으로 가서 이사가서 사는데 여기 와서 여기서하룻밤들 자고 그렇게 하고 갔지만
그래서 언니 여기가 낭구까니구 뭐 어쩌구 낭구 다 그냥 아유	그래서 언니 여기가 나뭇간이고 뭐 어쩌고 나무 다 그냥 아유
그러게 인제 허리 아프구 그러니까는 옌날 소리 들허지 내가	그러게 이제 허리 아프고 그러니깐 옛날 소리 덜 하지 내가
이 뒤에가 그냥 낭구 그 솔까지 석짱 처다 그냥 한무리씩 싸만 그걸 저 노할머이 시할머이 시할머이업꾸 그걸 다 끄러다 때씨니	이 뒤에가 그냥 나무 그 솔가지 삭정이 쳐다 그냥 한 무리씩 쌓면 그걸 저 노할머니 시할머니시할머니 업고 그걸 다 끌어다 땠으니
근데 이 친구드른 엳 고는 거 어트게 고으는 건지 모르자나요  아마 고걸 들으면 아주재미써 할 거 가태요 그니까 옌날 여슬 어트게 첨부터 이르케  뭘 준비해서 으응 어트게	그런데 이 친구들은 엿 고는 거 어떻게 고는 건지 모르잖아요  아마 그걸 들으면 아주재밌어 할 것 같아요 그러니까 옛날 엿을 어떻게 처음부터 이렇게  뭘 준비해서 으응어떻게
인제 저기야 싸를 인제 멥싸를 당가 응	이제 저기야 쌀을 이제 멥쌀을 담가 응
한 마를 여슬 골랴믄 멥싸를 당가따가서는 인제 시루에다가 시루 이짜나 그저네 응	한 말을 엿을 고려면 멥쌀을 담갔다가서는 이제 시루에다가 시루 있잖아 그 전에 응
시루에다 이러케 구먹 뻥뻥 뚤린 거 거기다가서는 시루미시라구 이러케 뚱그러케 짜	시루에다 이렇게 구멍 뻥뻥 뚫린 거 거기다가서는 시루밑이라고 이렇게 둥그렇게 짜
짜는 거 이서 지브루두 이러케 해서 짜는 거 이꾸 또 옌나레 그 나이롱 실루다가 이러케 가게바눌리라구 양발두 뜨구 뭐 저런 거 다 옌나렌 우더른 다 저기자나	짜는 거 있어 짚으로도 이렇게 해서 짜는 거 있고 또 옛날에 그 나일론 실로다가 이렇게 가게바늘이라고 양말도 뜨고 뭐 저런 거 다 옛날엔 우리들은 다 저기잖아
저러케 해때포 이런 벼게다 거는 거 그런 거뚜 다 수 노차나 바메 자잔쿠	저렇게 횃대포 이런 벽에다 거는 거 그런 것도 다 수 놓잖아 밤에 자지 않고
가께수 노쿠 뭐 그러케서 수를 놔가지구서는 해다가 다 치구 그런데 어태 그거 둬서 인는 사람도이때 근데 우더른 다 저기야 버려서 읍써	가께쓰 넣고 뭐 그렇게 해서 수를 놔가지고서는 해다가 다 치고 그러는데 여태 그거 둬서  있는 사람도 있대 그런데 우리들은 다 저기야 버려서 없어
그러커구  으응	그렇게 하고  으응
그래 저기 여슨 싸를 한 마를 골려면 싸를 당가	그래 저기 엿은 쌀을 한 말을 고려면 쌀을 담가
인제 오늘거치 당가따가 낼 인제 그거 다 부른 대메 그 시루에다가 인제 인제 철솓 소슬 여기다다 거러짜나 옌나레는	이제 오늘같이 담갔다가 내일 이제 그거 다 불은 다음에 그 시루에다가 이제 이제 철솥 솥을여기다 걸었잖아 옛날에는
걸만 그 시루 안 인제 시루 만는 소시 이서 그러마는 고기다가서는 시루를 거기다 마춰서 사찌	걸면 그 시루 안 이제 시루 맞는 솥이 있어 그러면 거기다가서는 시루를 거기다 맞춰서 샀지
그러마는 인제 거기다 시루미슬 깔구 그러카구 거기다 싸를 쩌	그러면 이제 거기다 시루밑을 깔고 그렇게 하고 거기다 쌀을 쪄
부를 때서 그냥 김이 풍풍 올라서 인제 싸를 인제 찌는 거야	불을 때서 그냥 김이 풍풍 올라서 이제 쌀을 이제 찌는 거야
그러면 그거이 아주 꼬두바비야 아주	그러면 그게 아주 고두밥이야 아주
그냥 술두 인제 그러커자나 나두 이른 보메두 그러케 쩌서 술두 해서	그냥 술도 이제 그렇게 하잖아 나도 이른 봄에도 그렇게 쪄서 술도 했어
약 사다가 버무려서 튀겨가지구 술두 해써	약 사다가 버무려서 튀겨가지고 술도 했어
핻써 몯자리들 허는 사람들 다 머거찌 걸러줘서	했어 못자리들 하는 사람들 다 먹었지 걸러줘서
그랜는데 그러케 쩌 그러면 인제 그거를 엳끼리미를 사다가서는 엳끼리미를 그저네는 사질 안쿠우더리 보리농사허니까 길러찌	그랬는데 그렇게 쪄 그러면 이제 그거를 엿기름을 사다가서는 엿기름을 그 전에는 사질 않고우리들이 보리농사하니까 길렀지
그래 그걸 가라서 인제 걸러 인제 체에다가	그래 그걸 갈아서 이제 걸러 이제 체에다가
걸러서 소테다가선 그걸 바블 퍼부어	걸러서 솥에다가선 그걸 밥을 퍼 부어
인제 퍼부만 엳끼리미 인제 걸러서	이제 퍼 부으면 엿기름 이제 걸러서
그러케 해서 인제 그 엳끼리미를 소테다 붜서 훙그르를 허게 해서	그렇게 해서 이제 그 엿기름을 솥에다 부어서 훙그르를하게 해서
한 솓 안쳐 요러케 짤람짤라머게	한 솥 안쳐 이렇게 짤람짤람하게
그러먼 이제 그거이 인제 여서씨간 일곱씨가니만 사가 다	그러면 이제 그게 이제 여섯시간 일곱시간이면 삭아 다
아주 이르케 바바를 이케 민대기마는 아주 요기서 다 노가 그러만 그쪼게는 짜는 거야	아주 이렇게 밥알을 이렇게 민대기면 아주 여기서 다 녹아 그러면 그 쪽에는 짜는 거야
인제 그냥 이 잘래기에다가 베 베잘래기 그냥 그런데다가 짜	이제 그냥 이 잘래기에다 베 베잘래기 그냥 그런 데에다가 짜
그걸 인제 짜가지구 짜가지구 인제 이 소테다가 부꾸 그걸 장작뿌를 다 때서 인제 그냥	그걸 이제 짜가지고 짜가지고 이제 이 솥에다가 붓고 그걸 장작불을 다 때서 이제 그냥
여시 되드락 여 테레비두 나오자나 여시 되드락 인제 쪼려	엿이 되도록 여기 텔레비전에도 나오잖아 엿이 되도록 이제 졸여
그 이제 그냥 쪼리마는 인제 그냥 한 반 그러케 뒈서 인제 이러케 주거그로 이러커먼 아주 인제흘러내리구 저기허게 쫄먼 아주 그거이 발그스름허게 저기 되자나 그 연무리	그 이제 그냥 졸이면 이제 그냥 한 반 그렇게 되서 이제 이렇게 주걱으로 이렇게 하면 아주이제 흘러내리고 저기하게 졸면 아주 그게 발그스름하게 저기 되잖아 그 엿물이
그러만 아주 그 연무리 무척 마시서 아주 이러케 이런 새까리루 그냥 저러케 될때	그러면 아주 그 엿물이 무척 맛있어 아주 이렇게 이런 색깔로 그냥 저렇게 될 때
그리구서는 이제 그걸 인제 되 누군 여털랴만 떡 찌거머께 헐랴만 주거그로 이러케 떠서	그리고선 이제 그걸 이제 되 누군 엿하려면 떡 찍어먹게 하려면 주걱으로 이렇게 떠서
이러케 똑똑 흘러내리마는 엳 찌거머글 꺼 껀 떠노쿠	이렇게 똑똑 흘러내리면 엿 찍어먹을 건 떠 놓고
또 인제 강정허구 인제 번드래기 여스루다가 헐랴마는 그냥 주거게서 이러케 주거게서 인제 그냥아주 떠러지지 아늘 정도 이러케 내려오자나	또 이제 강정하고 이제 번드래기 엿으로다가 하려면 그냥 주걱에서 이렇게 주걱에서 이제그냥 아주 떨어지지 않을 정도 이렇게 내려오잖아
그리마는 그쪼게는 인제 부를 안 때구	그러면 그쪽에는 이제 불을 안 때고
다 인제 그냥 고무종이를 깨끄시 해다가서는 깔구	다 이제 그냥 고무종이를 깨끗이 해다가서는 깔고
떠다가 거기다 인제 한 국짜씩 이러케 노마는 똥구라케 이러케 번드래기가 되자나 번드래기	떠다가 거기다 이제 한 국자씩 이렇게 놓으면 동그랗게 이렇게 번드래기가 되잖아 번드래기
그리구 인제 강정헐껀 또 이르 그르세다 퍼노쿠 강정헐꺼 바발강정허구 콩강정헐껀	그리고 이제 강정할 건 또 이렇게 그릇에다 퍼 놓고 강정할 거 밥알강정하고 콩강정 할 건
그러커구서는 인제 그러케 해서 번드래길 쭈욱 이러케 해놔 이러케 이러케	그렇게 하고선 이제 그렇게 해서 번드래기를 쭉 이렇게 해놔 이렇게 이렇게
해노만 해노쿠서는 또 그걸 해노쿠	해놓으면 해놓고서는 또 그걸 해 놓고
인제 강정헐꺼는 또 함바게다가서는	이제 강정할 거는 또 함박에다가서는
그저넨 함박뚜 그러케 해꾸 또 먼저 나와쓸 때는 양은다라이야	그 전엔 함박도 그렇게 했고 또 먼저 나왔을 때는 양은대야야
양은다라이에다가서는 인제 그 바발티기를 노쿠 여슬 다마다가 거기다가 놔	양은대야에다가서는 이제 그 밥알튀기를 놓고 엿을 담아다가 거기다가 놔
거기다 이러케 국자루다 떠 붜 그르만 인제 묻짜나	거기다 이렇게 국자로다 떠 부어 그러면 이제 묻잖아
그르만 그냥 이러케 버무려서 또 고무종이에다가서는	그러면 그냥 이렇게 버무려서 또 고무종이에다가서는
이러케 펴노쿠서는 짝짝 그냥 그 저 국쑤 미는 저거 방맹이루다가 짝짝 이러케 미러	이렇게 펴놓고서는 짝짝 그냥 그 저 국수 미는 저거 방망이로다가 짝짝 이렇게 밀어
미러서 도툼허게 이러케 머글만치 되 그러케 해서 맨드러놔따가 꾸득꾸드커마는 짤르지 뭐칼루다가	밀어서 도톰하게 이렇게 먹을만치 돼 그렇게 해서 만들어놨다가 꾸득꾸득하면 자르지 뭐칼로다가
다 짤라서 이러케서 함바게다 다마노쿠	다 잘라서 이렇게 해서 함박에다 담아놓고
또 엳빤드래기 이러케 해놔떤 건 다 쩍쩍 이러나만 또 해서 또 콩가루하고 뭐 저런 거 해서 술술뿌리만 켜켜이 해서 다마놔따가서는	또 엿번드래기 이렇게 해놨던 건 다 쩍쩍 일어나면 또 해서 콩가루하고 뭐 저런 거 해서 술술뿌리면 켜켜이 해서 담아놨다가서는
다마놔따 하낙씩 해다가서는 손님들 오구 또 머글 땐 쩍쩍 이러케 뻐글러서 때려서 그러케 해서머꾸 그러지 뭐	담아놨다 하나씩 해다가서는 손님들 오고 또 먹을 땐 쩍쩍 이렇게 뻐개서 때려서 그렇게 해서먹고 그러지 뭐
그러케 허는 거야	그렇게 하는 거야
그럼 아까 술두 담가서 드셔따 그래짜나요  수른 또 이케 순서대로 좀 이케 한번 말쓰믈해주시게써요	그럼 아까 술도 담가서 드셨다 그랬잖아요  술은 또 이렇게 순서대로 좀 이렇게 한번 말씀을 해주시겠어요
수른 수른 술두 인제 싸를 당가	술은 술은 술도 이제 쌀을 담가
인제 엳빱찌듯 그러케 당 해따가 시루에다 또 쩌 아주 꼬두바브루	이제 엿밥 찌듯 그렇게 담 했다가 시루에다 또 쪄 아주 고두밥으로
그르만 옌나레는 그걸 잘래기에다 다마서	그러면 옛날에는 그걸 자루에다 담았어
인제 그 벼짤래기	인제 그 베 자루
그런데다 다마서 저기다가선 이러케 노쿠서는 이런 걸 더퍼노쿠 그러케해서 한 이트리구 얼마구그걸 띠여	그런데다 담아서 저기다가선 이렇게 놓고선 이런 걸 덮어놓고 그렇게 해서 한 이틀이고 얼마고그걸 띄워
그걸 띠마는 그 잘래기에서 그냥 이러케 허만 아주 그 꼬두바비 그 술랴글 해서 버무려서 노마는	그걸 띄우면 그 자루에서 그냥 이렇게 하면 아주 그 고두밥이 그 술약을 해서 버무려서 놓으면
아주 하야케 펴 새똥 꼭 새똥거찌 뭐	아주 하얗게 펴 새똥 꼭 새똥 같지 뭐
새똥모 모냥으루 펴야지 이제 그걸 수를 다마	새똥모 모양으로 펴야지 이제 그걸 술을 담아
그러커마는 새똥거치 한 이틀마네 피마는 그거를 인제 항아릴 여그다 드려다노코 오지항아릴드려다노코	그렇게 하면 새똥같이 한 이틀만에 피면 그거를 이제 항아리를 여기다 들여다놓고 오지항아릴들여다놓고
그러커구 인제 그 다 편 아주 새똥거치 그냥 이르케 바스러지게 펴지마는	그렇게 하고 이제 그 다 편 아주 새똥같이 그냥 이렇게 바스러지게 펴지면
그걸 여그다가 가따가서는 저기 노쿠 그걸 거기 항아리에다 다마	그걸 여기다가 갖다가서는 저기 놓고 그걸 거기 항아리에다 담아
당꾸 인제 무를 인제 시마리구 너마리구	잠고 이제 물을 이제 서 말이고 너 말이고
인제 한말 저기해싱께는 한 그냥 서너말 되게 무를 여기다가 붜놔	이제 한 말 저기했으니깐 한 그냥 서너말 되게 물을 여기다가 부어 놔
그리구 누룩 이짜나 또 밀 밀 해서 인제 누루글	그리고 누룩 있잖아 또 밀 밀 해서 이제 누룩을
누루글 또 인제 해서 맨드러서 띠여서 옌나레는 띠 띠지	누룩을 또 인제 해서 만들어서 띄워서 옛날에는 띄 띄우지
그 인제두 저런 인제 그 누루근 먼 누루기야 나두 인제 저 강화으베서 사와보지만	그 이제도 저런 이제 그 누룩은 뭔 누룩이야 나도 이제 저 강화읍에서 사와보지만
우더른 그냥 미를 아주 빵에다가 곱따너케 이러케 어니 정도 가라가주구 누루글 맨드러찌 똥그라케	우리들은 그냥 밀을 아주 방아에다가 곱단하게 이렇게 어느 정도 갈아가지고 누룩을 만들었지동그랗게
이러케 그냥 그저네두 누룩 판두 인는데 그냥 베보재기에다가 해서 이러케 그냥 뭉치면 똥그라케돼	이렇게 그냥 그 전에도 누룩 판도 있는데 그냥 베보자기에다가 해서 이렇게 그냥 뭉치면 동그랗게돼
그러만 그냥 그거 띠여가지구 누룩 맨드러서	그러면 그냥 그거 띄워가지고 누룩 만들었어
그러케해서 누루글 이제 한장이구 두장이구 또 쿡쿡 인제 바슬러 저 돌절구에다 찌어 송괘이루다곱다너케	그렇게 해서 누룩을 이제 한 장이 있고 두 장이 있고 또 쿡쿡 이제 부숴 저 돌절구에다 찧어방망이로다 곱단하게찌어서 그러케해서 여그다 가따가서는 이제 그거 술 밥 띠언 거 여기다 허만 거기따가선 한장이구두장이구 그 누룩뚜 쫌 너어쪄서 그렇게 해서 여기다 갖다가서는 이제 그거 술밥 띄운 거 여기다 하면 거기다가선 한 장이고두 장이고 그 누룩도 좀 넣어
그러만 그거 인제 누룩술 데는 거야	그러면 그거 이제 누룩술 되는 거야
한지 일주이리구 한 파릴 파리리구 그러케 해서 인제 데마는 그거 인제 게자나 꿀럭꿀럭꿀러카구	한 지 일주일이고 한 팔일 팔일이고 그렇게 해서 이제 되면 그거 이제 고이잖아 꿀럭꿀럭하고
떠올라서 게 그러구서는 한 반 정도 게마는 이러케 찌거머거보먼 아주 달크무르를 허구 그러먼섬두마시찌 뭐	떠올라서 고여 그리고선 한 반 정도 고이면 이렇게 찍어먹어보면 아주 달큰하고 그러면서도맛있지 뭐그래서 그거이 인제 다 게마는 또 찹쌀 삽 찹쌀 주글 쒀 바블 허든지 주글 쒀그래서 그게 이제 다 고이면 또 찹쌀 찹쌀 죽을 쒀 밥을 하든지 죽을 쒀
그러켄 멥쌀루 해두 되구 그랜데 찹쌀주글 해서 쑤만 쒀서 여기다가 훙그를허게 또 무를 해가지구여기다 붜	그렇게는 멥쌀로 해도 되고 그런데 찹쌀죽을 해서 쑤면 쒀서 여기다가 훙그를하게 또 물을해가지고 여기다 부어
그리마는 찹쌀주글 해부마는 수리 호리호리허구 달크믈허구 마시꾸 아주	그러면 찹쌀죽을 해 부으면 술이 호리호리하고 달큰하고 맛있고 아주
멥싸를 허만 좀 들 호로로허구 그래	멥쌀을 하면 좀 들 호롤로하고 그래
그러케 해서 인제 또 다 게마는 그쪼게 저런 그 그쪼게는 아주 그냥 저 찹쌀주글 해서 붜서	그렇게 해서 이제 또 다 고이면 그쪽에 저런 그 그쪽에는 아주 그냥 저 찹쌀죽을 해서 부어서한 사미리구 사이리구 데마는 다 게마는 아주 동 다 가라앙꾸 아주 동동주가 데는 거야한 삼일이구 사일이구 되면 다 고이면면 아주 동 다 가라앉고 아주 동동주가 되는 거야
아주 노라케 그냥 그 누루기구 뭐구 그런 건 기냥 야깐 뜨구 다 가라안저	아주 노랗게 그냥 그 누룩이고 뭐고 그런 건 그냥 약간 뜨고 다 가라앉아
그리군 그냥 그리만 그냥 바가지루다 이러케 미러서 그냥 가따 떠다가두 그냥 머꾸	그리고는 그냥 그러면 그냥 바가지로다 이렇게 밀어서 그냥 갖다 떠다가도 그냥 먹고
청주루두 떠서 인제 체에다 바타서 그냥 병에다 다마노코두 머꾸	청주로도 떠서 이제 체에다가 밭아서 그냥 병에다 담아놓고도 먹고
근데 그냥 마껄리루 머글랴만 더러는 그러카구 그냥 막 걸러서 걸러서 다마노쿠 먹찌 뭐	그런데 그냥 막걸리로 먹으려면 더러는 그렇게 하고 그냥 막 걸러서 걸러서 담아놓고 먹지뭐
그리구 항아리에 그냥 저 써느런 데 내다노쿠 그냥 머글 때만 저기해서	그리고 항아리에 그냥 저 써늘한 데 내다놓고 그냥 먹을 때만 저기해서그럼 인젠 허는 사람 음써 안해 내나 저기해서 허지그럼 이젠 하는 사람 없어 안 해 나나 저기해서 하지
내나 저기허서 허지 인제두 저런데 저 고구처네 그짝 사람드리 좀 마니 해	나나 저기해서 하지 이제도 저런 데 저 고구촌에 그쪽 사람들이 좀 많이 해
할무니들두 그러쿠 절믄 사람들두 그러구 근데 이쪼게선 허는 사람 별루야 안해	할머니들도 그렇고 젊은 사람들도 그러고 그런데 이쪽에선 하는 사람 별로야 안 해
난 기냥 여기 우리 저 삼추니 그저네 이장 보구 그럴 때 여기 처뚜마리 드러오는 창꼬 인는 데그 삼추니	난 그냥 여기 우리 저 삼춘이 그전에 이장보고 그럴 때 여기 첫머리 드러오는 창고 있는 데그 삼춘이
이장두 보구 저 면사무소 사람들두 그냥 며 마니 그냥 손님들두 오구 그냥 그리마는	이장도 보고 저 면사무소 사람들도 그냥 며 많이 그냥 손님들도 오고 그냥 그러면
저기 형수가 핸 마껄리가 조타구 그냥 저기헌다구 그래니까	저기 형수가 한 막걸리가 좋다고 그냥 저기한다고 그러니까
해주만 그니껜 그걸 인천 가따 와따 가따허는 저기 시장에서	해주면 그러니까 그걸 인천 갔다 왔다 갔다하는 저기 시장에서
사가지구 와서 당가서 그냥 내가 주구 이럴 때두 머꾸 그냥 그런다구 그래서 내가 이 보메두한번 해찌	사가지고 와서 담가서 그냥 내가 주고 일할 때도 먹고 그냥 그런다고 그래서 내가 이 봄에도한 번 했지
해서 모짜리들 허는 날 그냥 걸러서 그러케서 빠케스에다 해서 올려보내 가따머그라구	해서 못자리들 하는 날 그냥 걸러서 그렇게 해서 양동이에 해서 올려보내 갖다먹으라고
가따들 머꾸 오민가민 그냥들 머꾸 그러게 그래따구드라구 저기해서	갖다들 먹고 오며가며 그냥들 먹고 그러게 그랬다고 하더라고 저기해서
마시껜네요 아주  마시께써요	맛있겠네요 아주  맛있겠어요
그리구 아까 또 그 연 만드는 과정에서 시캐 얘기도 잠깐 하셔짜나요  시캐는 또 어트게만드는	그리고 아까 그 엿 만드는 과정에서 식혜 얘기도 잠깐 하셨잖아요  식혜는 또 어떻게만드는
시캐는 그저넨 소테다가 여쌔기듣 그러케 새겨서  그러케해서그냥 저기해서 그러는데	식혜는 그 전엔 솥에다가 엿 삭이듯 그렇게 새겼어 그렇게 해서 그냥 저기해서 그러는데
근데 그냥 이 양바니 그런 그걸 조아해 시캐를	그런데 그냥 이 양반이 그런 그걸 좋아해 식혜를
근데 인제 이 저기에두 강기가 드러서 저기허구 바메두 그냥 뭘 저기허만 잡쒀스만 허니까는이 여르메두 저기야	그런데 이제 이 저기에도 감기가 들어서 저기하고 밤에도 그냥 뭘 저기하면 잡쉈으면 하니깐이 여름에도 저기야
장차 해서 그래 해서 두버늘 해서 잡쒀 근데 인저는 소테다 안허지	장차 해서 그래 해서 두 번을 해서 잡숴 그런데 이제는 솥에다 안 하지
밥통 보온밥 밥통 이짜나	밥통 보온밥 밥통 있잖아
거그다 바패가지구  그냥 엳끼 엳끼리미 사다가서는 그냥	거기다 밥해가지고  그냥 엿기 엿기름 사다가서는 그냥
한 봉 사다 걸러서 밥 좀 해 인제 그냥	한 봉 사다 걸러서 밥 좀해 이제 그냥
업시 그러케 해	없이 그렇게 해
그러만 요런 밥 해멍는 솓 거기다가서는 해가지구서는 한 봉 시캐 한 봉 사다 걸러서	그러면 이런 밥 해먹는 솥 거기다가서는 해가지구서는 한 봉 식혜 한 봉 사다 걸러서
그러케 해서 그냥 가라안처서 그러케 해서 인제 바비 다 되마는 다 되서 저기허구 그리마는 거걸러놔떤 여끼리미	그렇게 해서 그냥 가라앉혀서 그렇게 해서 이제 밥이 다 되면 다 돼서 저기하고 그러면 거  걸러놨던 엿기름
그걸루 그냥 밥통에다가 붜	그걸로 그냥 밥통에다가 부어
붜눠서 그냥 이러케 해노만 그거는 감주는 다서씨간 그러케 되만 사가	부어 놔서 그냥 이렇게 해놓으면 그거는 감주는 다섯시간 그렇게 되면 삭아
다서여서씨간	다서여섯시간
그러커마는 그냥 저기야 옌나렌 그거 소딴지에다 똑 이러케 그냥 붜가지구서 까쓰에다 끄리는데	그렇게 하면 그냥 저기야 옛날엔 그거 솥단지에다 똑 이렇게 그냥 부어가지고서 가스에다끓이는데
그걸루다가 한솓 꼴깍 안치마는 인제 요런 양은냄비에다가 더러 질러서 부꾸	그걸로다가 한 솥 꼴깍 안치면 이제 이런 양은냄비에다가 더러 질러서 붓고
까쓰에다 끄리구 그냥 그거 인제 저기 취사를 눌러 그러먼 거기서 끄러	가스에다 끓이고 그냥 그거 이제 저기 취사를 눌러 그러면 거기서 끓어
그러먼 그냥 설탕 조끔 너쿠 인제 여끼리미가 덜 달자나	그러면 그냥 설탕 조금 넣고 이제 엿기름이 덜 달잖아
그니깐 좀 달다너케 머글랴머는 설탕을 좀 너 끄려서 쪼릴 때	그러니까 좀 달달하게 먹으려면 설탕을 좀 넣어 끓여서 졸일 때
그러캐서 그냥 해노쿠서는 저 김치냉장고에 너어노쿠 저녀기마는  그럼 인제는 보리를 안심짜나	그렇게 해서 그냥 해놓고선 저 김치냉장고에 넣어놓고 저녁이면  그런 이제는 보리를 안 심잖아
그리니까는  저기허구	그러니깐  저기하고
응 그러캐섬 그래서 이 저기 여르메두 강기드러서 저기허구 그냥 기침나구 그리만 저기호만 바메그냥 하나 업씨나 그러케 되마는 또	응 그렇게 해서 그래서 이 저기 여름에도 감기들어서 저기하고 그냥 기침나고 그러면 저기하면밤에 그냥 하나 없이나 그렇게 되면 또
저기 기침나서 저기호만 찬 거 잡쑤만 저기하니까 또	저기 기침나서 저기하면 찬 거 잡수면 저기하니까 또
내 좀 냄비에다 좀 끄려서 따끄넌 거 잡쑬 적뚜 이꾸 어드런 땐 그냥 퍼다 잡쑬 적뚜 이꾸 그러치	내 좀 냄비에다 좀 끓여서 따끈한 거 잡술 적도 있고 어떤 땐 그냥 퍼다 잡술 적도 있고그렇지
그러케 해 머거 저기두  그건 쉬워 인전 지베서 해멍는건	그렇게 해 먹어 저기도  그건 쉬워 이제 집에서해먹는 건
옌나렌 그저 소테만 새겨서 불만 때야대는 줄 안데 인제는 전기밥쏘시 이짜나	옛날엔 그저 솥에만 삭혀서 불만 때야되는 줄 알았는데 이제는 전기밥솥이 있잖아
나미 자리가 데서 저기지 자믈 저기해서 졸 졸리나봐	남의 자리가 되서 저기지 잠을 저기해서 졸 졸리나봐
가마 써 이 아가씨는 여기 첨이나 첨 완나봐  처음 와써요 얘는	처음 왔나봐  처음 왔어요 얘는
펴나니 안저 발저려	편안히 앉아 발 저려
학교 마처 가치	학교 마쳐 갔지
어어	어어
지애는 석싸를 이제 바다꾸요 이버네 바다꾸 저친구도 이제 곧 인제 해서 바 열씨미 해서 바다야하구요	지애는 석사를 이제 받았고요 이번에 받았고 저 친구도 이제 곧 이제 해서 바 열심히 해서받아야 하고요
그럼 된장 간장 꼬추장도 다 담가 잡쑤신 거예요 옌나레는	그럼 된장 간장 고추장도 다 담가 잡수신 거예요 옛날에는
지금두 당가먹찌지금두 당가먹찌 그렁거야	지금도 담가 먹지 그런 거야
이유 인제 회과네두 어저께 그냥 한거시기 퍼가서 저거 그러지요	아유 이제 회관에도 어저께 그냥 한 거시기 퍼 갔어 저거  그렇지요
응 아주 그냥 저기헌 사람들 매  된장 된장을 담가다머그만 아유 우린 인제두 저기두 양배추 쩌서 그냥 저기자나	응 아주 그냥 저기한 사람들 매  된장 된장을 담가다먹으면 아유 우린 이제도 저기도 양배추 쪄서 그냥 저기잖아
그 인천사람들 온데 그저 받 나가서 꼬추 따다 찌거머꾸	그 인천사람들 온 데 그저 밭 나가서 고추 따다 찍어먹고
그냥 저기 요런 냄비에다 끄려서 꼬추장하고 된장하고 떠다가서는 그냥 끄려선 멍는데 마시따구들허데	그냥 저기 이런 냄비에다가 끓여서 고추장하고 된장하고 떠다가서는 그냥 끓여선 먹는데 맛있다고들 하데
어저께두 그러게 여기 동네 된장덜 그러게 된장 그런 거 짜야지 되자나	어저께도 그러게 여기 동네 된장들 그러게 된장 그런 거 짜야지 되잖아
된장 그런 거 짜야지 안짜먼 좀 틀리자나	된장 그런 거 짜야지 안 짜면 좀 틀리잖아
버 아이 벌레두 짜두 저기허긴 허지마는 그러케 저기야	버 아이 벌레도 짜도 저기하긴 하지만 그렇게 저기야
된장이 싱거마는 시크므르해요 그래서 짜게 당그자나	된장이 싱서우면 시큼해요 그래서 짜게 담그잖아
그르니깐 그냥 이러케 찌거머끼는 좀 저기라구러는데 어저께 거 퍼간는데 그래요 아유 된장만만 음는데 무어이 아주머이 어드러타 그레요 그러게	그러니까 그냥 이렇게 찍어먹기는 좀 저기라고 그러는데 어저께 거 퍼갔는데 그래요 아유된장 맛만 없는데 뭐가 아주머니 어떻다 그래요 그러게
짜게 당그니껜 마시꾸 그냥 그저넨 이 고기 궈머꼬 동네서 그냥 이 사네 올라서 고기궈그 마머꾸 그리만 그저 우리 된장만 퍼다먹찌	짜게 담그니깐 맛있고 그냥 그 전엔 이 고기 구워 먹고 동네에서 그냥 이 산에 올라가서 고기구워 마 먹구 그러면 그저 우리 된장만 퍼다 먹지
여 내가 그냥 다 내가 끄려서 가따주구 뭐 미끼리탕허구	여 내가 그냥 다 내가 끓여서 갖다주고 뭐 미꾸라지탕하고
올다니만 이 사네다가서는 양은솓 가따노쿠 불 때구 그냥 그 나무 그 사네서 그냥 때니깐	올라다니면 이 산에다가서는 양은솥 갖다놓고 불 때고 그냥 그 나무 그 산에서 그냥 때니까
해서 머꾸 저 서울 사람드리 아저씨드리 오만 그저네 그러게 호준 어머이가 늘 그 소리 허자나	해서 먹고 저 서울 사람들이 아저씨들이 오면 그 전에 그러게 호준 어머니가 늘 그 소리 하잖아
에유 그럴때가 아주먼네 사네서 미끼리루 탕끄려서 머꾸 그럴 때가 조은 시저리지 인전	에유 그럴 때가 아주머니네 산에서 미꾸라지로 탕끓여서 먹고 그럴 때가 좋은 시절이지 이제
그저 까스에만 허구 그냥 저기허구 그래	그저 가스에만 하고 그냥 저기하고 그래
난 어끄저께두 저기 저 양은소테다 바패가지구 바블 다 눌려서 해머거봔네	난 엊그저께도 저기 저 양은솥에다 밥 해가지고 밥을 다 눌려서 해먹어봤네
저기 누룽지 해머글랴구	저기 누룽지 해먹으려고
아이 그런데 저기야 그 현미싸리 조타구그래서 현미싸를 십키로 사다가 바블 해멍는데	아이 그런데 저기야 그 현미쌀이 좋다고 그래서 현미쌀을 십키로 사다가 밥을 해먹는데
그 현미싸리 조타그래두 탁탁타타커구 저기야	그 현미살이 좋다 그래도 탁탁탁탁하고 저기야
암녁쏘테다가 허닝까는 해먹지	압력솥에다가 하니까는 해먹지
그런껜 현미 찹쌀 그리께는 찹싸러구 멥싸러구는 저기허는데	그러니까 현미 찹쌀 그러니까는 찹쌀하고 멥쌀하고는 저기하는데
현미싸를 십키로를 사다가 찹싸러구 멥싸러구 서껀 데다가 그거를 호나블 해가지구 하는데	현미쌀을 십키로를 사다가 찹쌀하고 멥쌀하고 섞은 데다가 그거를 혼합을 해가지고 하는데
암녁쏘테다가 허마는 좀 난데 그냥 이러케 허니까는 더 탁  탁타그려	압력솥에다가 하면 좀 나은데 그냥 이렇게 하니까는 더 탁
거 응 서리태콩하구 서꺼서 그냥 해멍는데 저기드라구	거 응 서리태콩하고 섞어서 그냥 해먹는데 저기더라고
꼬추장 된장 다 저기지 그럼	고추장 된장 다 저기지
이 기우리만 인제 콩농사를 해가지구 기우리만 인제 콩타자글 호마는 인제 저기야	이  이제 콩농사를 해가지고  이제 콩타작을 하면 이제 저기야
이 저기 아래 뭐야 메주를 쒀 소테다가	이 저기 아래 뭐야 메주를 쒀
소테다 인제 콩을 인자 한마리구  그러묘 아래 쑤죠	솥에다 이제 콩을 이제 한 말이고  그럼요 아래 쑤죠
아유 이 저기 김장만 끈나만 김장만 끈나만 메주 쑤는 거야	아유 이 저기 김장만 끝나면 김장만 끝나면 메주 쑤는 거야
메주를 쒀서 그러케 해서 인제 메주를 맨드러서 놔따가서는	메주를 쒀서 그렇게 해서 이제 메주를 만들어서 놨다가서는
인제 뿌득뿌득 말르머는 지브루다가 지브루다가 여꺼서 저기다가서는 마당에 인제 저런 눈 안오구해뼈뚜 좀 쎄구 그런 데다가 매다라	이제 뿌득뿌득 마르면 짚으로다가 짚으로다가 엮어서 저기다가서는 마당에 이제 저런 눈 안오고 햇볕도 좀 세고 그런 데에다가 매달아
매다라따가서는 그거 인제 서딸 음녁 음녁 서딸 구뭄 명일 인제 댈 임바캐서	매달았다가서는 그거 이제 섣달 음력 음력 섣달 그믐 명일 이제 될 임박해서그걸 띠어다가서는 빡스에다가서는 재 이러케 뜨드턴데 노쿠 집 노쿠 그러커구 메주를 재그걸 띄워다가서는 박스에다가서는 재 이렇게 뜨듯한 데 놓고 짚 놓고 그렇게 하고 매주를재
그러마는 인제 뜨자나 그러만 멩일 세구 정월짱을 당가야 장을 인제 저기야 모짜리 허기 저네쪼리구 그린다구	그러면 이제 뜨잖아 그러면 명일 쇠고 정월장을 담가야 장을 이제 저기야 못자리 하기 전에졸이고 그런다고
인제 그냥 정월 한 저기야 센지 한 이시보일 그 저기 이십사이리나 이시보일 그 경에는 장을당가	이제 그냥 정월 한 저기야 쇤지 한 이십오일 그 저기 이십사일이나 이십오일 그 경에는 장을담가
당가따가서는 당가따 한달  음료수두  우리 조은 거이찌 응	담갔다가서는 담갔다 한달  음료수도  우리좋은 거 있지 응
그 쑹무를 조금씩 줘 으응 응  쑥 쑥 저기야	으응 응  쑥 쑥 저기야
이걸 뽀바야지  저기에다가 인제 매시리구 뭐구 다 효소만들자나 쑥뚜 인제 그러케핸거지 머	이걸 뽑아야지  저기에다가 이제 매실이고 뭐고 다 효소 만들잖아 쑥도 이제그렇게 한 거지 뭐
이 할머이가 맨드른 거 저 쑹내 향기나구 조아 쑤기 사랑께두 조차나	이 할머이가 만든 거 저 쑥내 향기나고 좋아 쑥이 사랑께도 좋잖아
또 이 해풍마즌 쑤기 조타 강화쑤기 그래서 조타 그러지	또 해풍 맞은 쑥이 좋다 강화쑥이 그래서 좋다 그러지
강화 약쑥	강화 약쑥  그럼 바다 근처에 거 다 잘라다가서
그거 일련 돌만에 짜가지구 먹찌	그거 일 년 돌만에 짜가지고 먹지
근데 그런 거이 조은데 해머끼 귀차느니께 그냥 해서 저러케 두구 우덜두 커피만 머거	그런데 그런 게 좋은데 해먹기 귀찮으니까 그냥 해서 저렇게 두고 우리들도 커피만 먹어
난 다리가 시원칠 아나서 이러커구 이서	난 다리가 시원칠 않아서 이렇게 하고 있어
아유아유 괜차느심니다 예	예 아유아유 괜찮으십니다
나 삼급장애야	나 삼급장애야
된장을 만들다 마라써요 아까  아까 메주 떼워 띄워노쿠	된장을 만들다 말았어요 아까  아까 메주 떼워 띄워놓구
메주를 인제 그러케해서 띠어 빡쓰에다가서는 인제 지블 인제 한케씩 너쿠 인제 띠여가지구서는	메주를 이제 그렇게 해서 띄워 박스에다가서는 이제 짚을 이제 한 켜씩 넣고 이제 띄워가지고서는
정월 인제 저기 한 이시보일 그러케 되마는 인제 장을 당가 소금무를 타	정월 이제 저기 한 이십오일 그렇게 되면 이제 장을 담가 소금물을 타
인제 메주 메주 한마를 쑤마는 다때	이제 메주 메주 한 말을 쑤면은 닷 되
다때를 메주 다때를 한마를 쑤마는 인제 소금두 인제 동가블 해	닷 되를 메주 닷 되를 한 말을 쑤면 이제 소금도 이제 동갑을 해
소금두 소금두 동가블 해서 인제 무를 인제 시마리구 얼마구 인제 저기야 노켜 소금 한마레다가	소금도 소금도 동갑을 이제 물을 이제 서 말이고 얼마고 이제 저기야 녹여 소금 한 말에다가
그러케서 노켜서 인제 그냥 다 소그미 노그마는 체에다 인제 그 무를 바타	그렇게 해서 녹여서 이제 그냥 다 소금이 녹으면 체에다 이제 그 물을 밭쳐
바타서 인제 항아리를 장또까네다 가따가 그 장 당으는 항아리가 이짜나	밭아서 이제 항아릴 장독간에다 갖다가 그 장 담그는 항아리가 있잖아
그르만 거기다가서는 항아리를 노쿠선 인제 장또카네다가 노쿠서는	그러면 거기다가서는 항아리를 놓고선 이제 장독간에다가 놓고서는
메주를 인제 띠엉거를 다 인제 그냥 다 이러케 깨끄시 인제 씨처 다 갈가내구	메주를 이제 띄운 거를 다 이제 그냥 이렇게 깨끗이 이제 씻어 다 갉아내고
인제 저기자나 시서리 남짜나 곰팡이 그 저기가 나야 메주가 그이 뜨는거야 이러케 새카마케	이제 저기잖아 시설이 남잖아 곰팡이 그 저기가 나야 메주가 뜨는 거야 이렇게 새까맣게
그러만 인제 그냥 무레다 그걸 다 따까서 바구니에다가 건져 놔따가 해뼈테다가 인제 좀 꺼덕꺼더커게 말려	그러면 이제 그냥 물에다 그걸 다 닦아서 바구니에다 건져 놨다가 햇볕에다가 이제 좀 꺼덕꺼덕하게 말려
그러케다가서는 장깐 타서 가따가서는 항아리에다가 부언 데다가서는 그 메 메주 말링거 그걸가따가 거기다 느치 뭐	그렇게 해다가서는 장간 타서 갔다가서는 항아리에다 부은 데다가서는 그 메 메주 말린 건그걸 갖다가 거기다 넣지 뭐
너쿠서는 숟뚜 두어덩어리 느쿠 대추도 느쿠 그냥 꼬추도 빨간 꼬추도 좀 느쿠	넣고서는 숯도 두어 덩어리 넣고 대추도 넣고 그냥 고추도 빨간 고추도 좀 넣고
그러케 해서 장을 당그는 거야	그렇게 해서 장을 담그는 거야
그러마는 그거이 인제 저기 그저네는 한달 되만 쪼린다고 옌날 할머이드른 그랜는데	그러면 그게 이제 저기 그전에는 한 달 되면 졸인다고 옛날 할머니들은 그랬는데
인전 당근지 한 이시보일 그저 한 이심뉴길 그러케 되마는 저기야 쪼려	이젠 담근지 한 이십오일 그저 한 이십육일 그렇게 되면 저기야 졸여
된장때이를 엔나레는 된장을 그거 된장땡이만 그저 건저서 인제 소금처서 인제 항아리에다저련는데	된장 덩이를 옛날에는 된장을 그거 된장 덩이만 그저 건져서 이제 소금 쳐서 이제 항아리에다절였는데
지그믄 그거뚜 내가 여기선 새봄 내떠래서 이동네서	지금은 그것도 내가 여기선 새 본을 냈더랬어 이 동네에서
인제 콩을 인제 신데 두리구 얼마구 살마	이제 콩을 이제 신데 둘이고 얼마고 삶아
살마서 그냥 지비서 그냥 저 절구에다 쿠쿡 쪄 그냥	삶아서 그냥 집에서 그냥 저 절구에다 쿡쿡 쪄 그냥
그냥 곱다너케 다 찌쿠 그냥 저기허게 인제 그냥 고게 그냥 뭐 지 찔쑤나 이야 힘들구 그르니까기냥 절구에다 그냥 찌어가지구	그냥 곱단하게 다 찧고 그냥 저기하게 이제 그냥 그게 그냥 뭐 지 찧을 수나 이야 힘들고 그러니까그냥 절구에 다 그냥 찧어가지고
그러케가지구서는 인제 된장때이 건질 때 가치 가치 버무려	그렇게 해가지고서는 이제 된장땡이 건질 때 같이 같이 버무려
그르껜 막뙨장이야 인제 막뙨장들 맨드러서 먹짜나	그러니까 막된장이야 이제 막된장들 만들어서 먹잖아
그러케선 그냥 거기다가 짭짜라게 소금치지 뭐 소그믈 너	그렇게 해선 그냥 거기다가 짭짤하게 소금 치지 뭐 소금물 넣어
너서 그냥 가치 버무려 그냥 거기 콩살믄거허구 된장때이 건진거하구	넣어서 그냥 같이 버무려 그냥 거기 콩 삶은 거하고 된장땡이 건진 거하고
그러케해서 다라이에다 다 건저서 노쿠 아주 그냥 다 주물러서 그러케서 그냥 버무려 곱따나케다 주물러 깨트려서	그렇게 해서 다라이에다 다 건져서 놓고 아주 그냥 다 주물러서 그렇게 해서 그냥 버무려곱단하게 다 주물러 깨트려서
옌날 할머이드른 그저 된장항아리 그냥 된장때이 건지구 소금 술술 뿌리구 그냥 이러케서 저려찌	옛날 할머니들은 그저 된장항아리 그냥 된장땡이 건지고 소금 술술 뿌리고 그냥 이렇게 해서절였지
인전 그냥 다라이에다 된장때이 건저서 콩 살믄 거 찌언 거허구 소금 너쿠 그러케서 버무려	이젠 그냥 대야에다 된장땡이 건져서 콩 삶은 거 찧은 거하고 소금 넣고 그렇게 해서 버무려
그러케해서 그리구 꼬추씨 꼬추씨 그런 거 가라다 좀 너어 얼크나라구	그렇게 해서 그리고 고추씨 고추씨 그런 거 갈아다 좀 넣어 얼큰하라구
꼬추씨좀 가라서 그냥 가따가서는 너타 그 꼬추씨가 조차나	고추씨 좀 갈아서 그냥 갖다가서는 넣다 그 고추씨가 좋잖아
그거좀 느쿠 그러커구 버무려 버무려서는 그러케서 된장항아리에 당꾸서는 그냥 꾹꾹 눌러서그러캐서 노쿠선	그거 좀 넣고 그렇게 하고 버무려 버무려서는 그렇게 해서 된장항아리에 담고서는 그냥 꾹꾹눌러서 그렇게 해서 놓구선
인제 오래 저린 건 내녀네 머꾸 먼저 저린 거 인제 머꾸 재장녀네 저린 건 오래 머꾸 오래 저린건 인제 내녀네 먹찌	이제 올해 절인 건 내년에 먹고 먼저 절인 거 이제 먹고 재작년에 절인 건 올해 먹고 올해절인 건 이제 내년에 먹지
근데 오래 저린 거뚜 그러케 해서 저려떠니 저기야 괜차나 그냥 막뙨장 청국장거치 청국뙨장거뜨라구 끄려머그니까	그런데 올해 절인 것도 그렇게 해서 절였더니 저기야 괜찮아 그냥 막된장 청국장 같이 청국된장같더라고 끓여 먹으니까
오래 핸 거 그러케해 저기 장 당으는거	올해 한 거 그렇게 해 저기 장 담그는 거
그러게 인제 우리 며누리가	그러게 이제 우리 며느리가
며누리가 접때도 오나 오나서 인제 아드라고 저 쌀 머 싱량 그런 거 가질러 와서 배추 뭐 김치그런 거	며느리가 저번 때도 와 와서 이제 아들하고 저 쌀 뭐 식량 그런 거 가지러 와서 배추 뭐 김치그런 거
우더리 좀 뜸허게 가 가뜨니 그래가지구서는 저 가질러 오나는데	우리들이 좀 뜸하게 가 갔더니 그래가지고서는 저 가지러 오는데
뭐야 그냥 저런 거 두부를 내가 해찌 국 오만 떠머글 거 업서서 두부를 해서	뭐야 그냥 저런 거 두부를 내가 햇지 국 오만면 떠먹을 거 없어서 두부를 햇어
저 바단물 떠다가 놔따가	저 바닷물 떠다가 놧다가
바단물 떠다놔따가서는 콩을 쪼끔 당가따가 두부를 인전 두부도 그저네 그냥 소테다가 허구 그러껜멩일가튼 때 여럳 머글 땐 소테다 허구	바닷물 떠다놨다가서는 콩을 조금 담갔다가 두부를 이제 두부도 그 전에 그냥 솥에나가 하고그러니까 명일 같은 때 여럿 먹을 땐 솥에다 하고
우리끼리 머글 땐 그냥 밥통에다 해두 돼 까쓰에 해두 돼 쪼끔씩 허는 건	우리끼리 먹을 땐 그냥 밥통에다 해도 돼 가스에 해도 돼 조금씩 하는 건
그러케서 순두부를 맨드러 놔뜨니 저기 어므니 이거 여기 저 인천 가서 내가 해머거두 되나되나요 그래 그래서	그렇게 해서 순두부를 만들어 놧더니 저기 어머니 이거 여기 저 인천 가서 내가 해먹어도되나 되나요 그래 그래서
해머거두 되지 그럼 내가 짠물 기러다논 거 끄려서 그러케 해서 음료수뼝에다가 하나 가지구가서	해먹어도 되지 그럼 내가 짠물 길어다놓은 거 끓여서 그렇게 해서 음료수병에다가 하나 가지구가서
콩 가주구 가서 그러케 해서 허마는 밥통에다 끄려서 해두 까쓰에 끄려서 해두 되구 그러니깐  해두 된다 내가 그랜 그러니깐	콩 가지고 가서 그렇게 해서 하면 밥통에다 끓여서 가스에 끓여서 해도 되고 그러니깐 해도된다 내가 그랜 그러니깐
내가 한번 해봐야지요 그런 그래드라구	내가 한 번 해봐야지요 그런 그러더라고
그래서 저기 해라 뭐 어려울 꺼 인냐 콩 당가따가 다 부른대먀 믹써에다 가라서 주머이에다짜서 메뻔 짜지 그건 아주 말간 무리 나드락 콩 두부허는 건	그래서 저기 해라 뭐 어려울 거 잇냐 콩 담갓다가 다 불은 다음에 믹서에다 갈아서 주머니에다짜서 몇 번 짜지 그건 아주 말간 물이 나도록 콩 두부하는 건
그러케서 짜서 소테다가 끄려	그렇게 해서 짜서 솥에다가 끓여
끄려가지구서는 우루루 간데 끄려서 끄르마는 좀 놔둬따가 그르마는 이제 혼니부리 짜가져	끓여가지고서는 우루루 가운데 끓여서 끓으면 좀 놔둿다가 그러면 이제 홑이불이 작아져
이러케 두꺼께 아주 짜가지먼 고거 가서 요러케 허마넌 아주	이렇게 두껍게 아주 작아지면 그거 가서 이렇게 하면 아주
두껍따 허는 혼니불 이라구 그거 요러케 지버져 그러먼 그거 건져내구	두껍다 하는 홑이불 이라고 그거 이렇게 집어져 그러면 그거 건져내구
거기다가 인제 바단물 짠물 기러온 거를	거기다가 이제 바닷물 짠물 길어온 거를
한물 한번 끄려따가서는 끄린거를 거기따가서는 이러케 가늘 주는 거야 그게 간준다 그래	한 물 한 번 끓였다가서는 끓인 거를 거기에다가서는 이렇게 간을 주는 거야 그게 간준다그래
사발에다가 두리 되든지 세시 되든지 인제 거기다가 인제 그 콩물 끄런 데다가 줘	사발에다가 둘이 되든지 셋이 되든지 이제 거기다가 이제 그 콩물 끓은 데다가 줘
그러마는 한번 주마는 그냥 그냥 고대로 이렇게 그냥 물대루 두구 뽀얀 게 그냥 이서	그러면 한 번 주면 그냥 그냥 그대로 이렇게 그냥 물대로 두고 뽀얀 게 그냥 잇어
그리구 또 두번째 또 주마는 망울망울해져	그리고 또 두 번째 또 주면 망울망울해져
그걸 덴 간을 덴통 주마는 두부가 안 나요 안 당거 안돼	그걸 된 간을 된통 주면 두부가 안 나요 안 담거 안돼
그냥 그걸 또 두번째 두만 이러케 망울망울허게 인제 돼	그냥 그걸 또 두번째 두면 이렇게 망울망울하게 이제 돼
그럼 또 세번째 또 또 줘 인제 그 간수를	그러면 또 세 번째 또 또 줘 이제 그 간수를
그러먼 그쪼게는 그냥 이러케 덩어리가 지게 엉겨	그러면 그 쪽에는 그냥 이렇게 덩어리가 지게 엉겨
세번 줘서도 또 들 들인제 가늘 뜨게 주니까	세 번 줘서도 또 들 들이제 간을 뜨게 주니까
뜨게 줘야 두부두 마니 나구 두부가 말랑말랑헌 게 마시찌	뜨게 줘야 두부도 많이 나고 두부가 말랑말랑한 게 맛있지
대버네 그냥 저기허구 그리마는 우리 여기 삼춘 말투로 우리	대번에 그냥 저기하고 그러면 우리 여기 삼촌 말투로 우리
저 지년어머이 허는 두부는 저 벽똘두부라구 딴따나다구 인제 그르지	저 진현 어머니 하는 두부는 저 벽돌두부라고 딴딴하다고 이제 그러지
형수가 허는 건 말랑말랑헌데 그냥 우리 지년어머니가 허는 건 벽똘두부야 벽똘두부야 그냥 그래	형수가 하는 건 말랑말랑한데 그냥 우리 진현어머니가 하는 건 벽돌두부야 벽돌두부야 그냥그래
그러케 해 그냥 그러케 해서 또 세번 주고도 가니 그냥 이러케 눌루게 또 안되구 좀 멍술멍술허만가늘 쪼끔 더줘	그렇게 해 그냥 그렇게 해서 또 세 번 주고도 간이 그냥 이렇게 부르게 또 안 되고 좀 멍술멍술하면간을 조금 더 줘
그러만 인제 눌루게 돼 그러만 걍 노라케 그냥 그 저거가 뭐야 무리 촌무리 생겨	그러면 이제 눌르게 돼 그러면 그냥 노랗게 그냥 그 저거가 뭐야 물이 촛물이 생겨
그러만 그걸 좀 질루 그러커구 보재기 피구 그러커구서는 또 눌러서 머글래만 모루 해서 머꾸또 순두부 더러 퍼노쿠	그러면 그걸 좀 질로 그렇게 하고 보자기 피고 그렇게 하고서는 또 눌러서 먹으려면 모로해서 먹고 또 순두부 더 퍼놓고
그러커구 두부두 해머꾸  말랑말랑해	그렇게 하고 두부도 해먹고  말랑말랑해
소굼 인제 간수라 그러자나 간수	소금 이제 간수라 그러잖아 간수
그거는 소굼짤래기를 가따가 놔두마는 인제 여기다가 인제 소굼짤래기를 올려놔	그거는 소금 자루를 갖다가 놔두면 이제 여기다가 이제 소금잘래기를 올려 놔
그리구서는 요기다가서는 인제 그르슬 놔두만 그 소그미 그거이 인제 노가서 여기에 간수가떠러지는 거야 그러마는	그리고선 여기다가서는 이제 그릇을 놔 두면 그 소금이 그게 이제 녹아서 여기에 간수가 떨어지는 거야 그러면
그걸루다가서는 그걸 병에다가 다마놔따가서는	그걸로다가선 그걸 병에다 담아놨다가서는
그걸루 인제 두부허는 거야 근데 그걸로다허마는 인제 되긴 허는데 좀	그걸로 이제 두부하는 거야 그런데 그걸로 하면 이제 되긴 하는데 그것도 좀
그것도 인제 그냥 저기허게 아주 짜게 그냥 서서히 허마는 괜차는데	그것도 이제 그냥 저기하게 아주 짜게 그냥 서서히 하면 괜찮은데
된 가늘 질러서 허만 두부가 딴따나고 마시 업써	된 간을 질러서 하면 두부가 딴딴하고 맛이 없어
우리는 그냥 흐니 바단무를 마니 떠다 끄려노코 해 인제도 저기도 끄려서 다마노쿠	우리는 그냥 흔히 바닷물을 많이 떠다 끓여놓고 해 이제도 저기도 끓여서 담아놓고
저 음료수뼝 그런데다 다마노쿠 이런 병에다가서는 다마노쿠 그러커구 두부도 그러케 해서 머꾸그러지 뭐	저 음료수병 그런 데다 담아놓고 이런 병에다가서는 담아놓고 그렇게 하고 두부도 그렇게해서 먹고 그러지 뭐
아까 된장은 만드션는데 고추장 만드는 건 말쓰믈 안해주션는데	아까 된장은 만드셨는데 고추장 만드는 건 말씀을 안해주셨는데
꼬추장은  꼬추장은 또 꼬추장은 인제 찹쌀꼬추장을 당을랴마는 멥쌀 찹싸를 차 찹쌀만바다두 새기구	고추장은  고추장은 또 고추장은 이제 찹쌀고추장을 담그려면 멥쌀 찹쌀을 차 찹쌀만빻아다가도 삭히고
인제 그냥 마니 인제 한말씩 허만 저런 큰 소테다 새기구	이제 그냥 많이 이제 한 말씩 하면 저런 큰 소테다 삭히고
인제 그냥 저 이러케 부를 때가민 미지근허게 해서 새기구 근데 인저는	이제 그냥 저 이렇게 불을 때가며 미지근하게 해서 새기고 그런데 이제는
그르게 인제 여끼리믈 사다 또 걸러 그거뚜	그러게 이제 엿기름을 사다 또 걸러 그것도
당가따가 메뻐늘 짜 아주 말간 무리 나드락	담갔다가 몇 번을 짜 아주 말간 물이 나도록
짜서 그냥 이런 다라이에다가서는 그냥 해서 걸러가지구선 그냥 그 뽀얀 무를 그냥 곤체에다가바타서 여이 다라이에다 이러케 다마놔	짜서 그냥 이런 대야에다가서는 그냥 해서 걸러가지고서 그냥 그 뽀얀 물을 그냥 고운 체에다가밭아서 여기 대야에다 이렇게 담아 놔
다마노쿠 그 무레다가 개 인제 가루 쌀가루 바온 걸	담아 놓고 그 물에다가 개 이제 가루 쌀가루 빻아온 걸
인제 개 큰소테다 할려면 그냥 거기다 다마서 그 기리민무를 그냥 부어가면 뭉그러게 그냥 해	이제 개 큰 솥에다 하려면 그냥 거기다 담아서 그 기름물을 그냥 부어가며 뭉근하게 그냥해
그러케 해서 소테다가 부를 때야지 그거이 미지근허든지 따드터든지 해야 사글 꺼 아냐	그렇게 해서 솥에다가 불을 때야지 그게 미지근하든지 따뜻하든지 해야 삭을 거 아냐
그러케서 새키구 소테다 하는 건 그러케 해서 허구	그렇게 해서 새기고 솥에다 하는 건 그렇게 해서 하고
또 쪼꿈 하는 건 인제 밥통이 킁거 이짜나 그러먼 밥통에다 큰 밥통에다가서는	또 조금 하는 건 이제 밥통이 큰 거 있잖아 그러면 밥통에다 큰 밥통에다가서는
저기야 둬서식 새겨	저기야 두어서씩 삭혀
그 엳끼리미를 개가지구 그 가루를 개가지구 누구눌굴허게	그 엿기름을 개 가지고 그 가루를 개 가지고 누구누굴하게
그러케해서 그냥 꼰자서 보오느로 꼰자노마는 그냥 아주 다서씨가니만 다 사가 다서여서씨가니만그거뚜	그렇게 해서 그냥 꽂아서 보온으로 꽂아놓으면 그냥 아주 다섯 시간이면 다 삭아 다서여섯시간이면 그것도
그러만 아주 말간 무리 돼 그 가루 이러케 되지커게 해서 다마노은 거이 아주 말간 무리 돼다 사그마는	그러면 아주 말간 물이 돼 그 가루 이렇게 되직하게 해서 담아놓은 게 아주 말간 물이 돼  다 삭으면
그러만 그쩌겐 쪼리는 거야 때서 인제	그러면 그때엔 졸이는 거야 때서 이제
되다너케 해서 꼬추까루 쳐서 저기헐 정도로 때	되단하게 해서 고춧가루 쳐서 저기할 정도로 때
이러케 주거그로 이러케 해바가민	이렇게 주걱으로 이렇게 해봐가며
그러먼 꼬추까루가 드러가마는 그러케 해서 되마는 다 인제	그러면 고춧가루가 들어가면 이렇게 해서 되면 다 이제
대려서 인제 될 엳 꼬추장이 될 정도 되마는 다라이에다 그 무를 퍼	대려서 이제 될 엿 고추장이 될 정도 되면 대야에 그 물을 퍼
푸마는 그쩌게는 메주까루 메주 메주 말려서 방거	푸면 그때에는 메줏가루 메주 메주 말려서 빻은 거
그거 꼬추까루 그러케 치구서는 그냥 버무리 꼬 버무리지 뭐	그거 고춧가루 그렇게 치고서는 그냥 버무리 꼬 버무리지 뭐
그러케 해서 꼬추장 당으는 거지 뭐	그렇게 해서 고추장 담그는 거지 뭐
그러케 해서 다마노치 뭐 단적찌에다 단적찌에다 그냥	그렇게 해서 담아놓지 뭐 단지 단지에다 그냥
그러케 해서 멍는 거야 꼬추장 그러케 해서	그렇게 해서 먹는 거야 고추장 그렇게 해서
인제 된장 만들고 꼬추장 만드러쓰면 이제 짱아치도 좀 만드러야 될거에요	이제 된장 만들고 고추장 만들었으면 이제 장아찌도 좀 만들어야 될 거예요
짱아찌  짱아찌는 뭐 여기서는 그르기는 인제 저기허드만 이 마늘쫑 나오는 거 이짜나짱아찌 당을랴만	장아찌는 뭐 여기서 그러기는 이제 저기하더만 이 마늘쫑 나오는 거 있잖아 장아찌 담그려면
그르겐 뭐 저런데서는 호방저기 이 콩니파리 짱아찌도 된장에 바가따 머꾸들 그래자나	그러게 뭐 저런 데서는 호박저기 이 콩이파리 장아찌도 된장에 박았다 먹고들 그러잖아
여긴 그런 거 아내 아랜녁 싸람드리 콩닙 그런 거 먹찌	여긴 그런 거 안 해 아랫녘 사람들이 콩잎 그런 거 먹지
그런데 이제 마늘짱 마늘쫑두	그런데 이제 마늘짱 마늘쫑도
마늘쫑두 저기야 해서 인제 가따가서는 소굼무레다가 인제 그걸 저려	마늘쫑도 저기야 이제 갖다가서는 소금물에다 이제 그걸 절여
저려따가서는 그걸 가니 머그마는 건져서 좀 뿌득뿌득 말린대	절였다가서는 그걸 간이 먹으면 건져서 좀 뿌득뿌득 말린대
말려따가서는 꼬추장을 버무려서 그리껜 다른 그러커마는 꼬추장 이 단적찌에다 허만 꼬추장을버리자나	말렸다가서는 고추장을 버무려서 그러니까 다른 그렇게 하면 고추장 이 단지에다 하면 고추장을 버리잖아
그리니까는 따로 쪼금 인제 머글만치 이런 저기 김치통 거튼 데다 담아서	그러니까 따로 조금 이제 먹을만큼 이런 저기 김치통 같은 데다 담아서
요만큼씨커게 짤라서 머끼 조케 그 마늘짱아찌를	이만큼씩하게 잘라서 먹기 좋게 그 마늘장아찌를
꽁을 짤라서 꼬추장을 떠서 거기다 인제 버무려서 인제 다마노쿠	콩을 잘라서 고추장을 떠서 거기다 이제 버무려서 이제 담아놓고
그이 그거이 짱아찌야	그 그게 장아찌야
짱아찌 허는 건 그리구 다른 거뚜 인제 된장을 헐래두 된장을 따루 그러케 허구	장아찌 하는 건 그리고 다른 것도 이제 된장을 하려도 된장을 따로 그렇게 하고
여기선 그냥 된 저기야 그리구 오이지	여기선 그냥 된 저기야 그리고 오이지
오이지 다 또 당가따가 노라케 당가따가	오이지 다 또 담갔다가 노랗게 담갔다가
그거뚜 인제 저기해서 좀 짜니까 짜니까 쪼끔 쓰러서 당가따가서는 눌러야돼 망짜 이런 보재기에다해서	그것도 이제 저기해서 좀 짜니까 짜니까 조금 쓸어서 담갔다가서는 눌러야 돼 망짜 이런보자기에다 해서
눌러따가서는 꼬추장이나 된장에 바가서 짱아찌 해멍는 건 통에다 따루 해서	눌렀다가서는 고추장이나 된장에 박아서 장아찌 해먹는 건 통에다 따로 해서
엔날 사람드른 그거뚜 그냥 덴장 항아리에다 무더써 통으루	옛날 사람들은 그것도 그냥 된장 항아리에다 묻었어 통으로
그러만 그냥 덴장이 저기 무리 생기구 그전 사람드른 몰라서 미려내서 그냥 그저 너따 끄내서머꾸 그래찌	그러면 그냥 된장이 저기 물이 생기구 그전 사람들은 몰랐어 미련해서 그냥 그저 넣었다 꺼내서먹고 그랬지인저는 고런 거뚜 짱아찌를 당을랴만 좀 우려서 보재기에다 해서 망짜글 눌러서 무리 짝 삔대메이제는 그런 것도 장아찌를 담그려면 좀 우려서 보자기에다 해서 망짝을 눌러서 물이짝 빠진 다음에
삔 대메 이런 통에다가구 된장을 거기다가 당가서 이러케 버무려서 눌러노쿠 그저 냉장고 이쓰께냉장고에 노쿠	빠진 다음에 이런 통에다가 된장을 거기다가 담가서 이렇게 버무려서 눌러놓고 그저 냉장고있으니까 냉장고에 넣고
그러케 먹찌 인제는 옌날 싸람드른 항아리에다 그냥 그	그렇게 먹지 이제는 옛날 사람들은 항아리에다 그냥 그
그르구 짱금치두 그러케 해서여 짱금치두 먹따 나므마는	그리고 장김치도 그렇게 했어요 장김치도 먹다 남으면
근데 그거이 옌나렌 그게 질 조타구 그러는 거야 이 하라버이 인제두 그러커라구이짜나	그런데 그게 옛날엔 그게 제일 좋다고 그러는 거야 이 할아버지 이제두 그렇게 하라고 하고있잖아
짱금치를 머꾸 나믄 거를 가으레 인제 해빠람 나구 그르자나	장김치를 먹고 남은 거를 가을에 이제 햇바람 나고 그러잖아
그르먼 인제 그냥 통에다가 그 짱금치를 쩍쩍 뻐글러서 당가	그러면 이제 그냥 통에다가 그 장김치를 쩍쩍 뻐개서 담가
그걸 아주 메칠씩 우려 아주 하야트락	그걸 아주 며칠씩 우려 아주 하얗도록
우리만 주를 쭉 매구 그걸 가따가 척척 이러케 그냥 쩍쩍 뻐글려서 그냥 그걸 통째 인제 말리꾸득꾸득 말리자나	우리면 줄을 쭉 매고 그걸 갖다가 척척 이렇게 그냥 쩍쩍 뻐개서 그냥 그걸 통째 이제 말리꾸득꾸득 말리잖아
그른대메 그냥 가따가서는 그걸 된장에다가 그냥 바 는는거야	그런 다음에 그냥 갖다가서는 그걸 된장에다가 그냥 바 넣는 거야
너따가서는 그거 한 쪽씩 끄내다가서는 기우레 그냥 그거 쫌 쓰 숭덩숭덩 쓰러느쿠 된장 끄려머꾸	넣었다가서는 그거 한 쪽씩 꺼내다가서는 겨울에 그냥 그거 좀 쓰 숭덩숭덩 썰어넣고 된장끓여먹고
근데 인저는 그러케 안하지 거기다는	그런데 이제는 그렇게 안하지 거기다는
허마는 된장이 틀려 인제는 허마는 따루따루따루 다	하면 된장이 틀려 이제는 하면 따로따로따로 다
뭐 저런 고돌빼기구 뭐구 다 그런 거 무더서 머글랴믄 따루따루 인젠 그러케 해멍는 거지 뭐	뭐 저런 고들빼기고 뭐고 다 그런 거 묻어서 먹으려면 따로따로 이젠 그렇게 해먹는 거지뭐
그 그러케 먹찌 뭘 짱아찌 당으는 거뚜 그런 시그루 하는 거지 뭐	그 그렇게 먹지 뭘 장아찌 담그는 것도 그런 식으로 하는 거지 뭐
그 이쪼게선 떠근 어떤 떡뜨를 주로 해머거써요	그 이쪽에선 떡은 어떤 떡들을 주로 해먹었어요
떠근 옌나레는 인절미를 마니 해찌 아이구 옌나레는	떡은 옛날에는 인절미를 많이 했지 아이구 옛날에는
옌나레는 저기 떡뚜 인제 시집짱개 보내자나 이사람 이 하라버이 이제 누이던 누이든지 동생이든지장갤 보내자나	옛날에는 저기 떡도 이제 시집장가 보내잖아 이 사람 이 할아버지 이제 누이든지 동생이든지장가를 보내잖아
그리마는 새길 보낸다구 보내 인제 누이는 인제 어드루 시지블 보내자나	그러면 새 길 보낸다고 보내 이제 누이는 이제 어디로 시집을 보내잖아
저 고구리 고구촌 인는 데루 인제 시지블 보낸다 그래	저 고구리 고구촌 있는 데로 이제 시집을 보낸다 그래
그리만 거기다 보내만 인제 조그미따 지비 친정에루 오나	그러면 거기다 보니면 이제 조금 있다 집에 친정에로 와
오나만 오마는 여그 와서 그냥 한 여리리구 이시비리구 인제 이 친정에서 쉬어따 가	오면 오면 여기 와서 그냥 한 열일이고 이십일이고 이제 이 친정에서 쉬었다 가
그르마는 저기 해서 보낸다구 큰기레서 보낸다구 찹싸를 당가따가서는 지비서 인제 시루에다쩌가지구	그러면 저기 해서 보낸다고 큰길에서 보낸다고 찹쌀을 담갔다가서는 집에서 이제 시루에다쪄가지고
두벌 찌지 한벌 찌마는 꼬드꼬드커자나 그리니까는 인제 두버를 찌마는	두 벌 찌지 한 벌 찌면 꼬득꼬득하잖아 그러니까 이제 두 벌 찌면
바가치에다가 인제 소금무를 좀 건거나게 타서 그걸 그 시루에다 그냥 퍼너쿠 인제 무를 줘	바가지에다 이제 소금물을 좀 건건하게 타서 그걸 그 시루에다 그냥 퍼넣고 이제 물을 줘
무를 줘가지구 그거를 또 한김 올라오드락 그냥 부를 때 그러케 허만 그 바비 찐둑찐두캐요	물을 줘가지고 그거를 또 한김 올라오도록 그냥 불을 때 그렇게 하면 그 밥이 찐득찐득해요
그러먼 퍼다가서는 그저네 나무절구 저러케 돌절구나 이서나	그러면 퍼다가서는 그 전에 나무절구 저렇게 돌절구나 있었나
그 절구두 이런데다가 그냥 이런 낭구깐 이런데다 노쿠서는	그 절구도 이런 데다가 그냥 이런 나뭇간 이런 데다 놓고서는
그거를 그냥 저기 뭐야 메 떵메 그거루다가서는 사라미 처	그거를 그냥 저기 뭐야 메  떡메 그걸로다가서는 사람이 쳐
처서 물루다가 그냥 이러케 깨껴느미 처	쳐서 물로다가 그냥 이렇게 께껴 넣으면서 쳐
그르만 차떡 인절미가 되는 거야	그러면 차떡 인절미가 되는 거야
그르만 파슬 쌀마서 쿡쿡 그냥 쩌가지구 똥그란떡 인제 속 싸서 엔나렌 뭐 속 싸서 똥그라케나해나	그러면 팥을 삶아서 쿡쿡 그냥 쪄가지고 동그란 떡 이제 속 싸서 옛날엔 뭐 속 싸서 동그랗게나했나
이러케 보리차떡 모냥으루 그 파슬 싸구 이마너케 이러케 이러케 맨드러서 그냥 상에다 쭉 다라	이렇게 보리차떡 모양으로 그 팥을 싸고 이만하게 이렇게 이렇게 만들어서 그냥 상에다 쭉달아
그러케서 그냥 이런 함지에다가서는 그걸 하낙씩 해서 해서 저 옌나레는 무슨 차가 이서 뭐이서 뭐 경운기가 이서 뭐 이 트럭타가 이서서	그렇게 해서 그냥 이런 함지에다가서는 그걸 하나씩 해서 해서 저 옛날에는 무슨 차가 있어뭐 있어 뭐 경운기가 있어 뭐 이 트랙터가 있었어
저 동차라구 그런 거 이짜나 거기다가 해서 실꾸 데려다 주는 거야	저 동차라고 그런 거 있짢아 거기다가 해서 싣고 데려다 주는 거야
아유 넌더리나게 떡두 허구 아주 이 하라버이가 골지를 다 우리게	아유 넌더리나게 떡도 하고 아주 이 할아버지가 골질을 다 우리게
동생덜 다 아들 새명제 딸 성제 다 해서 그런 거 해서 보내구	동생들 다 아들 삼형제 딸 삼형제 다 해서 그런 거 해서 보내고
그러케 떡 그리구 시루떡	그렇게 떡 그리고 시루떡
서따레 서딸 되마는 인제 멩일 쇨랴마는	섣달에 섣달 되면 이제 명일 쇠려면
인제 새루 농사 진 거라구 쌀 둬따가서는 그걸 바다가서는 파슬 케케두구 그러커구서는	이제 새로 농사 지은 거라고 쌀 뒀다가서는 그걸 빻아다가서는 팥을 켜켜이 그렇게 하고서는
고사떡 인전 다 교회나가구 저기허니깐 안쓰도 그걸 다 떠글 쩌다가서는 그냥 저런데다가 노쿠또 할머이더리 또 빌구 그러드만 에 엔날 할머니들	고사떡 이제 다 교회나가고 저기하니깐 그걸 안 써도 그걸 다 떡을 쪄다가서는 그냥 저런데다가 놓고 또 할머니들이 또 빌고 그러더만옛날 할머니들
그러케 고사 지낸다구 고사 지내구 그르 그래 그러케 허더라구 엔날 우리 시할머이 우리 시어머이서	그렇게 고사 지낸다고 고사 지내고 그르 그래 그렇게 하더라고 옛날 우리 시할머니 우리시어머니가
시루떡 찌는 거뚜 가르켜줘야지 떠까루 바서 시루떡 찌는 거 뭐 저기 시루떡 찌는 거는	시루떡 찌는 거 뭐 저기 시루떡 찌는거는
인제 바 그저네는 뭐 저런 기계가 인나 지비서 그거뚜 다 바찌	이제 바 그전에는 뭐 저런 기계가 있나 집에서 그것도 다 빻았지
그러케다 체에 다 그걸 처	그렇게다 체에 다 그걸 쳐
한벌 바서 치구 또 두벌 바서 치구 아주 그거이 떡무거리가 요만큼 남뜨락 바 바서 곤체에다처	한 벌 빻아서 치고 또 두 벌 빻아서 치고 아주 그게 떡무거리가 이만큼 남도록 빻아 빻아서고운체에다 쳐
그러케가지구 파슬 쌀마가지구 인제 해가지구서는 인제 저 뭐야 이런 저이 냉면때접 가튼 거루다가시루를 노쿠	그렇게 해서 팥을 삶아가지고 이제 해가지고선 이제 저 뭐야 이런 저 냉면대접 같은 걸로다가시루를 넣고
그러커구선 거기다 하나 둘 이러케 시루에다가 해서 요러케 요러케 피구서는 또 파슬 케케 또노쿠	그렇게 하고선 거기다 하나 둘 이렇게 시루에다가 해서 이렇게 이렇게 펴고서는 또 팥을 켜켜이또 놓고
또 떠까루 노쿠 또 팓 노쿠 그러커구서는 한 서너너더케씩 시루가	또 떡가루 놓고 또 팥 놓고 그렇게 하고서는 한 서너너더켜씩 시루가
인제 이거 시루래만 그냥 이러케 떠러지드락 이만큼 한 서너너더케씩 노쿠	이제 이거 시루라면 그냥 이렇게 떨어지도록 이만큼 한 서너너더켜씩 놓고
그러카구선 또 소테다 안처서 시루뻐늘 다 발르지 뭐	그렇게 하고선 또 솥에다 안쳐서 시룻번을 다 바르지 뭐
시루뻔 발르구 그러커구서는 또 디려따 때 그거 익뜨락	시룻번 바르고 그렇게 하고서는 또 들입다 때 그거 익도록
때서 인제 김 올라서 놔둬따가서는 또 이건나 아니건나 인제 저깔짝 찌거보마는	때서 이제 김 올라서 놔뒀다가서는 또 익었나 안 익었나 이제 젓가락짝 찍어보면
거기가 인제 하얀 가루가 안 무더나만 이겅 거야	거기가 이제 하얀 가루가 안 묻어나면 익은 거야
그르만 그냥 이런 보재기 피구 거기다 가따 시룰 쏘다	그러면 그냥 이런 보자기 펴고 거기에 갖다 시루를 쏟아
쏟꾸 시루믿 띠구 그러커구 다 짤라서 그러만 아주 케가 짝짝 다 이러나지 뭐	쏟고 시루밑 떼고 그렇게 하고 다 잘라서 그러면 아주 켜가 짝짝 다 일어나지 뭐
그러만 다라이에다 다 케로는 다마서 노쿠 두구두구 먹끼두 허구 그러케 허지 뭐 시루떡 찌는거	그러면 대야에다 다 켜로는 담아서 놓고 두고두고 먹기도 하고 그렇게 하지 뭐 시루떡 찌는거
그러고보니까 그 팓 파꼬물 이케 켜켜로 노쿠 한 게 고게 시루떠기구요  그다메 또시루에 찌는 떠근 또 모가 이써요 그러믄	그러고보니까 그 팥 팥고물 이렇게 켜켜로 놓고 한 게 그게 시루떡이고요  그 다음에또 시루에 찌는 떡은 또 뭐가 있어요 그러면
막떡  막떠근 그냥 저 저기 서리태 콩이나 무슨 콩 두고 가루에다가  송편가튼 거 만드는 거뚜 건 송펴는 쌀가루에 해서 그냥 맨드러가지구 찌지	막떡  막떡은 그냥 저 저기 서리태 콩이나 무슨 콩 두고 가루에다가 송편 같은 거 만드는 것도 건 송편은 쌀가루에 해서 그냥 만들어가지고 찌지
그럼 찌기두 허구 삼끼두 하구 옌나렌 그러커지 뭐 그냥	그럼 찌기도 하고 삶기도 하고 옛날엔 그렇게 하지 뭐 그냥
겅거 솔립 따다가서는 겅글러코 겅글러코 송펴는	겅거 솔잎 따다가서는 섞고 섞고 송편은
그런 거 잘해 막떡 막시루떡 막시루떠근 가루를 바서 인제 서리태나 무슨 등피기콩이나 뭐 속 퍼런거나 그런 걸 너코 그냥 막 버무려	막떡 막시루떡 막시루떡은 가루를 빻아서 이제 서리태나 무슨 등피기콩이나뭐 속 퍼런 거나 그런 걸 넣고 그냥 막 버무려
그러커구선 그냥 시루에다 그냥 케를 안너코 막 퍼부어	그렇게 하고선 그냥 시루에다 그냥 케를 안 넣고 막 퍼부어
그러케서 쩌서 그냥 뚝뚝 띠어서 멍는 게 막떠기지 뭐	그렇게 해서 쪄서 그냥 뚝뚝 떼어서 먹는 게 막떡이지 뭐
그 막떠근 찹쌀로 하는 거구요	그 막떡은 찹쌀로 하는 거고요
그건 찹쌀 너두 대구 안너두 대구 그래 그건 너두 부드럽꾸 그럼	그건 찹쌀 넣어도 되고 안 넣어도 되고 그래 그건 넣어도  부드럽고 그럼
멥쌀루 허는 건 인제 콩을 너서 저기하만 거기다 무를 좀느쿠 버무려	멥쌀로 하는 건 이제 콩을 넣어서 저기하면 거기다 물을좀 넣고 버무려
메 찹싸를 안느먼 그래야 좀 찌만 부드러니까	매 찹쌀을 안 넣으면 그래야 좀 찌면 부드러우니까
인제 떡빵아까네서 바는 거뚜 인제 찹쌀 안 느쿠	이제 떡방앗간에서 빻는 것도 이제 찹쌀 안 넣고
그냥 인제 그걸 내릴 때 거기다가 무를 좀 이러케 함지에 인제 내리자나 인제 기계에서 그러만거기다 무를 느쿠 그냥 이러케 버무려	그냥 이제 그걸 내릴 때 거기다가 물을 좀 이렇게 함지에 이제 내리잖아 이제 기계에서 그러면거기다 물을 넣고 그냥 이렇게 버무려
그러케해서 또 바구 또 바구 그러자나 인제	그렇게 해서 또 빻고 또 빻고 그러잖아 인제
근데 되레 인제는 기게에다 그러커는 떠기 찹쌀 너은 거는 그냥 좀 시그마는 이내는 갠차나두시그마는 그냥 이내 구셔	근데 되레 이제는 기계에다 그렇게 하는 거는 떡이 찹쌀 넣은 거는 그냥 좀 식으면 이내는괜찮아도 식으면 그냥 이내 딱딱해
그리구 그냥 막떡찌는 거 그러케서 무를 풍겨가민 바가지구 찌는 거는 오래 먹뜨락 되레 부슬부슬헌거이 마시써 그거이 그러케 해	그리고 그냥 막 떡 찌는 거 그렇게 해서 물을 품어 가며 빻아서 찌는 거는 오래 먹어도 되려부슬부슬 한 것이 맛있어 그렇게 해
이러케 그 콩 넌는 거 말구 또 저기 뭐 쑥까튼 거 너서 이르케 또 하야케 찌는 그 시루에 찌는떡뚜 이찌 안나요 어어 쑥뻐무리 쑥뻐무리에요	이렇게 그 콩 넣는 거 말고 또 저기 뭐 쑥같은 거 넣어서 이렇게 또 하얗게 찌는 그 시루에찌는 떡도 있지 않나요 쑥버무리 쑥버무리예요
그럼 그 쑥뻐무리지 뭐 쑥 그냥 살마서 짜가지구 그냥 막 버무려 콩허구 그거허구 서꺼서 그거뚜그냥 쑥버무리두 그거뚜 막떠기야 막떡	그럼 그 쑥버무리지 뭐 쑥 그냥 삶아서 짜가지고 그냥 막 버무려 콩하고 그거하고 섞어서그것도 그냥 쑥버무리도 그것도 막떡이야 막떡
그리구 또 지그믄  그럼 송편 인제 쑥떠커는거는 쑥때비리 그런 거는 쑤커구 발때 가치 내려 가치	그리고 또 지금은  그럼 송편 인제 쑥떡하는거는 쑥대빌이 그런 거는 쑥하고 빻을 때 같이 내려 같이
가치 내려서 그러커는 거야	같이 내려서 그렇게 하는 거야
그러커고 그냥 또 이 그냥 또 인절 그냥 절편	그렇게 하고 그냥 또 이 그냥 또 인절 그냥 절편
절편두 쑥 느쿠 헐랴만 쑤커구 막 바서 또 그거는 인제 쩌가지구 시루에다 쩌가지구 기계에다절편 내리구	절편도 쑥 넣고 하려면 쑥하고 막 빻아서 또 그거는 이제또 하얀절편 헐랴만 그냥 또 저기 허는 거구또 하얀 절편 하려면 그냥 또 저기 하는 거고
이제 우리 회과네는 가마는 이제 절편 여르미 뒈서 그냥 절편 뽀바서 한 말 뽀바	이제 우리 회관에는 가면 이제 절편 여름이 돼서 그냥 절편 뽑아서 한 말 뽑아
그건 기계로 절펴는 기계로 뽀바내는 거구요	그건 기계로 절편은 기계로 뽑아내는 거고요
그럼 기계 엔나렌 여기서 지비서자끄만 주물러서 또 이러케 물발라가미 짤라서 해찌	그럼 기계 옛날엔 여기서 집에서자꾸만 주물러서 또 이렇게 물 발라가며 잘라서 했지
근데 인젠 기계로 허니께는 인젠 여기서는 지베선 그런 거 안허지 안해 그런 거	그런데 이젠 기계로 하니깐 이제 여기서는 집에선 그런 거 안 하지 안 해 그런 거
여기 지금 집 보니까 이거 새로 지으신 지비자나요	여기 지금 집 보니까 이거 새로 지으신 집이잖아요
그러며는 예저넨 여기 이 집 터에 지비 이쓰셔떤 거에요  그거 허물고 이케 새 집 신시그루지으신 거예요 그럼 예저네는	그러면 예전에는 여기 이 집 터에 집이 있으셨던 거예요  그거 허물고 이렇게 새 집신식으로 지으신 거예요 그럼 예전에는
기역짜집 여 여기 흐니 그저넨 기역짜지비야 기역짜루	기역 자 집 여 여기 흔히 그 전엔 기역 자 집이야 기역 자로
기역짜지비 이은바치믈 해지 행낭 그거이 안채 왜 안채라그리구 행낭이라 그런다 마리야	기역 자 집에 니은 받침을 하지 행랑 그게 안채 왜 안채라 그러고 행랑이라 그런단 말이야
행낭엔 기역 안채는 흐니 기역짜지베 행낭이 이은짜루다니께 그린켄 입꾸짜가 되는 거지	행랑에는 기역 안채는 흔히 기역 자 집에 행랑이 니은 자로다니까 그러니까 입 구 자가 되는거지
그러케들 지어따구	그렇게들 지었다고
그러며는 지블 어떠케 뭐 터를 닥꼬 기초 다지고 기단 싸코 뭐 이러케 막 다 이런 순서가 이짜나요이 집	그러면 집을 어떻게 뭐 터를 닦고 기초 다지고 기단 쌓고 뭐 이렇게 막 다 이런 순서가 있잖아요이 집
아니 그니께는 전 천상에 기초를 해야지	아니 그러니까는 천 천상 기초를 해야지
기소를 해야자나 기초는 터를 골르구	기초를 해야잖아 기초는 터를 고르고
그럼 이 지븐 누가 지으셔써요	그럼 이 집은 누가 지으셨어요
목쑤가 지찌	목수가 짓지
아뇨아뇨 이집 말구 이 전찝 옌날찝	아뇨아뇨 이 집 말고 이 전 집 옛날집
목쑤야 그게	목수야 그게
그 목쑤가 이케  주인이 이르케 어떠케 좀 말하면서 지어요	그 목수가 이렇게  주인이 이렇게 어떻게 좀 말하면서 지어요
아 아이 거 주이는 인제 어드런 형체로 지어 달라	아 아니 거 주인은 이제 어떤 형체로 지어달라
거 주이니 세밀 지금두 그러차나 세밀허게 아는 사라믄 내가 지블 저두 요러케 요러케 구조를무러 요러케 해달라구 허지마는 모르는 사라믄 그 지 집 짓는 사라메게어떤 형시그루 좀 지어줘허마는 그 사라미 구조를 맨들자나	그 주인이 세밀 지금도 그렇잖아 세밀하게 아는 사람은 내가 집을 지어도 이렇게 이렇게 구조를물어 해달라고 하지만 모르는 사람은 그 지 집 짓는 사람에게어떤 형식으로 지어줘 하면그 사람이 구조를 만들잖아
그 옌나리나 지그미나 마찬가지지 뭐	그 옛날이나 지금이나 마찬가지지 뭐
옌나렌 그 이건 지금 그 뭐라고 하지 난방이	옛날에는 그 이건 지금 그 뭐라고 하지 난방이
온돌방	온돌방
네 이러케 구드를  에에 그거를 어떠케 까라써요 이케 지금처럼 모든 방에 다이러케	네 이렇게 구들을  에에 그거를 어떻게 깔았어요 이렇게 지금처럼 모든 방에다 이렇게
으응 기니께는 인제 지그믄 뭐 더퍼노코 공구리 허구선 여 깔지마는 그저넨 이 아궁이서 부를때야자나	으응 그러니까 이제 지금은 뭐 덮어놓고 콘크리트 하고서는 여기 깔지만 그 전엔 이 아궁이에서불을 때야 하잖아
불을 땐껜 그 아궁게서 고리라 그런다구 골 이 골 흐글 요러케 싸서 여기 이러케 싸쿠 여기구녀글 냉겨노쿠 여기 또 싸쿠	불을 때니까 그 아궁이에서 골이라 그런다고 골 이 골 흙을 요렇게 싸서 여기 이렇게 쌓고여기 구멍을 남겨놓고 여기 또 쌓고
그래 불 때문 이 고 골루 드러올 꺼 아냐 그리군 그거슨 뭐냐먼 돌루다 이래 착착차착 깐다마랴 그걸 구둘짱이라구 해	그래 불 때면 이 고 골로 들어올 거 아냐 그리고 그것은 뭐냐면 돌로 이렇게 착착차착 깐단말이야 그걸 구들장이라고 해
그리군 그 우이다 흐글 발르구 자리 까는 거지	그리고 그 위에다 흙을 바르고 자리 까는 거지
그리구 이제 마루 깔구 뭐	그리고 이제 마루 깔고 뭐
마루는 저 송파늘 까라야 마루지	마루는 저 송판을 깔아야 마루지
그럼 그 자리 깔구 그 위에 인제	그럼 그 자리 깔고 그 위에 이제
자리 깔문 그건 다야	자리 깔면 그건 다야
그럼 그 옛날 그 구들짱 이떤 그 집에는 위에 지붕을 뭐로 지으셔써요	그럼 그 옛날 그 구들장 있던 그 집에는 위에 지붕을 뭘로 지으셨어요
지비지 집	짚이지 짚
이영 영여꺼서  그러면 영으로 여끈 지븐 무슨 지비라 그래요	이영 영 엮어서  그러면 영으로 엮은 집은 무슨 집이라 그래요
초가집	초가집
네 초가집 그럼	네 초가집 그럼
개와로 인는 와가	기와로 이는 와가
그러면 음	아 그러면 음
옌나레는 그러면 민속 시낭이 이짜나요 이러케 조왕신 뭐 터주때감 뭐 이런 거	옛날에는 그러면 민속신앙이 있잖아요 이렇게 조왕신 뭐 터줏대감 뭐 이런 거
어어 그 개이네 지베서 저 위하는 귀신	어어 그 개인의 집에서 저 위하는 귀신
네 네	네 네
음 거긴 성주 또 칠썽	음 거긴 성주 또 칠성
성주는 뭐에요	성주는 뭐예요
성주는 그 집 질 때 젤 먼저 세우는 성주 그 성주기둥이야	성주는 그 집 지을 때 제일 먼저 세우는 성주 그 성주기둥이야
그 성주기둥이 처느루다 이러 매다라노치 성주	그 성주기둥에 천으로다 이렇게 매달아놓지 성주
칠썽 칠썽은 인제 자손 웁쓰면 칠썽님께 빈다 그러자나 칠썽	칠성 칠성은 이제 자손 없으면 칠성님께 빈다 그러잖아 칠성
대감  대 대가미라는 건 뭐 뭐이 성 성가신 거지만 뭐이 이 무슨 대감 무슨대감 하는 거이	대감  대 대감이라는 건 뭐 뭐 성가신 거지만 뭐 이 무슨 대감 무슨 대감하는 게
으응	으응
거이키니 업쭈 업쭈래는 건 그 집 인제 그건 바까테 에 업쭈까리라 하지	그 업주 업주래는 건 그 집 이제 그건 바깥에업주가리라 하지
어븐 어븐 보글 가따주는 거	업은 업은 복을 갖다주는 거
그럼 조왕시는	그럼 조왕신은
조왕시는 저 조왕시는 인저 여기 저 부뚜마기 이스먼 부뚜마게 인는 바름뼉 그거이 그게 주조왕이야	조왕신은 저 조왕신은 이제 여기 저 부뚜막이 있으면 부뚜막에 있는 바람벽 그게 그게 주조왕이야
그러면 옌나렌 옌날찌베는 샘물도 이쓰셔써요 우물 우물	그러면 옛날엔 옛날집에는 샘물도 있으셨어요
움물	우물
엔날지베 움물 인는 지비 쉬운가 동네움무리지	옛날집에 우물 있는 집이 쉬운가 동네우물이지
그럼 우물  우무레 시니 이쩌	아 그럼 우물  우물에 신이 있죠
그건 움물시는 별루 생기지 아나 인제	그건 우물신은 별로 생기지 않아 이제
그럼 외양까는요 소는  거기는 신 업써요	그럼 외양간은요 소는  거기는 신 없어요
그거뚜 뭐 저 거러키니 민는 사라믄 믿꾸 안 민는 사라믄 안 미꾸	그것도 뭐 저 그렇게 믿는 사람은 믿고 안 믿는 사람은 안 믿고
그럼 이 지여게서는 주로 어떤 조상시늘 모셔써요 잘 안모셔써요  이 지역 교동에서는어 어떤 조상시늘 주로 모셔써요 잘 안모셔써요	그럼 이 지역에서는 주로 어떤 조상신을 모셨어요 잘 안모셨어요  이 지역 교동에서는어 어떤 조상신을 주로 모셨어요 잘 안모셨어요
조상시니란 내 내 조상들 제사지내는 지방지가 이찌 뭐 그걸 그거보구 시니라군 모타지	조상신이란 내 내 조상들 제사 지내는 지방지가 있찌 뭐 그걸 그거 보고 신이라고는 못하지
지성을 아주 종이에다 써서 인제 그 사당이라구 한단 마리야 종묘 사당이라 그러자나	지성을 아주 종이에다 써서 이제 그 사당이라구 한단 말이야 종묘 사당이라 그러잖아
뭐 정초에는 바늘 빌리러 가지 마라 뭐 이런 거 이써써요  금 해서는 안될 일 가튼 게이써써요 금기사항 네 음력 세시 뭐 이런 때 정초에 뭐	뭐 정초에는 바늘 빌리러 가지 마라 뭐 이런 거 있었어요  금 해서는 안될 일 같은게 있었어요 금기사항 네 음력 세시 뭐 이런 때 정초에 뭐
정초에 여기서 가레는 건 음려그루 정월딸 정월초하루 지나자나 정월초하룬날 토끼나를 가레묘일 묘이리지	정초에 여기서 가리는 건 음력으로 정월달 정월초하루 지나잖아 정월초하룻날 토끼날을 가려  묘일 묘일이지
묘일 묘이른 여자드리 나미 집 제일 먼저 안 가	묘일 묘일은 여자들이 남의 집 제일 먼저 안 가
그 나른 남자가 인제 이우찌베 인저 가서 아치밀찌금 가서 아궁에 저 불 불살라 주지	그 날은 남자가 이제 이웃집에 이제 가서 아침일찍 가서 아궁이에 저 불 불살라 주지
술라주며는 그 지비선 또 술 술 대저패주고 그거시 풍소기어서	살라주면 그 집에선 또 술 술 대접해 주고 그것이 풍속이었어
기허는 건 별루 업꼬 정월 지나고 나서 첟 묘일 첟 토끼날	기하는 건 별로 없고 정월 지나고 나서 첫 묘일 첫 토끼날
그 나를 가 지금두 지금두 가레서 가레 저 정월 처 토끼나른 여자들 아치밀찌근 나가지 마라라마리야 그런 거 이서	그 날을 가 지금도 지금도 가려서 가려 저 정월 첫 토끼날은 여자들 아침일찍은 나가지 말아라말이야 그런 거 있어
그루구 또 겨론 혼사에두 금기사항이 만차나요 뭐 이케 왜 요새두 호닌날 겨론싱날 자바놔쓰면어디 장례식장 가는 거 아니라구  옌나레두 옌날부터이써써요	그리고 또 결혼 혼사에도 금기사항이 많잖아요 뭐 이렇게 왜 요새도 혼인날 결혼식날 잡아놨으면어디 장례식장 가는 거 아니라고  옛날에도 옛날부터있었어요
어우 예선 옌나렌 더허지	어우 여기선 옛날엔 더하지
그러면 뭐 장녜는녀 이케 관 위로 뭐 고양이 지나가면 안 된다 뭐 이런 거 이써써요	그러면 뭐 장례는요 이렇게 관 위로 뭐 고양이 지나가면 안 된다 뭐 이런 거 있었어요
그건 뭐 그건 안 되지	그건 뭐 그건 안 되지
그거 말구 또 업써써요	그거 말고 또 없었어요
그거 말구 뭐 관 위루 무어이 지나가 뭐 지나가나	그거 말고 뭐 관 위로 뭐가 지나가 뭐 지나가나  응 지나갈 게 없으니까
예저네는 요새는 병원두 드러서서 괜차는데 옌나레는 병원도 업꼬 병도 더 마나짜나요  야기 별로 업써쓰니까 옌나렌	예전에는 요새는 병원도 들어서서 괜찮은데 옛날에는 병원도 없고 병도 더 많았잖아요  약이 별로 없었으니까
주 그건 그 지방마다 주부 주부라 그르지 침 노쿠 그저 그저 흐니 하는 얘기루 인제 초약가튼거 아주 뭐지 융모초를 다레 머라 쑤글 다레 머거라 뭐 그걸 주부라 그지	주 그건 그 지방마다 주부 주부라 그러지 침 놓고 그저 흔히 하는 얘기로 이제 초약같은  거 아주 모지 육모초를 달여 먹어라 쑥을 달여 먹어라 뭐 그걸 주부라 그러지
그러며는 그 주부 주부가 주로 어떤 질병을 치료해써요 어떤 질병이 주로 마나써요 뭐 이러케버짐 피고 버지메두 종류가 만차나요 이러케 마른 거 진 거	그러면 그 주부 주부가 주로 어떤 질병을 치료했어요 어떤 질병이 주로 많았어요 뭐 이렇게버짐 피고 버짐에도 종류가 많잖아요 이렇게 마른 거 진 거
진 버짐 마른 버짐 허는데 그 야근 그건 난 몰라	진 버짐 마른 버짐 하는데 그 약은 그건 난 몰라
응 그러며는 뭐 그런 거 민간요뻡 뭐 이짜나요 화상 이브면 된장 해라 뭐 그런 거 그런 건여기 뭐 이써써요 민간요뻡 지베서 지베서 응급처치루 임시방펴느루 하는 민간요뻐브로 뭐가이써쓸까요	응 그러면 뭐 그런 거 민간요법 뭐 있잖아요 화상 입으면 된장 해라 뭐 그런 거 그런 거여기 뭐 있었어요 민간요법 집에서 집에서 응급처치로 임시방편으로 하는 민간요법으로뭐가 있었을까요
글쎄	글쎄
그러면 아까 그 아까 그 취사병 하면  안 먹따가 머거서 막 설사하고 한다고 하셔짜나요그럼 그런 거 말고 음식 때무네 생긴 질병에는 뭐가 이써요	그러면 아까 그 아까 그 취사병 하면  안 먹다가 먹어서 막 설사하고 한다고 하셨잖아요그럼 그런 거 말고 음식 때문에 생긴 질병에는 뭐가 있어요
체헌 거	체한 거
체한 거 그리고 또 음식 머꼬 나서 나타나는 생리저긴 현상에는 어떤 거뜨리 이쩌 예를 들면이케 이르케	체한 거 그리고 또 음식 먹고나서 나타나는 생리적인 현상에는 어떤 것들이 있죠 예를 들면이렇게 이렇게
딸꾹찔	딸꾹질
네 뭐 그런 거	네 뭐 그런 거
트림	트림
트림 또 이르케 혀에 이르케	트림 또 이렇게 혀에 이렇게
세빠눌	혓바늘
그다메 애가 깜짝 놀라면	그 다음에 애가 깜짝 놀라면
경끼	경기
그 왜 이제 옌나레는 막 저념 질병이 진짜 심가칸 질병이 마나짜나요 이케 처년두 곰보 뭐이런 거 그런 거 마을 한 번 역뼝 쓴다 그러자나요 교동은 그런 거 업써써요	그 왜 이제 옛날에는 막 전염 질병이 진짜 심각한 많았잖아요 이렇게 천연두 곰보 뭐 이런거 그런 거 마을 한 번 역병 쓴다 그러잖아요 교동은 그런 거 없었어요
호녁 호녁 마마 그건 아주 누구든지 한 번 겨꺼야 하는 거야	홍역 홍역 마마 그건 아주 누구든지 한 번 겪어야 하는 거야
그래서 예저네는 출쌩신고도 느저서 은제 호녁 마마 헐찌 모르니께는 호녀카면 까따카면 주꼬마마오면 주그니께는 호녁 마마가 젤 무서운 거야	그래서 예전에는 출생신고도 늦었어 언제 홍역 마마 할 지 모르니까 홍역하면 까딱하면 죽고마마 오면 죽으니깐 홍역 마마가 제일 무서운 거야
하라버지도 겨끄셔써요	할아버지도 겪으셨어요
물로니지	물론이지
그거 걸림 어뜨케 돼요  전 안 걸려 봐꺼든녀	그거 걸리면 어떻게 돼요  전 안 걸려 봤거든요
그이 지그믄 주살 노차나	그게 지금은 주사를 놓잖아
걸리면 어때요 어떠케 돼요 이케 모메	걸리면 어때요 어떻게 돼요 이렇게 몸에
그건 그건 어려 어려서 다 해	그건 그건 어려 어려서 다 해
어려서쯤	어려서쯤
호녀근 마마는 이 얼구레 그냥 막 툴툴툴툴 튀어나는 거구	홍역은 마마는 이 얼굴에 그냥 막 툴툴툴툴 튀어나오는 거고
호녀근 알 그냥 알른 모냥이야	홍역은 앓 그냥 앓는 모양이야
그리구 이 지역 이 교동에는 교동에두 무당이 이써요	그리고 이 지역 이 교동에는 교동에도 무당이 있어요
아 무당 마나찌	아 무당 많았지
교동에두 무당 마나써요  서민데 무당 마나써요	교동에도 무당 많았어요  섬인데 무당 많았어요
아유 무덩 마나찌	아유 무당 많았지
그러며는 이케	그러면 이렇게
구슬 해	굿을 해
그럼 굳판두 보시구 그러세요	그러면 굿판도 보시고 그러세요
아 굳판두 봐찌	아 굿판도 봤지
그러면 뭐 이르케 무당 마느면 무당에두 종류가 만차나요 종류별루 다 이써써요 무당에두 막 박쑤무당	아 그러면 뭐 이렇게 무당 많으면 무당에도 종류가 많잖아요 종류별로 다 있었어요 무당에도 막 박수무당
아이 박쑤는 남자무당이 박쑤지 근데 교동엔 박쑤는 웁서서	아이 박수는 남자무당이 박수지 그런데 교동엔 박수는 없었어
박쑤는 웁써꼬 그냥 무당만	박수는 없었고 그냥 무당만
응 여자가 해	응 여자가 해
그럼 왜 무당찌븐 쫌 꺼리는 경양이 이짜나요 가까이 하기 꺼리지 아느셔써요 옌나레는 안옌나레는 이케 무당 별로 안조아하구 그래떤 거 가튼데	그럼 왜 무당집은 좀 꺼리는 경향이 있잖아요 가까이 하기 꺼리지 않으셨어요 옛날에는 안옛날에는 이렇게 무당 별로 안 좋아하고 그랬던 것 같은데
안조아하는데 우리 지바네 우화니 이쓰면 부르던 불러오는 걸 꺼리구 말 꺼 뭐 인나	안 좋아하는데 우리 집안에 우환이 있으면 부르든 불러오는 걸 꺼리고 말 거 뭐 있나
그럼 무당들두 겨로나구 다 그래요	그럼 무당들도 결혼하고 다 그래요
당연하지 저 겨론 안 하는 건 중 중이 겨론 안하지	당연하지 저 결혼 안하는 건 중 중이 결혼 안 하지
그러면 그런데 막 신내리믄 이케 내림 받꼬	그러면 그런데 막 신내림은 이렇게 내림 받고
그러태 난 뭐 그거 신내림꾸뚜 헌대 신내리면 굳 구슬 헌대	그렇대 난 뭐 그거 신내림굿도 한대 신내리면 굿 굿을 한대
그러며는 무당찌브로 시집까면 아니 그니까 결 장 무당 여자무당이면 장가를 가야 되는거자나요	예 그러면 무당집으로 시잡가면 아니 그러니까 결 장 무당 여자무당이면 장가를 가야 되는거잖아요
무덩끼리 장개간다고	무당끼리 장가간다고
아니 그니까 여자무당이니까 이 사라미 어느 남자한테 시지블 가야 되자나요 그러면 남자가무당이 시지본다고 하면	아니 그러니까 여자무당이니까 이 사람이 어느 남자한테 시집을 가야 되잖아요 그러니까 남자가무당이 시집온다고 하면
근데 흐니 저 시집까구 나서 무덩허지 무덩 저 시집까지 저네 무덩허는 사람 읍때	그런데 흔히 저 시집가고 나서 무당하지 무당 저 시집가기 전에 무당하는 사람 없대
그럼 시집까구 나서 무당대면 쪼껴나요	아 그럼 시집가고 나서 무당되면 쫓겨나요
아니지 왜 쬐껴나펴나난 거거든 펴나난 사라미구 저 무덩이네 실랑이야 그르지 가마니안자서 버러다 메기는데 왜 쪼차	아니지 왜 쫓겨나편안한 거거든 편안한 사람이고 저 무당이네 신랑이야 그러지 가만히앉아서 벌어다 먹이는데 왜 쫓아
아 고기 잘 머꾸 구터면 돼 돼지 머리 노쿠 허자나 돼지머리 가저오구 고기 잘 머꾸	아 고기 잘 먹고 굿하면 돼 돼지머리 놓고 하잖아 돼지머리 가져오고 고기 잘 먹고
아 그 쌀도 쌀두 가저오구 가마니 안자서 잘 멍는데 왜 쪼차내나	아 그 쌀도 쌀도 가져오고 가만히 앉아서 잘 먹는데 왜 쫓아내나
예저네는 무당이 갠차나 조 그러케 안 꺼리는 모양이에요 요새는	예전에는 무당이 괜찮아 좋 그렇게 안 꺼리는 모양이에요 요새는
근데 구뚜 종류가 되게 여러가지 이찌 아나요	그런데 굿도 종류가 되게 여러가지 있지 않아요
그게 구터는 지비서 여러 가지 종류가 이찌 뭐 무 말명꺼리 마 마누라꺼리 대감꺼리 성주꺼리그거 그지베서 인는 거지 무덩의 종류가 마는 건 아니지	그게 굿하는 집에서 여러 종류가 있지 뭐 무 말명거리 마누라거리 대감거리 성주거리 그거그 집에서 있는 거지 무당의 종류가 많은 건 아니지
그러며는 옌나레는 그러면 약초도 직쩝 캐시구 그러셔써요	그러면 옛날에는 그러면 약초도 직접 캐시고 그러셨어요
여긴 약초 별루 업서	여긴 약초 별로 없어
여긴 약초 별로 업써요 그러면 절기에 따라서 세시풍소기 여러가지가 이짜나요 하라번니미그런 거 굉장히 자라시자나요 저기 가서 강의도 하시고	여긴 약초 별로 없어요 그럼 절기에 따라서 세시풍속이 여러가지가 있잖아요 할아버님이그런 거 굉장히 잘하시잖아요 저기 가서 강의도 하시고
이케 세시 풍속 뭐 정워레 뭐 설 대보름 뭐 성묘 조왕제 뭐 이런 거 뭐 정워레 오곡빱 뭐이런 거	이렇게 세시풍속 뭐 정월에 설 대보름 성묘 조왕제 뭐 이런 거 뭐 정월에 오곡밥 뭐 이런거
응 정월 그건 보름날 허자나	음 정월 그건 보름날 하잖아
그런 거 말고 그런 세시풍소게 대해서 이르케 정워레 뭐하고 이워레는 뭐하고 삼워레는 뭐하고이런 거 가서 강의하시듣 저기 저이한테도 해주시면	그런 거 말고 그런 세시풍속에 대해서 이렇게 정월에 뭐하고 이월에는 뭐하고 삼월에는 뭐하고이런 거 강의하시듯 저기 저희한테도 해주시면
다다리는 별로 그 그런 건 웁서서	다달이는 별로고 그런 건 없었어
그럼 굴찍굴찌칸 걸로	그럼 굵직굵직한 걸로
굴찍국찍 그이 차례를 인제 예저네는 한식차례두 지내서 그러게 정워레는 인제 설리구 이워렌한시기거든 사머렌 삼진	굵직굵직 그 차례를 이제 예전에는 한식차례도 지냈어 그러게 정월에는 이제 설이고 이월에는한식이거든 삼월에는 삼진
사워렌 파일 초파일 오워렌 다노 다노에도 차례지내따고 유워렌 유두	사월엔 파일 초파일 오월엔 단오 단오에도 차례지냈다고 유월엔 유두
칠썩 파뤄른 추석 그러케도 나누는 거지 뭐	칠석 팔월은 추석 그렇게도 나누는 거지 뭐
그럼 구워레는	그럼 구월에는
구워레는 구일 구월 구월 구일 시 시워른 시월 시월 보르미 상 상워린가	구월에는 구일 구월 구월 구일 시 시월은 시월 시월 보름이 상 상월인가
상달	예 상달
상딸 그래 동지따른 동지 서따렌 구뭄	상달 그래 동짓달은 동지 섣달엔 그믐
그거이 인는 거지 뭐	그게 있는 거지 뭐
그러며는 그 사머레는 뭐한다고 하셔쩌 사머레는	그러면 삼월에는 뭐한다고 하셨죠 삼월에는
사머렌 무슨 별루 행사하는 거 업서  한시게는 저러키니 뭐야 도라선산수들 치산하지	삼월엔 무슨 별로 행사하는 거 없어  한식에는 저렇게 뭐야 돌아선산수들 치산하지
그러구 그럼 초파이레는 뭐해요	그러고 그럼 초파일에는 뭐해요
초파이레는 그거 서까모니 탄생한 나린데 뭐 허긴 뭘 허나	초파일에는 그거 석가모니 탄생한 날인데 뭐 하긴 뭘 하나
여기두 그럼 이런 거 달구 그래여 연등	여기도 그럼 이런 거 딜고 그래요 연등
어유 저렌 달지 궹장하네 지금 하개사에	아유 절엔 달지 굉장하네 지금 화개사에
그러구 그럼 다노에는	그리고 그럼 단오에는
다노엔 차례지내	단오에는 차례 지내
차례지내고 여자드른	차례 지내고 여자들은
자 장풍으로 머리강꾸 그 그너 그네매서 그너 뛰고	창포로 머리감고 그네 매서 그네 뛰고
유두는 뭐에여	유두는 뭐예요
유두는 그 다레 명절 이르므루 제 제켜 인는 거지 뭐	유두는 그 달의 명절 이름으로 적혀 있는 거지 뭐
그럼 따키 하는 건 업꼬	그럼 딱히 하는 건 없고
앙 웁써	응 없어
그럼 칠써게두 따키 하는 거 업써요	그럼 칠석에도 딱히 하는 거 없어요
칠써근 겨누징녀 만나는 나리지 뭐	칠석은 견우직녀 만나는 날이지 뭐
그럼 그날 뭐 이르케 대나무 뭐	그럼 그날 뭐 이렇게 대나무 뭐
오자꾜야 오자꾜 에 까치가마구가 올라가서 오작 오자기야 까마구 까치가 올라가 다리 놔주는게	오작교야 오작교 에 까치까마귀가 올라가서 오작교 오작이야 까마귀 까치가 올라가서 다리놔주는 게
그럼 그날 뭐 하는 건 업써요  그럼 추석때는	그럼 그날 뭐 하는 건 없어요  그럼 추석 때는
추석 때 차례지내자나 그리구 나마진 별루 웁서 동지에 파쭈기나 쑤어머꾸	추석 때 차례지내잖아 그리고 나머진 별로 없어 동지에 팥죽이나 쑤어 먹고
그러쿠나 그럼 그뭄날 잠 안 자구 뭐 이런 거 이써요	그렇구나 그럼 그믐날 잠 안 자고 뭐 이런 거 있었어요
구뭄나른 자머는 머 머리 누 눈써비 신다구 그른다나	그믐날은 자면 머리 눈썹이 신다고 그러잖아
근데 구뭄나른 눈써비 시는 게 아이라 지시니 나리 천시니 나린다는 거야 천신 하느레서 시니나린대는 거야	그런데 그믐날은 눈썹이 시는 게 아니라 지신이 내리 천신이 내린다는 거야 천신 하늘에서신이 내린다는 거야
그거이 앙궤라 그래 그 시네 이르믈 여기선 앙궤라 그른다구 앙궤이	그게 앙궤라 그래 그 신의 이름을 여기선 앙궤라 그런다고 앙궤이
앙궤가 나려오니게 그저넨 지그믄 전부 신바를 아네 버찌만 그저넨 퉤똘 바께 인제 아이들 신바를아이들 신바를 늘 전부 아네 드려놔	야광귀가 내려오니까 그 전엔 지금은 전부 신발을 안에 벗지만 그 전엔 툇돌 밖에 이제 아이들신발을 아이들 신을 전부 안에 들여놔
앙궤가 나려와서 그 신발 다 시너본다구	야광귀가 내려와서 그 신발 다 신어본다고
그러니 그 당시에 그 방지가 뭐냐먼 문깐 여페다가 체를 가따 거러놔	그러니 그 당시에 그 방지가 뭐냐면 문간 옆에다가 체를 갖다 걸어놔
그 앙궤가 드러오다가 그 체꾸녀글 보고선 고거시 구녁 자꾸 시다가 나리 방는다는 거지	그 야광귀가 들어오다가 그 체구멍을 보고선 그게 구멍 자꾸 세다가 날이 밝는다는 거지
그런 풍서리 이서	그런 풍설이 있어
그러며는 요새는 뭐 애들 께임만 하구 그러자나요 그런데 옌나레는 게임 말구 전통 노리가이써짜나요	그러면 요새는 뭐 애들 게임만 하고 그러잖아요 그런데 옛날에는 게임 말고 전통 놀이가 있었잖아요
윤노리바께 더 인나	윷놀이밖에 더 있나
윤노리 말고 자치기 이런 거	윷놀이 말고 자치기 이런 거
자치기 지기차기	자치기 제기차기
제기차기	제기차기
제기	제기
그럼 그거뚜 뭐 정워레는 널 뛰고 연날리고  그럼 대보르메는 뭐하고 노라써요	그럼 그것도 뭐 정월에는 널 뛰고 연 날리고  그럼 대보름에는 뭐하고 놀았어요
대보름 달마지바께 더 인나	대보름 달맞이밖에 더 있나
줄다리긴 안해써요	줄다리기는 안했어요
여기는 여기서는 줄다리기 말구 하구 뭐 그 옌나렌 뭐 그런 거 허나 안 하지 먹구 살기두 바쁜데언제 줄다리구 해	여기는 여기서는 줄다리기 말고 하고 뭐 그 옛날엔 뭐 그런 거 하나 안하지 먹고 살기도 바쁜데언제 줄다리고 해
그럼 지신발끼는 뭐에요	그런 지신밟기는 뭐예요
지신발끼는 여긴 안해서	지신밟기는 여긴 안했어
그럼 쥐불로리두요	그럼 쥐불놀이도요
쥐쥐불로린 늘 해찌	쥐쥐불놀인 늘 했지
쥐불로린 인제 거러키니 정월 때 나와서 논뚜러메 쥐부리 뭐냐면 논뚜러메 풀 인는 거 그 푸푸리 풀 소게서 각쫑 해충드리 거기서 서시커니깐 살구 이니깐 그걸 불론는데 그 쥐불로리가 그거에일쫑이야 드렁에 불론는 거이	쥐불놀이는 이제 그렇게 정월 때 나와서 논두렁에 쥐불이 뭐냐면 논두렁에 풀 있는 거 그푸 풀이 풀 속에서 각종 해충들이 거기서 서식하니까 살고 있으니까 그걸 불 놓는데 쥐불놀이가그거의 일종이야 두렁에 불 놓는 거야
뭐 이르케 이르케 하는 거 아니에요	뭐 이렇게 이렇게 하는 거 아니에요
그게 쥐불로리야 이러케 허는데 그러커다 인제 드러메 불로쿠 허는 거지	그게 쥐불놀이야 이렇게 하는데 그렇게 하다가 이제 두렁에 불 놓고 하는 거지
그러면 호미씨시가 뭐에요 백쭝나레 하는 호미씨시 호미씨끼	아 그러면 호미씻이가 뭐예요 백중날에 하는 호미씻이 호미씻기
글쎄다 그건 첨 든는데 호미 씨는 건 치럴 칠써기면 기믄 다 매시니게 호미 씨 김매는 걸 호미라그러자나 거 호미 씬는 거지 뭐	글쎄다 그건 처음 듣는데 호미 씻는 건 칠월 칠석이면 김은 다 맸으니까 호미 씻 김 매는걸 호미라 그러잖아 그거 호미 씻는 거지 뭐
호드기 부는 게 뭐에요	호드기 부는 게 뭐예요
호적	호적
호드기	호드기
호데기 호데기는 나무가 보메 이 나무에 무리 올르자나 근데 고기 저 저러키니 깨나리나무가튼거 고 꺼꺼서 비틀면 여기 비트른 무리 올라 비트러진다고	호드기 호드기는 나무가 봄에 이 나무에 물이 오르잖아 그런데 거기 저렇게 개나리나무 같은거 그거 꺾어서 비틀면 여기 비튼 물이 올라 비틀어진다고
고거 인제 빼가지구 나무껜 빼구서는 고 껍찌를 요이 다드머가지구 이베 대구 불면 호 하고이 소리가 난다고 고게 호데기야	그거 이제 빼가지고 나무니까 빼고선 그 껍질을 이렇게 다듬어가지고 입에 대고 불면 호 하고이 소리가 난다고 그게 호드기야
그러면 뭐 누가 더 소리 오래 내나 뭐 이런 거 시하파구 그러는 거에요	그러면 뭐 누가 더 소리 오래 내나 그런 거 시합하고 그러는 거예요
그런 거 시합허는 건 모뽜서	그런 거 시합하는 건 못 봤어
그냥 소리만 내구 노는 거구나 그러면	그냥 소리만 내고 노는 거구나 그러면
자치기는 어떠케	자치기는 어떻게
자치기 자치기는 요만한 막때기 요걸 새끼자라 그러지 또 이마난 긴 거 이서	자치기 자치기는 요만한 막대기 요걸 새끼자라 그러지 또 이만한 긴 거 있어
그래가지구 자치 이 땅에다 구데이 파노콘 이 꿰드러	그래가지고 자치 이땅에다 구여기이 파놓곤 꿰어 들어
꿰들먼 절리 나갈 꺼 아냐 그니 여기 에미자를 여기다 그걸 들면 저기 상대방에서 거기서 되쏴	꿰어 들면 저리로 나갈 거 아냐 그러니 여기 어미자를 여기다 그걸 들면 저기 상대방에서서거기서 되쏴
쏘면 마치는 거야 마치는 게 고 일딴게 이단게가 이서 이건 마치머는 그냥 주꾸	쏘면 맞히는 거야 맞히는 게 그 일단계 이단계가 있어 이건 맞히면 그냥 죽고
안 마즈먼 그땐 또 두번째로 이러이 들군 치거든 치머는 저 멀리 나가자나 거기서 인제 요기이 구녀글 향해서 되쏴	안 맞으면 그땐 또 두번째로 이렇게 들고 치거든 치면 저 멀리 나가잖아 거기서 이제 여기이 구멍을 향해서 되쏴
쏘머는 쏘머는 여기와서 바루 이 한자두 모뙤게 허먼 이건 중는 거구 여기서 멀찌미 하머는여기서 자를 여기 세 가 며짜다 마랴	쏘면 쏘면 여기와서 바로 이 한자도 못되게 하면 이건 죽는 거고 여기서 멀찍이서 하면 여기서자를 여기 세 가 몇 자다 말이야
그 메짜내기에 메짜내기 끈낸단 마랴 그 시자컬때 그 한단 마랴 여긴 이제 백짜 백짜내기헌다하면 세서 한버네 열짜다 마랴 거 하구	그 몇자내기에 몇자내기 끝낸단 말이야 그 시작할 때 그 한단 말이야 여긴 이제 백자 백자내기한다 하면 세서 한번에 열 자다 말야 그거 하고
또 세번째는 뀌어드러가주구 이거 새끼자가 올라간 다메 여서 올라간 데 이거 올라간 데 이걸치머는 그건 멀리 나가자나	또 세 번째는 꿰어 들어 가지고 이거 새끼자가 올라간 다음에 여기서 올라간 데 이거 올라간데 이걸 치면 그건 멀리 나가잖아
멀리 나가먼 그걸 또 재는 거지 근데 이거 뀌어드러가주 치지 모타먼 중는 거구	멀리 나가면 그걸 또 재는 거지 그런데 이거 꿰어들어가지고 치지 못하면 죽는 거고
그게 그거이 상대방이 두 패가 뒈가지구 서루 번가라가면서 허다가 먼저 이 큰 자루다 백짜 재는그 티미 이기는 거지	그게 그게 상대방이 두 패가 되어서 서로 번갈아가면서 하다가 먼저 이 큰 자로 백 자 재는그 팀이 이기는 거지
금 지금 막 눈 엄청 마니 내려짜나요 눈 싸여 이짜나요 아직뚜 그러면 막 예저넨 눈싸움 하구그러셔껜네요 여기서	그럼 지금 막 눈 엄청 많이 내렸잖아요 눈 쌓여있잖아요 아직도 그러면 막 예전엔 눈싸움하고 그러셨겠네요 여기서
그러치 아이드른 눈싸움두 하구 해지	그렇지 아이들은 눈싸움도 하고 하지
그럼 옌나레두 이러케 눈싸람두 만들구	그럼 옛날에도 이렇게 눈사람도 만들고
그 아이들 지금두 허구 명절 때 오랜 명절 오면 늘 거 아이들 오먼 눈싸람 맨들가찌	그 아이들 지금도 하고 명절 때 올핸 명절 오면 늘 거 아이들 오면 눈사람 만들겠지
그러면 땅재머끼 이런 건 업써써요	그러면 땅재먹기 이런 건 없었어요
땅재머끼 별걸 다 문네	땅재먹기 별 걸 다 묻네
땅재머끼래는 건 이러케 땅을 요러케 땡그라케 그려 땅을 땡그라게 그리구 여긴 내 집 요러케하나 그려노쿠 여기 여기 지블 둘 상대가 이니겐 그래가주 요거 깜파리 요마난 걸 가지구 톡쳐	땅재먹기라는 건 이렇게 땅을 요렇게 동그랗게 그려 땅을 동그랗게 그리고 여긴 내 집 요렇게하나 그려놓고 여기 여기 집을 둘 상대가 있으니까 그래가지고 이거 사금파리 이만한 걸 가지고톡 쳐
톡 쳐가지구 고거이 간 거기서 요 그거뚜 규치기 이서 뭐 어뜨케 허는 줄 아니 요 요러케 해서뼈 뼈므루다 이러케 재지 뼈믈 재서 이러케 한다 마랴	톡 쳐가지고 그게 간 거기서 이 그것도 규칙이 있어 뭐 어떻게 하는 줄 아니 이 이렇게해서 뼘으로다 이렇게 재지 뼘을 재서 이렇게 한단 말야
그니껜 여기 이 지비 먼저 드러가는 거이 이 여이 내 지베선 이 사람네 지비 먼저 깜파리가 드러가야이기는 거야	그러니까 여기 이 집이 먼저 들어가는 게 이 여기 내 집에선 이 사람네 집이 먼저 사금파리가들어가야 이기는 거야
근껜 요기서 땅 이러케 재머는 여그서 첨에 치던 거이 나중에 여기 가따 치니까 가까워지자나	그러니까 여기서 땅 이렇게 재면 여기서 처음에 치던 게 나중에 여기 갖다 치니까 가까워지잖아
그거 그거슬 땅빼끼 땅재머끼라구 하는 거야	그거 그것을 땅뺏기 땅재먹기라고 하는 거야
거 말고 완전 어려쓸 때에는 그러면 이러케 애기 달랠 때 어뜨케 하세요 이르케 이르케 이르케이거 뭐라구	그거 말고 완전 어렸을 때는 그러면 이렇게 애기 달랠 대 어떻게 하세요 이렇게 이렇게 이렇게이거 뭐라고
까꿍까꿍	까꿍까꿍
뭐 이르케 뭐라고 하지 이르케	뭐 이렇게 뭐라고 하지 이렇게
도리도리 죄암죄암 짜짜꿍 곤지곤지  곤지곤지	도리도리 죄암죄암 짝짜꿍 곤지곤지  곤지곤지
이건 곤지곤지 이건 죄앰죔 짜짜꿍 이거	이건 곤지곤지 이건 죄암죄암 짝짜꿍 이거
그러면 개가 인제 그러케 완전 어려쓸 땐 그러고 놀다가 쫌 크면 아까 말씀하신 거처럼 자치기도하고  그러고 이제 쥐불로리도 하고 그러는데 제기도 차자나요  제기 제기 차는거에두 제기에두 뭐 이케 뭐 종류가 이쩌 차는 거에두 이르케 차구 뭐 이르케 차구	그러면 걔가 이제 그렇게 완전 어렸을 땐 그러고 놀다가 좀 크면 아까 말씀하신 것처럼 자치기도하고  이제 쥐불놀이도 하고 그러는데 제기도 차잖아요  제기 제기 차는 거에도제기에도 뭐 이렇게 뭐 종류가 있죠 차는 거에도 이렇게 차고 뭐 이렇게 차고
어어 처 츠메는 인제 땅에서 이 발루다 여이 제기가 이러이 이스면 이러케 이러케 이러케 차거든	어어 처 처음에는 이제 땅에서 이 발로다 여기 제기가 이렇게 있으면 이렇게 이렇게 이렇게차거든
고다 이 이단계는 들구 들구 차기야 이거이	그 다음에 이 단계는 들고 들고 차기야 이게
그리구 세번째는 들구 차따 땅에 대따 들구 차따 땅에 대따 그이 삼단계가 인는 거지	그리고 세 번째는 들고 찼다 땅에 댔다 들고 찼다 땅에 댔다 그 삼 단계가 있는 거지
그러쿠나 그러구 이제 그 사람드리 쫌더 크면 이제 뭐하고 노냐면 장기도 두고  바둑도두고 그러고 놀자나요 근데 투전 여기서 투탄	아 그렇구나 그리고 이제 그 사람들이 좀 더 크면 이제 뭐하고 노냐면 장기도 두고 바둑도 두고 그러고 놀잖아요 그런데 투전 여기서 투탄
투 투탄 몰라  아이 저 거러키니 뭐야 이 경기허는 데두 올림픽대회허는데두 그거 인는데 투타이 이 던지는 거	투 투탄 몰라  아이 저 그렇게 뭐야 이 경기하는 데도 올림픽대회하는데도 그거 있는데 투탄이 이 던지는 거
그러구 노르셔써요	그러고 노셨어요
응 그 그건 뭐 보통 허는 게 아니구 인제 이제 이 교동에서두 인제 무슨 운동경기 이스먼 투탄경기가 이찌	응 그건 뭐 보통 하는 게 아니고 이제 이 교동에서도 이제 무슨 운동경기 있으면 투탄경기가있지
투타니 이 땡구란 땡그란 인제 쇠 거튼 거 이걸 가지구 그거뚜 쏘는 지그믄 그냥 그거 아주삥삥삥삥 돌다 퓍 패대기를 처버리지만 그저네 여기서 할땐 그 쇠떵어리를 귀에다 귀에다 대따가던질 그니 팔 순 팔심이지 파리 히미 나가는 거지 그 그거이 투타니야	투탄이 이 땡그란 땡그란 쇠 같은 거 이걸 가지고 그것도 쏘는 지금은 그냥 그거 아주 삥삥삥삥돌다 퓍 패대기를 쳐버리지만 그전에 여기서 할 땐 그 쇳덩어리를 귀에다 귀에다 댔다가 던질그러니 팔 순 팔힘이지 팔의 힘이 나가는 거지 그 그게 투탄이야
여기에두 그 뭐지 여팔러 오구 그래써요 그 각써리드리	여기에도 그 뭐지 엿 팔러 오고 그랬어요 그 각설이들이
엳 엳 엳 팔러	엿 엿 엿 팔러
여짱수	엿장수
네 여짱수	네 엿장수
에 여기도 여짱수가 이뜨래서	에 여기도 엿장수가 있더랬어
저이는 여짱수 본 저기 한번두 업꺼든녀	저희는 엿장수 본 적이 한 번도 없거든요
여짱수는 여 뭐야 여슬 이 여슬 고아가지구 자꾸 느르먼 여시 인제 하야케 되먼서 요 손까락모냥으루 하야케 뽐는단 마랴 그거 딱딱딱딱 짤라가지구	엿장수는 여 뭐야 엿을 이 엿을 고아가지고 자꾸 늘이면 이제 엿이 하얗게 되면서 이 손가락  모양으로 하얗게 뽑는단 말야 그거 딱딱딱딱 잘라가지고
그게 연모파니 이러케 모파니 이찌	그게 엿모판이 이렇게 모판이 있지
모파는 인제 이아까에 끌구 대니는 사람두 이꾸 모게 걸구 다니기두 하구 가위가 이서 여짱사가위	모판은 이제 리어카에 끌고 다니는 사람도 있고 목에 걸고 다니기도 하고 가위가 있어 엿장사가위
가위 딱따따딱 치머는 아이드리 여싸무라 나가는 거지	가위 딱따따딱 치면 아이들이 엿 사먹으러 나가는 거지
여치기가 뭐에요	엿치기가 뭐예요
여치기는 여짱사 인제 불러노쿠 상대 상대방이 이 묀다 마랴	엿치기는 엿장사 이제 불러놓고 상대 상대방이 이 모인단 말야
여치기는 여까라기 이러케 이짜나 그러먼 저짜가끔 하나씩 골래 가저	엿치기는 엿가락이 이렇게 있잖아 그러면 제가끔 하나씩 골라 가져
골래가지고 딱 꺼꺼 딱 꺼끄먼 여세 엳 그 가락엔 여긴 구머기 이서	골라가지고 딱 꺾어 딱 꺾으면 엿에 엿 그 가락엔 여긴 구멍이 있어
으응	으응
구머기 질 큰 사라미 이기는 거지 그 여치기야	구멍이 제일 큰 사람이 이기는 거지 그게 엿치기야
그럼 남자드른 그러고 노란는데 여자드른 그럼 모하고 노라써요 고무줄로리 하고 노란나요	그럼 남자들은 그러고 놀았는데 여자들은 그럼 뭐하고 놀았어요 고무줄놀이 하고 놀았나요
고무 옌날 여자드른 고무줄도 몰르지  느리나 하고 공기나 하고	고무 옛날 여자들은 고무줄도 모르지  널이나 하고 공기나 하고
느리 뭐에여	널이 뭐예요
늘띠기	널뛰기
아아 그러면 저기는 뭐 사방치기가 뭐	아아 그러면 저기는 뭐 사방치기가 뭐
사방치기 사방치긴 또 이러케 요러케 인제 땅에다 그리믈 그려 요러케 해서 간을 마가	사방치기 사방치기는 또 이렇게 요렇게 이제 땅에다 그림을 그려 요렇게 해서 칸을 막아
간을 마가서 요만 납짜칸 동메가 이서 요이 요기 지비 이꼬	칸을 막아서 요만 납작한 돌멩이가 있어 여기 여기 집이 있고
그니 요그서 이걸 던저노콘 깨끔발 한발 깨끔발 톡 처서 요 그리 가고 또 톡 처서 욜리 가고요기서 서늘 이루고 가다가 이 그메 걸리면 중는 거야	그러니 여기서 이걸 던져놓곤 깨끔발 한발 깨끔발 톡 쳐서 요 그리 가고 또 톡 쳐서 이리로가고 여기서 선을 이루고 가다가 이 금에 걸리면 죽는 거야
으응 그러면 안 걸리고 끄까지 가는 사라미 이기는 거네요	으응 그러면 안 걸리고 끝까지 가는 사람이 이기는 거네요
그 근데 그거뚜 아냐 게 이러케 도라서 한바쿠 도라와따 마랴  기먼 처으메는 요 처까네다던저찌먼 고다멘 이 둘째까네다 던저	그 그런데 그것도 아냐 그게 이렇게 돌아서 한바퀴 돌아왔딴 말이야  그러면 처음에는이 첫칸에다 던졌지만 그 다음엔 이 둘째칸에다 던져
게 둘째까네 던지고 고 다멘 세째까네 던지고 이거시 완저니 한바꾸 도라야 이기는 거야	그게 둘째칸에 던지고 그 다음엔 셋째칸에 던지고 이것이 완전히 한 바퀴 돌아야 이기는 거야
한 번 도라따고 이기는 게 아냐	한 번 돌았다고 이기는 게 아냐
그러쿠나 그럼 그르구나서 이제 좀더 크면 이제 노인분드른 윤노리하고 뭐 화투하고 그조 근데 마작뚜 하셔써요	아 그렇구나 그럼 그러고 나서 이제 좀더 크면 이제 노인분들은 윷놀이하고 뭐 화투하고 그렇죠 그런데 마작도 하셨어요
마적뚜 그기 여기는 에 중가네 마저기 생겨서	마적도 그게 여기는 에 중간에 마적이 생겼어
마저근 저 한번두 본 저기 업써요  그거는 뭐 우리나라 꺼에요	마적은 저 한 번도 본 적이 없어요  그거는 뭐 우리나라 거예요
마 마저기야 그거 중구꺼야  마 마저기야 도두 말 마짜에 도둑 적짜야	마 마적이야 그거 중국 거야  마 마적이야 도두 말 마 자에 도둑 적 자야
그 마적떼라 그르자나  그 그이 그 마리야 그이	그 마적떼라 그러잖아  그 그게 그 말이야 그게
마 마저기라구 이서가지구 인제 퉁수가 이꾸 만쑤가 이서	마 마적이라고 있어가지고 이제 퉁수가 잇고 만수가 있어
퉁수는 머냐면 점 저 똥그란 점 꼬꼬꼬꼭 찌근 거	퉁수는 뭐냐면 점 저 동그란 점 꼬꼬꼬꼭 찍은 거
찌근 거고 만수는 일리삼사루 이 글씨 쓴 거고	찍은 거고 만수는 일이삼사로 이 글씨 쓴 거고
게 만수가 이꾸 퉁수가 인는데 고거시 며시냐며는 하나서 아홉까지 수짜루 이꾸 또 퉁수루아홉까지 그이 하나 일짜가 네시야 일통이 네시구	그게 만수가 있고 퉁수가 있는데 그게 몇이냐면 하나에서 아홉까지 숫자로 있고 또 퉁수로아홉 가지 그게 하나 일 자가 넷이야 일통이 넷이고
네썩 네썩 한 거시 아홉꺼지 두리야 그럼 며시지	넷씩 넷씩 한 것이 아홉까지 둘이야 그럼 몇이지
삼심뉵  사 삼심뉵	삼십육  사 삼십육
네 네 이 하 한짜기 네신데 요거이 아홉꺼지 이서  사구 삼심뉴기지 삼심뉴기 두리야	네 네 이 하 한 짝이 넷인데 이게 아홉까지 있어  사구 삼십육이지 삼십육이둘이야
칠씨비	칠십이
칠씨비지 칠씨비인데 거기다 백 그 하얀 판 또 발 바리라구 필 발짜 필 발짜 그거시 넫	칠십이지 칠십이인데 거기다 백 그 하얀 판 또 발 발이라고 필 발 자 필 발 자 그것이넷
또 중 가운데 중짜 중헌 거시 네시구 그이 네썩 인는 거이 또 세시 이서	또 중 가운데 중 자 중한 것이 넷이고 그게 넷씩 있는 게 또 셋이 있어
삼 삼사시비지 금 며시야 고거이 통 수짜야 마저게 칠씨비에	심 삼사십이지 그럼 몇이야 그게 통 숫자야 마적에 칠십이에
그럼 그거는 뭐 어뜨케 마춰서 이기는 거예요	그럼 그거는 뭐 어떻게 맞춰서 이기는 거예요
음 그거 그거는 네 사라미 하는 거야 넫  네 사라미 안자서 인제 허는 거지 서로 짝 이러케 노초그러치 응	음 그거 그거는 네 사람이 하는 거야 넷  네 사람이 앉아서 이제 하는 거지
서로 짝 이렇게 놓죠그렇지 응이거 한 사라미 며씩 가진나며는 인제 네씩 네씩 세벌 세버를 띤게 삼세피리 열두리지	
이거 한 사라미 며씩 가진나며는 인제 네씩 네씩 세벌 세버를 띤게 삼세피리 열두리지	이거 한 사람이 몇씩 가지냐면 이제 넷씩 넷씩 세 벌 세 벌을 띤 게 삼세필이 열둘이지
열두 열두짝 가주구 허는 거야 이거이 열두짝	열두 열두짝 가지고 하는 거야 이게 열두짝
기리구 이건 내군 요기서 다시 싸논 데서 하나 떠오구	그리고 이건 내고 여기서 다시 쌓아 놓은 데서 하나 떠 오고
그러며는 손자랑 손녀랑 이제 설 때랑 추석 때랑 여기 오 오자나요  그럼 지금 손자손녀분들어 며쌀쭘 되셔써요	그러면 손자랑 손녀랑 이제 설 때랑 추석 때랑 여기 오 오잖아요  그럼 지금 손자손녀분들어 몇살쯤 되셨어요
어 아이들 나이가 에 큰손주가 정 무기경신 스물따섣	어 아이들 나이가 에 큰손주가 정 무기경신 스물다섯
으응 그러며는 아주 어려쓸 때 막 깐난쟁이 때 여서쌀 뭐 다서쌀 일곱쌀 이럴 때 그럴 때손주드리 오면  옌날 얘기 해주고 그러셔써요	으응 그러면 아주 어렸을 때 막 간난쟁이 때 여섯살 뭐 다섯살 일곱살 이럴 때 그럴 때 손주들이오면  옛날 얘기 해주고 그러셨어요
옌날래기 해달래면 해줘야지	옛날얘기 해달라면 해줘야지
뭐애주셔써요	뭐해주셨어요
자네들 옌날래기 드꼬 시픈가	자네들 옛날얘기 듣고싶은가
그먼 효자 얘기 내 하나 해주 해주지	그러면 효자 얘기 내 하나 해 주 해 주지
예저네 홀루 인는 늘근 어머니를 모시고 사는 사라미 이서	예전에 홀로 있는 늙은 어머니를 모시고 사는 사람이 있어
근데 이 어머니가 기픈 병이 드러서	그런데 이 어머니가 깊은 병이 들었어
배갸기 무효야 뭐 무슨 야글 야글 지어두 안 나꾸 뭐 해두 안 나꾸 뭐 심지어는 구슬 해두안 나꾸	백약이 무효야 뭐 무슨 약을  약을 지어도 안 낫고 뭐 해도 안 낫고 뭐 심지어는 굿을 해도안 낫고
그니께는 아들 메누리가 아주 고시메 빠진 거지 근심걱쩡에	그러니까 아들 며느리가 아주 고심에 빠진 거지 근심걱정에
핸는데 하루는 중이 와서	했는데 하루는 중이 왔어
중 중이 와서 인제 그 시주허세요 시주 좀 허세요 대문까네 인는데 이 메누리가 사 사바레다싸를 좀 떠가주 가선 중 배랑에다 부어주니껜	중 중이 와서 이제 그 시주하세요 시주 좀 하세요 대문간에 있는데 이 며느리가 사발에다쌀을 좀 떠가지고 가선 중 배랑에다 부어주니까
이 중이 이러이 바라보더니지끔 지바네 우와니 이깐는데 그러구 그리군 도라 도라서거든	이 중이 이렇게 바라보더니지금 집에 우환이 있겠는데 그러고 그러곤 돌아서거든
그니 이 메누리가심상칠 안커든 어뜨케 우와니 인는 줄 아냐마랴	그러니 이 며느리가심상칠 않거든 어떻게 우환이 있는 줄 아냔 말이야
그껜 쪼차가선 대산님 허구 부뜬 거지	그러니까 쫓아가선 대사님 하고 붙든 거지
대산님 지금 뭐라고 말씀 허셔씀니까 지비 우와니 이깐는데 네 우완 이시다 마리야	대사님 지금 뭐라고 말씀하셨습니까 집에 우환이 있겠는데 네 우환 있습니다 말이야
시어머니가 병 병이 난는데 배갸기 무욤니다 마랴 어뜨커먼 조씀니까	시어머니가 병 병이 났는데 백약이 무효입니다 말이야 어떡하면 좋습니까
한참 이뜨니야근 이낀 인는데 그리군 그리군 또 가는 거야	한참 있더니약은 있긴 있는데 그러곤 그러고는 또 가는 거야
아 야근 이때거든 그래 그땐 중을 아주 끼여안다시피 부뜰고 뭠니까 그 야기 뭐냐	아 약은 있대거든 그래 그땐 중을 아주 껴안다시피 붙들고 뭡니까 그 약이 뭐냐
에 안되는데 안되구 되는 게 어딘냐마랴 마래주시오 마랴	에 안 되는데 안 되고 되는 게 어딨냔 말야 말해주시오 말야
그냥 대롱대롱 부짜구 매달기니 중이 헐 수 업시 에유 헐 수 읍꾸만	그냥 대롱대롱 붙잡고 매달리니 중이 할 수 없이 에유 할 수 없구만
근데 이거 참 힘드는데 힘드러두 조타 마랴 내 목쑤미 끄너저두 조타 마랴	그런데 이거 참 힘드는데 힘들어도 좋단 말야 내 목숨이 끊어져도 좋단 말야
그러태먼 가르켜줌세만 지비 세살 머근 아드리 이깐는데	그렇다면 가르쳐줌세만 집에 세 살 먹은 아들이 있겠는데
중이 보지도 아나 저 아드린는 줄두 모르는데 이깐는데 네 이씀니다 마랴	중이 보지도 않아 저 아들 있는 줄도 모르는데 있겠는데 네 있습니다 말이야
그 애를 살마서 시어머닐 주머는 시어머니가 그 애 살믄 물 무를 머그면 난는다 마랴	그 애를 삶아서 시어머닐 주면 시어머니가 그 애를 삶은 물을 먹으면 낫는단 말야
자네거틈 헐 수 이서  모터지  네	자네같으면 할 수 있어  못하지  네
모터지 그니껜 그 뭐 주거야지 아나먼 중는데 이미	못하지 그러니까 그 뭐 죽어야지 안 하면 죽는데 이미
거 어떠캐 자 시살머근 거 누네 너도 아나픈 재롱동이를 어뜨케 끌른 소테다 삼냔 마리야 응	그거 어떡해 자 세 살 먹은 거 눈에 넣어도 안 아픈 재롱둥이를 어떻게 끓는 솥에다 삶냔말이야 응
게 실랑이 드러온 다으메 그 얘길 헌 거야	게 신랑이 들어온 다음에 그 얘길 한 거야
오늘 대산니미 완는데 이런 얘기를 하고 간는데 이걸 어뜨케야 되냐	오늘 대사님이 왔는데 이런 얘기를 하고 갔는데 이걸 어떻게 해야 되나
걔를 살마서 어머니를 드려야 되냐 어머니 도라가시라고 내부려 둬야 하냐	걔를 삶아서 어머니를 드려야 되나 어머니 돌아가시라고 내버려 둬야 하나
고 어떠케 이거뚜 모터고 저거뚜 모터자나	그거 어떡해 이것도 못하고 저것도 못하잖아
그냥 이스먼 즈이 어머니 주글 꺼구 게 메치를 두리 자믈 모짠거야	그냥 있으면 제 어머니가 죽을 거고 그게 며칠을 둘이 잠을 못 잔 거야
어머니를 도라가시라구 둬야 되냐 아드를 주겨야 되냐	어머니를 돌아가시라고 둬야 되나 아들을 죽여야 되나
그 하면서 메치를 밤나슬 자믈 모짜고 그냥 근심걱쩡허구 허다 나중에 결론이 어트게 난냐면쟤 살마 주자	그 하면서 며칠을 밤낮을 잠을 못자고 그냥 근심걱정하고 하다 나중에 결론이 어떻게 났냐면쟤 삶아 주자
부모는 한번 도라가시먼 고마니구 자시근 또 나먼 자식 아니냐	부모는 한 번 돌아가시면 그만이고 자식은 또 낳으면 자식 아니냐
그래서 쟤를 살마서 어머니를 드리자	그래서 쟤를 삶아서 어머니를 드리자
자 결쩡은 그러케 해 놘는데 그게 되냐 마랴 응	자 결정은 그렇게 해 놨는데 그게 되냔 말야 응
게 결쩡을 해노쿠두 메치를 미정미저카구 그냥 응 그 더군다나 자믈 자믄 더 모짜구 바븐 더몬먹찌	그렇게 결정을 해 놓고도 며칠을 미적미적하고 그냥 응 그 더군다나 잠을 잠은 더 못 자고밥은 더 못 먹지
그래서 뭐 할 쑤 업따 이미 결쩡나구 헌 거니껜 헐 수바께 업따는	그래서 뭐 할 수 없다 이미 결정나고 한 거니까 할 수밖에 없다는
가마소테다 무를 퍼부꾸선 아궁이에다 부를 때는 거야 무를 끄리는 거지	가마솥에다 물을 퍼붓고선 아궁이에다 불을 때는 거야 물을 끓이는 거지
거 정신 이시 불 땔 꺼야 게 불 땐겐 아유 무리 아주 벼남엄씨 끄를 껀 사시리지 펄펄 이리케소꾸치먼서 끌치	거 정신 있어 불 땔 거야 그게 불을 때니까 아유 물이 아주 변함없이 끌을 건 사실이지 이렇게  솟구치면서 끓지
아 그 무리 그러이 디려 끌른데거 세살 머근 아이가 부억 문터글 너머서 엄마 허구 드러오거든	아 그 물이 그렇게 들여 끓는데거 세 살 먹은 아이가 부엌 문턱을 넘어서 엄마 하고 들어오거든
그걸 그냥 그 아이 드러오는 걸 치마루다 이러이 싸선 가따 소테다 지버너쿠선 소댕 뚜껑 다꾸선그 여자는 혼미해서 쓰러지구 만 거지	그걸 그냥 그 아이 들어오는 걸 치마로 이렇게 싸선 갖다 솥에다 집어넣구선 솥뚜껑 닫고선그 여자는 혼미해서 쓰러지고 만 거지
게 언마 이따 이제 혼미해따 인제 정시니 드러 깨 깬는데	게 얼마 있따 이제 혼미했다 이제 정신이 들어 깨 깼는데
깨니 뭐 소단 저이 아드른 소다네 드러가 이스니 벌써 물크러저슬 꺼구	깨니 뭐 솥 안 제 아들은 솥 안에 들어가 있으니 벌써 뭉크러졌을 거고
그이 정시넙씨 그냥 안저 인는데그랜는데 뭐이 또 엄마 허곤 부어그루 드러와	정신없이 그냥 앉아 있는데그랬는데 뭐가 또 엄마 하곤 부엌으로 들어와
아 보니께는 지 아드리야 또 이거이 어떠게 된 거야	아 보니깐 제 아들이야 또 이게 어떻게 된 거야
아 아드른 소테 드러가서 지금 살마져 인는데 또아드리 드러오니	아 아들은 솥에 들어가서 지금 삶아져 있는데 또아들이 들어오니
아이 좌우간 어트게 되뜬지 껴안꾼 얼싸안꾸 울구불구 헌 거지	아이 좌우간 어떻게 됐던지 껴안곤 얼싸안고 울고불고 한 거지
그리먼 이 소데 드러간 건 뭐냐 마랴	그러면 이 솥에 들어간 건 뭐냔 말이야
게 소슬 열고 보이껜 그건 저이 아이가 아니라 큰 동자삼이란 마랴 인삼	게 솥을 열고 보니까 그건 저희 아이가 아니라 큰 동자삼이란 말이야 인삼
게 그 인사믈 가따 시어머니 주니껜그거 잡쑤꾼 뻘떡 이러나는 거지 뭐야	그게 그 인삼을 갖다 시어머니 주니까그거 잡숫곤 벌떡 일어나는 거지 뭐야
게 효시미 지그카며는 지성이 감처니라 이거야 정성이 지그가먼 하느리 감동헌대는 거야	그게 효심이 지극하면 지성이 감천이라 이거야 정성이 지극하면 하늘이 감동한다는 거야
겐 그 도사는 중은 중이 아이라 어느 산시니라	그 도사는 중은 중이 아니라 어느 산신이라
그 효시메 감동해서 그 아들며누리 그 효시메 감동되야서 나려와가지고 그 산사믈 내려다 준거야	그 효심에 감동해서 그 아들며느리 그 효심에 감동되어서 내려와가지고 그 산삼을 내려다준 거야
이런 효도가 이서 더 바랄 수 엄는 효 효시미지	이런 효도가 있어 더 바랄 수 없는 효 효심이지
자기 자식까지도	자기 자식까지도
그럼그거 뭐 삼 사민줄 알구 살만나 내내 아드린 줄 알구 살마찌	그럼그거 뭐 삼 삼인줄 알고 삶았나 내내 아들인 줄 알고 삶았지
더 자래야 하는데 엄마	더 잘해야 하는데 엄마
더 더 더해	더 더 더해
아우 이거 대가리가 그리믄 어뜨케 돼뜬지가네	아우 이거 대가리가 그림은 어떻게 됐든지 간에
이 번 바탕이 우리 태그끼야 이거이 요이요이 인제 괘는 그릴 꺼구	이 본 바탕이 우리 태극기야 이것이 요기요기 이제 괘는 그릴 거고
본 바탕이 힌새기야 아마 이건 다 알 꺼야	본 바탕이 흰 색이야 아마 이건 다 알 거야
힌 새근 평화를 평와를 유지하는 거거든 하얀 새근	흰 색은 평화를 평화를 유지하는 거거든 하얀 색은
그러키 때메 옌나레도 인제 전쟁을 허구 해도 이 항보컬 때는 배낄 하얀 기를 이 장대에 꼬꾸이 항보글 헌다 마랴	그렇기 때문에 옛날에도 이제 전쟁을 하고 해도 이 항복할 때는 백기를 하얀 기를 이 장대에꽂고 이 항복을 한단 말이야
그 항보컬 때는 나는 인젠 저스니껜 우리 평화롭게 잘 삽씨다 그 뜨시야 그거이	그 항복할 때는 나는 이제 졌으니까 우리 평화롭게 잘 삽시다 그 뜻이야 그게
힌새근 평와야	흰 색은 평화야
헌데 요거시 인제 요기 인제 태그기 요 요거슨 요거시 태그기야	헌데 요것이 이제 요기 이제 태극이 요 요것은 요것이 태극이야
요 하나 요러케 그려논 거이 요이 태그기야	요 하나 요렇게 그려논 게 요게 태극이야
아무거뚜 움는 거슬 무그기라구 해 무극	아무것도 없는 것을 무극이라고 해 무극
아무거 이거 이거 음는 거 백찌 이는 거슨 이거슨 무그기라구 해	아무거 이거 이거 없는 거 백지 있는 것은 이것은 무극이라고 해
아무거뚜 업따 마리지	아무것도 없다 말이지
헌데 요거이 딱 하나 나오먼 태그기야	헌데 요게 딱 하나 나오면 태극이야
태그긴데 이거 태그긴데 요 태그기 나오먼서 요기 요 딱 버러저	태극인데 이거 태극인데 요 태극이 나오면서 요기 요 따악 벌어져
우리 조서니 언마나 지금 세계에서 상등구기 뒌냐 하는 거슨 이 구끼에서버텀 나타나고 인는거야	우리 조선이 얼마나 지금 세계에서 상등이 됐냐 하는 것은 이 국기에서부터 나타나고 있는거야
아프로부터 봐	앞으로부터 봐
느이는 난 느이들 느이드리라구 해 나는 느이보군 뭐 학쌩들 허구 저네 내 손주딸 거치니께그냥 느이드리라구 해  너희는 난 너희들 너희들이라고 해 나는 너희보곤 뭐 학생들  하기 전에 내 손주딸 같으니까 그냥 너희들이라고 해느이 느이는 능이 볼 수 이서 이 하라버지 거튼 사라믄 보기 힘들지	
느이 느이는 능이 볼 수 이서 이 하라버지 거튼 사라믄 보기 힘들지	너희 너희는 능히 볼 수 있어 이 할아버지 같은 사람은 보기 힘들지
아프로 어떠케 돼 발쩐돼나가서 세계를 가따 한구게 자바 웅켜지고 지배하는가 마리지	앞으로 어떻게 돼 발전되어 나가서 세계를 갖다 한국에서 잡아 움켜쥐고 지배하는가 말이지
세계 상등구기야 상등이 뭐야 우쌍짜 아냐	세계 상등국이야 상등이 뭐야 윗 상 자 아냐
예에	예 예
제일 너픈 나라가 된다고 한구게서 제일 노픈 나라	제일 높은 나라가 된다고 한국에서 제일 높은 나라
지금 이런 얘기허먼 아유 저 하라버이 또 미친 소리 허네 이런 얘그한다고	지금 이런 얘기하면 아유 저 할아버지 또 미친 소리 하네 이런 얘기한다고
그러나 하라버지가 지금 메씸년 전아플 보구 얘길 허먼 미친노미지만 그 당시에는 마자	그러나 할아버지가 지금 몇십년 전앞을 보고 얘기를 하면 미친놈이지만 그 당시에는맞아
아 그 얘기가 증말 마잔네	아 그 얘기가 정말 맞았네
이걸 예를 드러서 얘기허까	이걸 예를 들어서 얘기할까
내가 한 삼사심년 저네  삼사심녀네는 무슨 얘길 핸냐면 이런 얘길 해서	내가 한 삼사십년 전에  삼사십년에는 무슨 얘길 했냐면 이런 얘길 했어
아프로는 굴뚜게서 연기 안 나고 바패먹고	앞으로는 굴뚝에서 연기 안 나고 밥해먹고
우리가 농사진는데 여기는 농사 저 아냐	우리가 농사 짓는데 여기는 농사 저 아냐
농사진는데 소니나 바레 물과 흐글 안 무치구 농사 진는다	농사 짓는데 손이나 발에 물과 흙을 안 묻히고 농사 짓는다
그때 하라버지가 어트게 몰련는 줄 아라	그때 할아버지가 어떻게 몰렸는 줄 알아
저 미친 사람 미친년 그 당시엔 하라부지가 이 상투 틀구 이뜨래따구	저 미친 사람 미친년 그 당시엔 할아버지가 이 상투 틀고 있더랬다고
저 미친 사람 미친 주른 이미 아라찌머는 저러케꺼지 미친 주른 몰라따 마리야	저 미친 사람 미친 줄은 이미 알았지만 저렇게까지 미친 줄은 몰랐다 말이야
아니 이 사라마	아니 이 사람아
아이 구 굴뚜게서 연기가 안 나먼 바블 무로 어트게 해머거	아이 굴 굴뚝에서 연기 안 나면 밥을 뭘로 어떻게 해먹어
그리고 우리가 농사진는데 아이 무레 드러가야지 흐글 발바야지	그리고 우리가 농사짓는데 아이 물에 들어가야지 흙을 밟아야지
소니나 바레 흐꽈 무를 안 무치고 어떠케 농사지어 마랴	손이나 발에 흙과 물을 안 묻히고 어떻게 농사지어 말이야
사람 증말 어유 미친 줄 아라찌만 보통 미친 거 아이네 저 크닐나꾸만 저 사람	사람 정말 어유 미친 줄 알았지만 보통 미친 거 아니네 저 큰일났구만 저 사람
아무말 모태서 아무말 모태서	아무 말 못했어 아무 말 못했어
근데 지금 와서 얘기하먼 마자	그런데 지금 와서 얘기하면 맞아
지금 굴뚝 인는 지비 어디가 이서	지금 굴뚝 있는 집이 어디가 있어
응 굴뚜기래는 너이 굴뚝 아냐 모르지	응 굴뚝이래는 너희 굴뚝 아냐 모르지
그저네 이러케	그 전에 이렇게
그러구 맨발루다 모 찌구 김 매구 그만	그리고 맨발로다 모 찌고 김 매고 그만
뭘허게 농사지는데 소니나 바레 무리 왜 무꾸 흐기 왜 무더	뭘 하게 농사짓는데 손이나 발에 물이 왜 묻고 흙이 왜 묻어
아 장와 여기 어디 쓰는 거 있지 장갑 여기꺼지 쓰는 거지	아 장화 여기 어디 쓰는 거 있지 장갑 여기까지 쓰는 거지어 물로네 드러가도 흐가나 무라나 안무치고 버스면 요러 요러 요러케 된다 마랴어 물논에 들어가도 흙 하나 물 하나 안 묻히고 버스면 요러 요렇게 된다 말이야
지금 애기허며는 마자	지금 얘기하면 맞아
허는데 지금 내가 얘기허는 건 아프로 멘 녀늘 압뚜구서 얘기하니껜 지금 또 드르먼 아유 하라버지정말 미천네 정 망녕 드런네	하는데 지금 내가 얘기한 건 앞으로 몇 년을 앞두고서 얘기하니까 지금 또 들으면 아유 할아버지정말 미쳤네
두구봐 틀림업따	두고 봐 틀림없다
그리머는 요 요거 인제 요건 힌새기구	그러면 요 요거 이제 요건 흰색이고
요 요 똥그랑이 태그긴데	요 요 동그라미가 태극인데
요기 두군데 따악 갈라논 거이 뭐냐 양이야 양이	요기 두 군데 따악 갈라놓은 게 뭐냐 양의야 양의
한문 쓰지 안쿠 내언문 한글루 쓰께	한문 쓰지 않고 내언문 한글로 쓸게
양의야 양이는 뭐냐 남자 여자  해와 달	양의야 양의는 뭐냐 남자 여자  해와 달
이거 오음냥이야 일본 구끼는 그냥 이런데 똥그란 거 하나 이찌	이거 오음양이야 일본 국기는 그냥 이런데 똥그란 거 하나 있지
요건 해야 해	이건 해야 해
일본 구끼두 이거 보통 구끼 아니야 해야 해	일본 국기도 이거 보통 국기 아니야 해야 해
근데 다른 나라 구끼드른 이러케 된다메 낭구이파리를 그려노코 요거 우리나라 구끼	그런데 다른 나라 국기들은 이렇게 된다며 나무이파리를 그려놓고 이거 우리나라 국기
또 줄 이러케 거노코 이거 우리나라 구끼	또 줄 이렇게 그어놓고 이거 우리나라 국기
만국기를 한번 헤처노코 봐바	만국기를 한번 헤쳐놓고 봐봐
참 우습끼가 하넙 뭐 벼 별 하나 이러 그려노코 우리나라 구끼 응	참 우습기가 한없 뭐 벼 별 하나 이렇게 그려놓고 우리나라 국기 응
이건 아이들 장난꺼리바께 안되는 거라 마랴	이건 아이들 장난거리밖에 안 되는 거란 말이야
오행 이치에 인는 건 요건 해야 해 일보는 해	오행 이치에 있는 건 이건 해야 해 일본은 해
핸데 해가 아유 영 시지	해인데 해가 아유 영 세지
일본놈드리 을마나 기우니 셔뜨래서	일본 놈들이 얼마나 기운이 셌더랬어
소 저러키니 러시아 소련도 가따	소 저렇게 러시아 소련도 갖다
저기 궁미낵교 일본 글만 밴는데 그저넨 조선말하머는 여기 한국말하머는 빼꾸 지베도 안 보내서그저네	저기 국민학교 일본 글만 배웠는데 그 전엔 조선말하면 여기 한국말하면 뺏구 집에도 안 보냈어그 전에
이 일보니 일러전쟁 이짜나	이 일본이 일러전쟁 있잖아
역사는 그 그거 정말 일러전쟁 소련하고 전쟁해서 소련 때려 부셔짜나	역사는 그 그거 정말 일러전쟁 소련하고 전쟁해서 소련 때려 부쉈잖아
중일전쟁해짜나 주 중국 중국 중국 때려 부셔짜나	중일전쟁했잖아 주 중국 중국 때려 부쉈잖아
그래가주구 나중엔 한구글 깔고누르는 거라 마리야	그래가지고 나중엔 한국을 깔고 누르는 거라 말이야
깔구 눌러 한구글 토대로 해가주군 세계로 뻐쳐나갈려구	깔고 눌러 한국을 토대로 해가지곤 세계로 뻗쳐 나가려고
근데 요 해 요건 해야 이게 일보니저번 그저께두 내가 교순데 해가 인제 동쪼게 불끈소까오를 때는 하루 죙일 날 그 기우늘 띠고 일 때 해에 태양에 히미란 게 엄청나다 마랴	그런데 요 해 요건 해야 이게 일본이저번 그저께도 내가 교순데 해가 이제 동쪽에 불끈솟아오를 때는 하루 종일 날 그 기운을 띠고 일 때 해의 태양의 힘이란 게 엄청나단 말이야
해찌먼 그 해가 떠와서 중간쯤 오먼 그 처음에 떠올른 기새기 다 업드러지군 그저 흐러 흐러  고개 끄떡끄떡	했지만 그 해가 떠 와서 중간쯤 오면 그 처음에 떠오른 기색이 다 없어지곤 그저 흘러 흘러고개 끄덕끄덕
그 서쪼그루 너머가게 되먼 이 해는 인저는 기운 다 이저버린 거야	그 서쪽으로 넘어가게 되면 이 해는 이제는 기운 다 잊어버린 거야
이제 일보는 힘 다 써서 인전 업써	이제 일본은 힘 다 썼어 이젠 없어
그 일보는 일보는 그러키 때메 기시가 등등해짜나	일본은 그렇기 때문에 기세가 등등했잖아
근데 그래두 세계 구끼 일케 드러보면 일본구끼만덤두 헌거이 엄는데	그런데 그래도 세계 국기 이렇게 들여다 보면 일본국기만한 게 없는데
우리나라 구끼는 하유 이거이 아프루 무긍무지너게 기냥 씨뻘 뻘쳐나가는 기세라 마리야	우리나라 국기는 하유 이게 앞으로 무궁무진하게 그냥 시뻘 뻗쳐나가는 기세라 말이야
게 요거슨 여긴 홍 여긴 청 홍청 아냐	그러니 요것은 여긴 홍 여긴 청 홍청 아냐
빨간 건 양 파란 거 음	빨간 건 양 파란 거 음
이러케 뒌는데 왜 삼팔써니 갈라전냐	이렇게 되어 있는데 왜 삼팔선이 갈라졌냐
이상허지 이거이 우리 조서닌데 구끼가 갈라저서	이상하지 이게 우리 조선인데 국기가 갈라졌어
어 구끼가 여기 이러 그믈 딱 거놔서	어 국기가 여기 이렇게 금을 딱 그어 놨어
으먕이야	음양이야
이부기남 여기서 이 이 구끼에서두 이 주를 딱 처노코 이러케 갈라	이북이남 여기서 이 국기에서도 이 줄을 딱 쳐놓고 이렇게 갈라
근데 이걸 어디다 그려중가니야 중간 중가네서 다 그려놔서	그런데 이걸 어디다 그려중간이야 중간 중간에서 다 그려놨어
이거 이건 어차피 헐 쑤 웁씨 천지대세서 한구글 가따 얘기해짜나	이거 이건 어차피 할 수 없이 천지대세에서 한국을 갖다얘기했잖아
음녁 양녀근 삼뱅육씨보일 음녀근 이백구십 구십칠 파릴 메뿐 이백오십또 부니 허구 핸데요거슬 통터르면 삼뱅육씹	음력 양력은 삼백육십오일 음력은 이백구십 구십칠 팔일 몇분 이백오십 도 분의 일하고한데 요것을 통틀면 삼백육십
음녁 양녀글 통터러서 갈르며는 삼뱅육씨비다	음력 양력을 통틀어서 가르면 삼백육십이다
삼뱅육시빈데 지금 지구가 어드러케 생견냐	삼백육십인데 지금 지구가 어떻게 생겼냐
지구가 이 타워녕으로 생겨가지고 지추기 여기서 이러케 생겨다 마리야	지구가 이 타원형으로 생겨가지고 지축이 여기서 이렇게 생겼단 말이야
요거시 지추기 요러케 서스머는 똑바로 서스머는 삼뱅육씨비 되는데 지추기 삐따커니 지금 이사람들 뭐 학쌩들 보고 이런 얘기허긴 선생 아페서 문자 쓰는 거네 내가	요것이 지축이 요렇게 섰으면 똑바로 섰으면 삼백육십이 되는데 지축이 삐딱허니 지금 이사람들 뭐 학생들 보고 이런 얘기하긴 선생 앞에서 문자 쓰는 거네 내가
지구가 지금 타워령이란 마랴	지구가 지금 타원형이란 말이야
핸데 그 지추기래는 건 지구를 가따 아까 이 지구 지블 허먼 성주와 마찬가지루 그 성주 제 지추글바루잡는 거이 지추기 이 삐따카게 서따 마리지	헌데 그 지축이라는 건 지구를 갖다 아까 이 지구 집으로 하면 성주와 마찬가지로 그 성주제 지축을 바로잡는 게 지축이 이 삐딱하게 섰단 말이지
게 지구가 지추글 위애서 이제 빙빙빙빙 수뇌를 허는데 삐따커게 슨겐 삐따커게 도니껜 음녁과양녀근 거기서 차이가 진다 마리야	게 지구가 지축을 위해서 이제 빙빙빙빙 순회를 하는데 삐딱하게 서니까 삐딱하게 도니까 음력과양력은 거기에서 차이가 진단 말이야
게 지금 얘기하는 건 뭐냐믄 아프론 이 삐따카게 슨 지추기 바루 슨다 이거야 딱빠루	게 지금 얘기하는 건 뭐냐면 앞으로는 이 빠딱하게 선 지축이 바로 선다 이거야 똑바로
똑빠루 서게 되며는 일려는 사 삼뱅육씨빌	똑바로 서게 되면 일년은 사 삼백육십일
음녁 양녀기 웁씨 삼뱅육씨빌	음력 양력이 없이 삼백육십일
그땐 뭐시 되냐 동쪼게서 해 뜨고 서쪼게 해가 지먼 바로 동쪼게서 다리 쪼차 올라오는	그땐 무엇이 되냐 동쪽에서 해 뜨고 서쪽에 해가 지면 바로 동쪽에서 달이 쫓아 올라오는
해 또 달 지먼 해가 뜨구 이러케 된대는 거야	해 또 달 지면 해가 뜨고 이렇게 된다는 거야
이거슬 지금 누가 누가 미더	이것을 지금 누가 누가 믿어
이런 얘기먼 또 미쳐따고 하지	이런 얘기면 또 미쳤다고 하지
미처따구 허는데 아니 증거가 여기 테레비에 나와	미쳤다고 하는데 아니 증거가 여기 텔레비전에 나와
너이 저이 인천서우른 그거이 안나 안나올 꺼야	너희 저 인천 서울은 그게 안 나 안 나올 거야
여기서는 시보방송이나본데 시보방송이서 맨날 이 얘기 한다 이거	여기서는 십오 번 방송이나본데 십오 번 방송에서 맨날 이 얘기 한다 이거
지추기 바루 슴니다 바루 슴니다	지축이 바로 섭니다 바로 섭니다
바루 스먼 삼뱅육씨비 된다 마리야	바로 서면 삼백육십이 된다 말이야
밤낟 여기서는 너이 고구초네 가서 자먼서 테레비 보머는 시보 채널 시보 한 번 트러봐	밤낮 여기서는 너희 고구촌에 가서 자면서 텔레비전 보면 십오 채널 십오 한 번 틀어봐
지금 여기 틀먼 지금두 나와	지금 여기 틀면 지금도 나와
고 고기서 나오며는 증산도랜 교에서 나와	거 거기서 나오면 증산도라는 교에서 나와
아이 그 테레비에 공개되는 건 버베 저초기 안 되니껜 공개하는 거 아냐 그니까 나와	아이 그 텔레비전에 공개되는 건 법에 저촉이 안 되니까 공개하는 거 아냐 그러니까 나와
그 그 사람들 얘기를 바루 내가 얘기하는 거 지추기 바루 슨다	그 그 사람들 얘기를 바로 내가 얘기하는 거 지축이 바로 선다
바로 스며는 그땐 음양이 또까따	바로 서면 그땐 음양이 똑같다
근데 지금 태그끼 얘기하다 이러이 된는데	그런데 지금 태극기 얘기하다가 이렇게 됐는데
요거 이제 으먕으루 갈라젼는데	요거 이제 음양으로 갈라졌는데
돼따마랴 근데 워니 이거 팔괘야 팔괘 여덜깨야	됐단 말야 그런데 원이 팔괘야 팔괘 여덟개야
이건 건 곤 이 감 건 곤 감 감 이 허자나	이건 건 곤 이 감 건곤감 감이 하잖아
느이 이거 이건 알자나	너희 이거 이건 알잖아
그르먼 이거이 무어냐 거는 뭐냐 고는 뭐고	그러면 이게 뭐냐 건은 뭐냐 곤은 뭐고
요건 하눌 요건 땅 요건 아버지 어머니 요건 양 음	요건 하늘 요건 땅 요건 아버지 어머니 요건 양 음
요건 그러먼 요건 뭐냐 해 이건 달	요건 그러면 요건 뭐냐 해 이건 달
근데 이 괘래는 거이 그렁거야	그런데 이 괘라는 것이 그런 거야
양은 양이래는 건 이 쭉 하나 겅 거이 요거 양이고그래 요건 하나는 양으루 가	양은 양이라는 건 이 쭉 하나 그은 게 요것이 양이고그래 요거 하나는 양으로 가
근데 둘 허먼 요러케 가요건 하나 요건 두리야	그런데 둘 하면 요렇게 가요건 하나 요건 둘이야
금 왜 양으미게	그럼 왜 양음이게
으 으먕 얘기 할려머는 내 저번날 저 교순님 너이들 귀 귀 마가 핸데	음 음양 얘기 하려면 내 저번날 저 교수님이 너희들 귀 귀 막아 했는데
에이 나 그 얘기꺼진 아내준다 그러구 마라찌만	에이 나 그 얘기까진 안해준다 그러고 말았지만
으먕을 얘기허먼 사라메 비춰서 얘길 해야 얼릉 아라	음양을 얘기하면 사람에 비춰서 얘기를 해야 얼른 알아
겐 한 번 이야해신겐 내 고대로 얘기해	그게 한 번 이야기했으니까 내 그대로 얘기할게
천지 아까 내가 얘기허지만 사라믄 천지에 대표무리다	천지 아까 내가 얘기했지만 사람은 천지의 대표물이다
천지 이 이치는 몰라도 이 천지 이치를 알려머는 사라메 모메다가서 비춰보먼 모든 게 안다마리야	천지 이치는 몰라도 이 천지 이치를 알려면 사람의 몸에다가 비춰 보면 모든 걸 안단 말이야
해짜나 그이 요거는 쪽쪽 뻐치니겐 요건 양이야	했잖아 그러니 요거는 쪽쪽 뻗치니까 요건 양이야
양을 가따 건 거는 하눌 아버지	양을 갖다 건 건은 하늘 아버지
요건 전부 갈라져서 요거 세시 다 갈라져짜나	요건 전부 갈라졌어 요거 셋이 다 갈라졌잖아이 땅 어머니 음땅 어머니 음
게 아버지 어머니 하늘과 땅 야 음양 으먕	게 아버지 어머니 하늘과 땅 야 음양 음양
그면 여긴 뭐냐	그러면 여긴 뭐냐
이건 해 해는 왜 왜 여그 중가니 비언냐	이건 해 해는 왜 왜 여기 중간이 비었냐
해를 처다봐 해 소근 부 누니 부셔서 해 소글 드려다 보지 모태 그르치	해를 쳐다봐 해 속은 부 눈이 부셔서 해 속을 들여다 보지 못해 그렇지
해에 해 소게는 아주 그냥 말꾸 고고헌데 해쏘글 드려다 보래먼 해쏘게 무어 인는지 뵈질 아나	해에 해 속은 아주 그냥 맑고 고고한데 해 속을 들여다 보려면 해 속에 뭐가 있는지 보이질않아
그건 으미 드러이끼 때메야	그건 음이 들어있기 때문이야
으미 드러이끼 때메 해소근 드려다보지 모태	음이 들어있기 때문에 해 속은 들여다보지 못해
다르 다를 한 번 봐바 달은 자체가 으미거든	달을 달을 한 번 봐봐 달은 자체가 음이거든
으민데 달까운덴 양이 이서	음인데 달 가운데엔 양이 있어
달까운덴 양이 이 처다보면 게수나무가 나오지	달 가운데엔 양이 이 쳐다보면 계수나무가 나오지
그거 또려타게 뵈거든 다른 붸	그거 또렷하게 보이거든 달은 보여
그건 왜 봬냐	그건 왜 보이냐
으메 으메는 양 끼우니 이끼 때메	음에 음에는 양 기운이 있기 때문에
양끼운 때메 다른 저 보먼 살 소기 다 베지만 해 쏘겐 으미 이끼 때메 해쏘근 뵈질 안는 거야	양 기운 때문에 달은 저 보면 살속이 다 보이지만 해 속엔 음이 있기 때문에 해 속은 보이질않는 거야
건 어니나라 구끼 치구 이런 천지에 이치를 포아먼 구끼를 가진 나라가 어디 인냐	어느 나라 국기 치고 이런 천지의 이치를 포함한 국기를 가진 나라가 어디 있냐
이건 하라버지 혼자 판단한 거야 누구에게 배운 거뚜 아니고 누구에게 이 헌 거뚜 아니구	이건 할아버지 혼자 판단한 거야 누구에게 배운 것도 아니고 누구에게 이 헌 것도 아니고
어디 가든지 하라버진 이 얘길 해	어디 가든지 할아버지는 이 얘기를 해
아프로 우리 한구기 한구기 세계를 지배한다 상등국 댄다	앞으로 우리 한국이 한국이 세계를 지배한다 상등국 된다
그건 뭐루아냐	그건 뭐로 아냐
구끼를 한 번 헤쳐노코 봐라	국기를 한 번 헤쳐놓고 봐라
구끼래는 건 그 나라에 상징이야 그 나랄 표시허는 거야 그 나라의 얼구리야	국기라는 건 그 나라의 상징이야 그 나라를 표시하는 거야 그 나라의 얼굴이야
그리먼 아까 얘기한 대루 어드런 나라는 그냥 낭구이파리 하나 그리고 요거 우리 구끼	그러면 아까 얘기한 대로 어떤 나라는 그냥 나뭇잎 하나 그리고 요거 우리 국기
하나 이러 쭉 거노코 우리나라 구끼	하나 이렇게 죽 그어 놓고 우리나라 국기
이거이 무어 무어 구낀지 뭔지 그리믈 그려논 건지 하등 몰라	이게 뭐 뭐 국기인지 뭔지 그림을 그려놓은 건지 하등 몰라
그나 우리나라 구 이 태그끼 만쿠믄 완저이 뚜려터게 천지 이치를 묘 포함되구 이따 마리지	그러나 우리나라 구 이 태극기만큼은 완전히 뚜렷하게 천지 이치를 묘 포함되고 있단 말이지
근데 왜 왜 그러케 되냐	그런데 왜 왜 그렇게 되냐
우리나라가 왜 그러케 소 소꾸기 되구 약쏘구까가 뒌냐	우리나라가 왜 그렇게 소 속국이 되고 약소국가가 됐냐
그거뚜 저 교수님헌테 이야기 핸네 음냥이야기	그것도 저 교수님한테 이야기했네 음양이야기
선처네는 남자 양이 셔가지고 여자는 그냥 응 거 남자들 사 사추리 미테 고게 드리 드리미러노쿤네네 잘모태씀니다	선천에는 남자 양이 세가지고 여자는 그냥 응 거 남자들 사추리 밑에 고개 들이 들이밀어놓곤네네 잘못했습니다
그러케 해두 마 나가 그러면 보따리 싸가주구 나가야 돼구	그렇게 해도 마 나가 그러면 보따리 싸가지고 나가야 되고
마 예편네 그냥 두구두 첩 뭐 일처 이처비야	마 여편네 그냥 두고도 첩 일처 이첩이야
첩 하나 둘 드리먼 보통이구	첩 하나 둘 들이면 보통이고
남자 권세가 그러케 시 세다구 해지 아나서	남자 권세가 그렇게 세 세다고 하지 않았어
근데 우리나라 우리나라는 자체가 동쪼게서 양이야	그런데 우리나라 우리나라 자체가 동쪽에서 양이야
우리나라 위치가 양인데 양 양 중에 유으미야 달 다러구 또까태	우리나라 위치가 양인데 양 중에 음이 있어 달 달하고 똑같아
해 해서 구 구바글 바다 오다 아프론 후천 해원 시대가 돼	해 해서 구박을 받아 오다가 앞으로는 후천 해원 시대가 돼
해원 워늘 푸러야지대	해원 원을 풀어야지 돼
워늘 푸는데 뭐세서 풀기 시자캔냐	원을 푸는데 무엇에서 풀기 시작했냐
욘님금 욘님금 순님금 허먼 느이드리 그 역싸에 욘님금 순님그미 나오는지 안나오는지 모르가따	요임금 요임금 순임금 하면 너희들 그 역사에 요임금 순임금이 나오는지 안 나오는지 모르겠다
에 보키씨 무 보키 보키씨 무놩씨 그거뚜 아는지 모르가뜨만	에 복희씨 무 복희 복희씨 문왕씨 그것도 아는지 모르겠지만
요 요 욘 욘님그미야 게 이 살기 조 조을 때가 요 욘님금 시저리 질 조아때	요 요 요임금이야 그게 이 살기 좋을 때가 요임금 시절이 제일 좋았대
아주 차카고 서난 사라믄저 사라믄 요순쩍 백썽이야	아주 착하고 선한 사람은저 사람은 요순적 백성이야
이제 그까 지금두 이따구	이제 그러니까 지금도 있다고
저 사라믄 요순쩍 백썽이야	저 사라믄 요순적 백성이야
그러는데 그때는 사라미	그러는데 그 때는 사람이
요 욘닝그미 욘닝그메 아드리 단주야 단주	요 요임금이 요임금의 아들이 단주야 단주
단준데 옌나레는지금 지금두 이부게선 기밀썽이가 김정이레게 정권 아양애주고 뭐 저 정뭐야 정이리 아드리 무슨 정 뭐시냐 그이 그놈께 또 또 그놈께 다시 저 정궈늘 이양시키니	단주인데 옛날에는지금 지금도 이북에선 김일성이가 김정일에게 정권 이양해주고 뭐저 정 뭐야 정일이 아들이 무슨 정 뭐시냐 그 그놈에게 또 또 그놈에게 다시 저 정권을 이양시키니
예저네는 그대로 게승이야 임그메 아드른 임금	예전에는 그대로 계승이야 임금의 아들은 임금
핸는데 욘님그미 단 아드리 아들 이르미 단준데 당여니 단주에게 될 임금 자리를 통치꿔늘넴겨 줘야되는데 아드레게다 안 줘서 통치꿔늘	했는데 요임금이 단 아들이 아들 이름이 단주인데 당연히 단주에게 될 임금 자리를 통치권을넘겨줘야 되는데 아들에게 안 줬어 통치권을
안 주구 아드레겐 뭘 줜냐 배둑판 지금 배둑 뚜는 거 이짜나	안 주고 아들에겐 뭘 줬냐 바둑판 지금 바둑 두는 거 있잖아
배듭파늘 하나를 그러 주면서 넌 이거나 가지고 이서 허구 사위 사위 사위가 누구냐면 우수니야우순	바둑판을 하나를 그려 주면서 넌 이거나 가지고 있어 하고 사위 사위 사위가 누구냐면 우순이야우순
그게 운님그미야	그게 우임금이야
우수네게다 따리 형제 이선는데 큰 따른 아왕 둘째 딸 이르믄 여영 아왕 여영을 가따 우수네게다 줘뻐려서	우순에게 딸이 형제 있었는데 큰 딸은 아왕 둘째 딸 이름은 여영 아왕 여영을 갖다 우순에게다 갖다 줘버렸어딸 형제를 다 주먼서 임그메 자리를 우수네게 넹겨주구 아들 단주에겐 이 배득판 하나 그려주구넌 이거나 차지하구 이서 줘따 마랴딸 형제를 다 주면서 임금의 자리를 우순에게 넘겨주고 아들 단주에게는 이 바둑판 하나 그려주고넌 이거나 차지하고 있어 줬단 말이야
욘님그미 성이니신데 욘님그믄 후세를 며천년전 아플 내다보시는 양반인데 그래서 아드레게단주에겐 임금 짜리를 안주구 너 배득파니나 너 이거 가지구 이서	이건 임금이 성인이신데 요임금은 후세를 몇 천년 전 앞을 내다보시는 양반인데 그래서 아들에게 단주에겐 임금 자리를 안 주고 너 바둑판이나 너 이거 가지고 있어
핸는데 단주는 그 내용을 몰라	했는데 단주는 그 내용을 몰라
헌데 당여니 내가 임금 노륻 헐 줄 아란는데 아니 엉뚱하게 난 쓸데움는 그림 하나 그려주구이거 넌 이거나 가저 하고 임금 자리는 매 매부에게 누 누이동생 둘씨기나 주먼서 임금시켜주니그이 하니 된 거지	헌데 당연히 내가 임금 노릇 할 줄 알았는데 아니 엉뚱하게 난 쓸데없는 그림 하나 그려주고이거 넌 이거나 가져 하고 임금 자리는 매 매부에게 누이동생 둘씩이나 주면서 임금시켜주니그게 한이 된 거지
하니 돼서 단주는 주거뻐려서 워나늘 품지 풍꾸 그냥 주거뻐린거야	한이 돼서 단주는 죽어 버렸어 원한을 품지 품고 그냥 죽어버린 거야
그 그 워나니 그 순님그미 임금노르슬 하먼서 단주에게 누 누이동생 두를 아내로 거느리고사는데도	그 그 원한이 그 순임금이 임금노릇을 하면서 단주에게 누이동생 둘을 아내로 거느리고 사는데도
단주가 그 워늘 하늘 품꾸 주그니 그 하네 워나니 누이 누이들께루 가서 사리 가가지구 아왕여연 소상강에 무레 다 드러가 다 주거뻐리구 만 거야	단주가 그 원을 한을 품고 죽으니 그 한에 원한이 누이 누이들에게로 가서 살이 가가지고아왕 여영 소상강에 물에 다 들어가 다 죽어버리고 만 거야
그니 거기서부턴 하니 쌘 거야 그냥	그러니 거기에서부턴 한이 쌓인 거야 그냥
워나니 그냥 풍풍 쌔구 나오는 거지	원한이 그냥 풍풍 쌓이고 나오는 거지해서 이 세상은 상그기 돼뻐려서해서 이 세상은 상극이 되어버렸어
서루 그냥 주기구 바꾸 치구 바꾸 주기구 살리구 그래 전쟁이 이러나구 이 모냥이 된 거지	서로 그냥 죽이고 박고 치고 박고 죽이고 살리고 그래 전쟁이 일어나고 이 모양이 된 거지
근데 지금 이 도수가 지금 드러오기 시자커는 거야 이 도수가	그런데 지금 이 도수가 지금 들어오기 시작하는 거야 이 도수가
금 아니 아니 지금 그 도수가 드러온지 안드러온진 뭘 가지고 뭘보고 암니까 마리야	그럼 아니 지금 그 도수가 들어온지 안들어온지는 무얼 가지고 뭘 보고 압니까 말이야
느이 반무나구 싶짜나	너희 반문하고 싶잖아
아니그 사람들 그러게 원하네 주건는데 세게 상그그루 해서 주기구 치구 바꾸 주기구 살리구했는데지금 그거시 푸러저서 후천 시대가 드러온대는 건 뭐 뭐 보고 그런 얘기하냐고 반문헐꺼 가튼데 반문허지	아니그 사람들 그렇게 원한에 죽었는데 세 개 상극으로 해서 죽이고 치고 박고 죽이고살리고 했는데지금 그것이 풀어져서 후천시대가 들어온다는 건 뭐 보고 그런 얘기하냐고반문할 것 같은데 반문하지
내가 이젠 반문꺼지 무러 가먼서 대 줘야지	내가 이젠 반문까지 물어 가면서 대 줘야지
근데 보키 욘님금 먼저에 보키씨가 이서서 보키씨가	그런데 복희 요임금 먼저에 복희씨가 있었어 복희씨가
바로 이 팔괘가 보키씨 나중 팔괘야	바로 이 팔괘가 복희씨 나중 팔괘야
요 요건 아주 정시기야 정식	요 요건 아주 정식이야 정식
근데 무놩 때 욘님금 시저렌 무놩이래서	그런데 문왕 때 요임금 시절엔 문왕이랬어
무낭 때 인데 이 팔괘를 보키씨가 그냥 그린 거 아냐	문왕 때 인데 이 팔괘를 복희씨가 그냥 그린 거 아냐
보키씨두 승이는 승이니라두 몰르지	복희씨도 성인은 성인이라두 모르지
헌데 그때에 하수 하수는 연몯 연모세서 용마	헌데 그 때에 하수 하수는 연못 연못에서 용마
그니가 저 인제 너이는 그게 모르가 아는지 모르간는데	그러니까 저 이제 너희는 그게 모르겠 아는지 모르겠는데
장수나믄 용마 생긴다	장수 나면 용마 생긴다
장수 장수랜 건 월뜽하는 장수지	장수 장수라는 건 월등한 장수지
장수가 나며는 용마가 나온다 그 얘기가 인는 거야	장수가 나며는 용마가 나온다 그 얘기가 있는 거야
근데 용마래는 건 어디서 나오 았냐 물쏘게서 나와 용마는 물쏘게서 나와	그런데 용마라는 건 어디서 나왔냐 물 속에서 나와 용마는 물 속에서 나와
용마가 물 쏘게 튀저나 그때 튀저나오는데 보키씨는 성이니거든 용마가 물 속에 튀어나 그때튀어나오는데 복희씨는 성인이거든튀저나오는데 보니겐 마리 튀저나오거든 물쏘게서	
튀저나오는데 보니겐 마리 튀저나오거든 물쏘게서	튀어나오는데 보니까 말이 튀어나오거든 물 속에서
그 이상허자나 물쏘게서 마리 텨나오니	그 이상하잖아 물 속에서 말이 튀어 나오니
게 그런 얘기가 인는 거야	게 그런 얘기가 있는 거야
무시 보키씨가 무시카며는 타구댕기다가 자바먹뜬지 할 껀데	무식 복희씨가 무식하면 타고다니다가 잡아먹던지 할 건데
성이니시라 그러칠 안코 용말 살피다 보니까 용마 장등에 마 마른 털 이짜나 터리 꼬불랑꼬불랑요러케 뭉처저가지구 뭉켜저가 가지구 무슨 그리믈 그 그려서 지금 나와따 이거야	성인이시라 그렇질 않고 용마를 살피다 보니까 용마 잔등에 마 말은 털 있잖아 털이 꼬불랑꼬불랑 요렇게 뭉쳐져가지고 뭉쳐져가지고 무슨 그림을 그 그려서 지금 나왔다 이거야
그 그리미 무슨 그리미냐 여기 나오는 거야	그 그림이 무슨 그림이냐 여기 나오는 거야
그 용마 잔등에 무슨 그리민 줄 아냐먼 이런 그르믈 지고 나온 거야 이런 이 그리믈	그 용마 잔등에 무슨 그림인 줄 아냐면 이런 그림을 지고 나온 거야 이런 이 그림을
근데 이 그리믈 그린 게 아니라 말 잔등에 털 터리 꼬부락꼬부락 하먼서 온 거지	그런데 이 그림을 그린 게 아니라 말 잔등에 털 털이 꼬부락꼬부락 하면서 온 거지
게 그걸 보고 그린 그리미 요거 하도야	그게 그걸 보고 그린 그림이 요거 하도야
근데 요 하얀 건 양 꺼먼 건 음	그런데 요 하얀 건 양 검은 건 음
아까 다서 다서여서까지는 생수라그래찌	아까 다섯 다섯여섯까지는 생수라 그랬지
요걸 요걸 바로 생수네 요거 부모체야	요거 요거 바로 생수네 요거 부모체야
해가지고 처음 부모가 겨론허면 자식 나차나	해가지고 처음 부모가 결혼하면 자식 낳잖아
첨 하나 아들 난 거야	처음 하나 아들 낳은 거야
아드른 양 아니야 하나는 양이껜	아들은 양 아냐 하나는 양이니까
요거 요 요거 하나는 요 부모에 사이에서 하나 나온 거거든	요 요거 하나는 요 부모의 사이에서 하나 나온 거거든
기겐 요거 하나 나와 요거 부모는 다서시야	그러니까 요거 하나 나와 요거 부모는 다섯이야
다서터고 하나하고 합치니겐 요 여서시 되는 거야	다섯하고 하나하고 합치니까 요 여섯이 되는 거야
아까 얘기헌 그거야 이거	아까 얘기한 그거야 이거
게 이 용마 장등에 이걸 지구 나온 거야	게 이 용마 잔등에 이걸 지고 나온 거야
이걸 보시구선 아하 이때는 이 법또 가지구 백썽을 다스리래는 거구나	이걸 보시고서 아하 이 때는 이 법도 가지고 백성을 다스리라는 거구나
승인이시니깐 이거슬 보고 그린 거시 이 보키팔괘야	성인이시니까 이것을 보고 그린 것이 이 복희팔괘야
여기 여기 그린 이 팔괘야 이거이	여기 여기 그린 이 팔괘야 이게
근데 요건 사괘 네괘만 해찌 요거 팔괘야 팔괘	그런데 요건 사괘 네괘만 했지 요거 팔괘야 팔괘
이러케 뒌는데 무놩때는 어드러케 완냐머는 요건 천지 기쑤가 봄처리야	이렇게 됐는데 문왕 때는 어떻게 왔냐면 요건 천지 기수가 봄철이야
하루 하루에는 이십사시가니 벼놔된다고 얘기해줘찌	하루 하루엔 이십사시간이 변화된다고 얘기해줬지
이십사시가니 시비야 시비지가 한지가 두시간	이십사시간이 십이야 십이지가 한 지가 두 시간
자추긴묘 허는 거이 고이 지지라구 허구 가블병정은 천가니라구	자축인묘 하는 게 그게 지지라고 하고 갑을병정은 천간이라고
고걸 한 바꾸 천간 지지가 한 바꾸 돌먼 육씨비 돼 육씹깝자야 육씨비 되먼 한갑	그걸 한 바퀴 천간 지지가 한 바퀴 돌면 육십이 돼 육십갑자야 육십이 되면 환갑
그 이치가 다 고기 인는 거야	그 이치가 다 거기 있는 거야
그래가지구 여기 이 보키씨가 지나가니겐 보키씨는 봄처린데 여기 오면 무놩이야	그래가지고 여기 이 복희씨가 지나가니까 복희씨는 봄철인데 여기 오면 문왕이야
무놩땐 뭐연냐면	문왕 땐 뭐였냐면
무놩 때는 이 그 이 그리미 또 나와서요 이 그리미	문왕 때는 이 그 이 그림이 또 나왔어요 이 그림이
여기는 보키시대구 여기는 무놩 때야	여기는 복희시대고 여기는 문왕 때야
게 메천년 후지	게 몇천 년 후지
건 지금 뭐 뭐냐 요 낙써라 그런다마랴 낙써	그건 지금 뭐 뭐냐 요 낙서라 그런단 말야 낙서
낙써는 어디서 난냐	낙서는 어디서 났냐
보키 때는 말 장등에다 걸머지고 나와찌마는 이 때는 거부기 장등	복희 때는 말 잔등에다 걸머지고 나왔지만 이 때는 거북이 잔등
거부기 거부기두 연 모세서 나와서 연모세서 거부기 장등에다 이 그리믈 지구 나온 거야	거북이 거북이도 연 못에서 나왔어 연못에서 거북이 잔등에다 이 그림을 지고 나온 거야
겐 무놩두 성이니니겐 아하 하도는 보키시대 봄철게 쓰던 법또구 지그믄 그 법똘 쓰지 말구이 법똘 쓰래는 거구나	그러니까 문왕도 성인이니까 아하 하도는 복희시대 봄철에 쓰던 법도고 지금은 그 법도를  쓰지 말고 이 법도를 쓰라는 거구나
저이키니 무놩이 이걸 보구선 이걸 하도를 하먼서 이 이 팔괘를 또 내논 거야 이거 요건 무놩팔괘야	저렇게 문왕이 이걸 보고선 이걸 하도를 하면서 이 이 팔괘를 또 내놓은 거야 이거 요건문왕 팔괘야
오눌랄까지 송꾸락 꼬불락꼬불락 허는 거 이짜나	오늘날까지 손가락 꼬불락꼬불락 하는 거 있잖아
어태도 무놩 무놩 이 시대 껄 우리가 쓰고 인는 거야 이 시대 껄 쓰구이서	여태도 문왕 문왕 이 시대 거를 우리가 쓰고 있는 거야 이 시대 거를 쓰고 있어
근 무놩은 어느 때냐 무놩은 일려니면 봄철 무저러키니 보키씨는 봄철 무놩은 여름철	그 문왕은 어느 때냐 무놩은 일년이면 봄철 무복희씨는 봄철 문왕은 여름철
기겐 생가캐봐 봄처레 허는 일과 여름처레 허는 일관 딸르자나	그러니까 생각해봐 봄철에 하는 일과 여름철에 하는 일과는 다르잖아
봄처레는 논 갈고 받 갈고 씨앋 뿌리고 허지마는 여름처레는 그 싹 나온 걸 가꿔야 하자나 노냥씨안만 뿌리면 어뜨케 가꿔야자나	봄철에는 논 갈고 밭 갈고 씨앗 뿌리고 하지만 여름철에는 그 싹 나온 걸 가꿔야 하잖아 노상씨앗만 뿌리면 어떡해 가꿔야 하잖아
가꾸먼 어뜨케 되냐 가꾸면 여름처렌 그냥 모내 팽창해 뻐려 막 퍼저뿐다	가꾸면 어떻게 되냐 가꾸면 여름철엔 그냥 모내 팽창해 버려 막 퍼져 버린다
인구가 얼마 퍼전냐 지금 인구가 지구상에 인구가 얼마나 퍼저서	인구가 얼마나 퍼졌냐 지금 인구가 지구상에 인구가 얼마나 퍼졌어
근데 인구가 그냥 그러케 퍼저나가면 안되거든	그런데  인구가 그냥 그렇게 퍼져나가면 안 되거든
그 뭐냐 여르미 가면 뭐냐 가을처리 온다 마리야	그 뭐냐 여름이 가면 뭐냐 가을철이 온단 말이야
가을처레 오먼 어트게 사냐 비여 전부 추수해야 돼	가을철에 오면 어떻게 사냐 베 전부 추수해야 돼
근데 봄처레는 하 하눌끼우니야	그런데 봄철에는 하늘 기운이야
하눌끼우네 너이 다른 건 몰라도 마눌거튼 거 마눌건나 땅에다 안 시머도 저 다라꺼튼 데 놔도동지가 지나먼 동지는 서따리야 동지딸 동지딸 지나먼 동지에 이량이 시생이라는 거야	하늘 기운에 너희 다른 건 몰라도 마늘같은 거 마늘같은 건 땅에다 안 심어도 저 다락같은데 놔도 동지가 지나면 동지는 섣달이야 동짓달 동짓달 지나면 동지에 이량이 시생이라는거야
이 너이드란텐 이 드끼 어려운 얘기들	이 너희들한텐 이 듣기 어려운 얘기들
동지 이량이 시생이야	동지 이량이 시생이야
동지가 되먼 양이 하나 나온다	동지가 되면 양이 하나 나온다
양은 뭐냐 기운	양은 뭐냐 기운
양이 나오먼 뭐야 요 곡씨게서 누니 터	양이 나오면 뭐야 요 곡식에서 눈이 터
기겐 동지가 지나먼 벽 다라꺼튼 데 마눌두 얼렁 싱거야 마누리야	그러니까 동지가 지나면 벽 다락같은 데 마늘도 얼른 심어야 하는 것이 마늘이야
마눌 두먼 마누리 삐주커게 싸기 나와	마늘 두면 마늘이 삐죽하게 싹이 나와
그르먼 봄처레는 싸기 나오는 거고 여름처렌 길르는 거란 마리야	그러면 봄철에는 싹이 나오는 거고 여름철엔 기르는 거란 말이야
길러 팽창해 맘껃 팽창해	길러 팽창해 맘껏 팽창해
그러지아느면 그냥이면 지구가 터저뻐려	그러지 않으면 그냥이면 지구가 터져 버려
지구 터지먼 안되지	지구 터지면 안 되지
겐 거기선 또 감축시켜야 된다 마랴 쭈려야 된다구	그러니까 거기선 또 감축시켜야 된단 말이야 줄여야 된다고
쭈리는데 뭐냐 전부 인제 베 거튼 건 무꺼 아니 비어	주리는데 뭐냐 전부 이제 벼 같은 건 묶어 아니 베어
비머는 비머는 전부 무꺼 전부 무꺼서 이러케 노먼	베면 베면 전부 묶어 전부 묶어서 이러케 놓으면
지금 당이 언마나 무슨 당 무슨 당 무슨 부 무어 민주당 공화당 무슨 당 자유당 무슨 당	지금 당이 얼마나 무슨 당 무슨 당 무슨 부 뭐 민주당 공화당 무슨 당 자유당 무슨 당
저 전부가 무껴저 이서	저 전부가 묶여져 있어
근데 무껴지는 건만 문제가 아니라	그런데 묶여지는 것만 문제가 아니라
보 보메는 보메는 양에 기우니 셔가지고 싸기 나니껜 양은 뭐야 남자라 마래찌	보 봄에는 봄에는 양의 기운이 세가지고 싹이 나니까 양은 뭐야 남자란 말이지
남자 세려기 커 해가 불끈 소사올르는 그때 아침나저리야 양에 기우니 셔	남자 세력이 커 해가 불끈 솟아오르는 그때 아침나절이야 양의 기운이 세
여르메는 키 키우는 건 땅에 땅에 시므니 어머니가 키운다 마리야	여름에는 키 키우는 건 땅에 심으니 어머니가 키운다 말이야
기겐 남자 기우는 어느정도 업서지고 어머니 세려기 아이 자식 나으머는 엄마 하구 젇빠라먹지아부지 젇빠라멍나	그러니까 남자 기운은 어느 정도 없어지고 어머니 세력이 아이 자식 낳으면 엄마 하고 젖빨아먹지 아버지 젖 빨아먹나
근데 남녀가 해따가 내 저번날 내 겨론을 가지구 얘기 해짜나	그런데 남녀가 했다가 내 저번날 내 결혼을 가지고 얘기했잖아
처멘 실랑이 나이가 어리구 신부는 나이가 망쿠 나중에 그다으멘 비슫비스하다 지그믄 실랑은늘꾸 신부는 정꾸 나이가 저꾸 하다구	처음엔 신랑이 나이가 어리고 신부는 나이가 많고 나중에 그 다음엔 비슷비슷하다 지금은신랑은 늙고 신부는 젊고 나이가 적고 하다고
오후가 되머는 해 해의 시믄 빠저뻐려	오후가 되면 해 해의 힘은 빠져버려
인제 저녀기 됭겐 그림자가 인는 거야 그림잔 뭐야 으미야 으믄 누구야 여자야	이제 저녁이 되니까 그림자가 있는 거야 그림자는 뭐야 음이야 음은 누구야 여자야
지 지그믄 아들보덤 저 따리 더 조태	지 지금은 아들보덤 저 딸이 더 좋대
이와 가튼 이치가 이건데 바로 여기가 그 이치가 인는 거야 그 이치가 여그가	이와 같은 이치가 이건데 바로 여기가 그 이치가 있는 거야 그 이치야 여기가
그르니 어니 나라든지 이거 아프룬 우리 항구게 우리 조서네 지배 안 받는 나라가 업서	그러니 어느 나라든지 이거 앞으론 우리 한국의 우리 조선의 지배 안 받는 나라가 없어
선생구기 돼 다 도라다니머 지금 영어 가르키듣 우리 한국싸라미 다 대니먼서 해	선생국이 돼 다 돌아다니며 지금 영어 가르키듯 우리 한국 사람이 다 다니면서 해
나는 볼찌말찌 허지만 우리 지애하구 저 저군 오양허군 충부니 되먼서 교사노르탈꺼야 강사노륻	나는 볼지 말지 하지만 우리 지애하고 저 저기 오양하고는 충분히 되면서 교사노릇할 거야강사 노릇
게 마리 이서 해방되고 난 대메 저 내가 연배글 가뜨니 무슨 마리냐	그게 말이 있어 해방되고 난 다음에 저 내가 연백을 갔더니 무슨 말이냐
아 이러구 살 수 인나 근 무슨 뜨시 일본말 허구 살 쑤 인나	아 이러고 살 수 있나 그게 무슨 뜻이 일본말 하고 살 수 있나
영아캐야 살지 영아기 뭐야 영어 해야 살지	영학해야 살지 영학이 뭐야 영어 해야 살지
영아커먼 사나 살래야 살지	영학하먼 사나 살래야 살지
내 그 얘기 드꾼 지금도 그 얘기가 생생해	내 그 얘기 듣곤 지금도 그 얘기가 생생해
이러구서 일본말 하구 살 수 인나 영어 해야 살지 영어 허먼 사냐 살래야 살지	이러고서 일본말 하고 살 수 있나 영어 해야 살지 영어 하면 사냐 살래야 살지
그 살래는 누가 살래냐 천지에서 내려주는 그 운명	그 살래는 누가 살래냐 천지에서 내려주는 그 운명
세상사리가 다 이래 뜨시 메씨나 돼찌 아우	세상살이가 다 이래 뜻이 몇 시나 됐지 어우
