dialect	standard
그게 에 가스미 가스미 갱장이 이 빠개저 나가능 거그치 아품니다	그게 에가슴이 가슴이 굉장히 이 빠개져 나가는 것같이 아픕니다
심장이 발 발짜글 하고	심장이 발작을 하고
그개 저 심근경새기라구 하능 거연나부내요	그게 저 심근경색이라고 하는 거였나 보네요
그르치요	그렇지요
싱근 영새기지요	심근경색이지요
으 경새긴데	심근 경색인데
그 인재 츠매 발짜걸 해따가 낭중앤 자꾸 더해 가주고 세 번챈 대수술를 해야된다 고라더라고요	그 이제 처음에 발작을 했다가 나중에 자꾸 더 해 가지고 세번째는 대수술을 해야 된다고 하더라고요
그래가주구 이 가스물 요래 뚝빠개짜너요	그래가지고 이 가슴을 이렇게 쭉 빠갰잖아요
포가 나지요	표가 나지요
아아	아
이 월개 예예	예예
포가 나지요	표가 나지요
여 요까지 다 이 아주 여러노코 핻 항 거요	여 요기까지 다 이 아주 여러 놓고한 거예요
그러먼 이 피쭈럴 여길 뺌미다 요거	그러면 이 핏줄을 여기를 뺍니다 요거
이댄 피쭈럴 혈가널 빼 가주고	이 댄 핏줄을 혈관을 빼 가지고
요기 빼구 요 요기서 여기 이 다 빼구	여기 빼고 요 요기서 여기 이 다 빼고
요까지 요거 다 뺌미다	요기까지 요거 다 뺍니다
다 빼요	다 빼요
가따 이서 농 거지요	갖다 이어 놓은 거지요
허허	허허
그래 살고 이찌요 지금	그래 살고 있지요
허허	허허
그래두 의수리 조아서	그래도 의술이 좋아서
에에 그래요 의수리 조아서	예 그래요 의술이 좋아서
다 중는다 그래쬬 뭐 그때는	다 죽는다 그랬지요 뭐 그때는
그개 저 혈과니 이르캐 오 쪼라드러 가주구 그렁 거자나요	그개 저 혈관이 이렇게 졸아들어 가지고 그런 거잖아요
피가 안 통해서	피가 안 통해서
그르쵸 안 통하조	그렇지요 안 통하지요
안 통해 가주구 인재	안 통해 가지고 이제
그 수술할라구 들먼 그 이 저	그 수술하려고 들면 그 이 저
심장	심장
심장이 이 피쭈머니 아니유	심장이 핏주머니 아니요
팍팍팍하는대 그 피 팍팍팍 가능 기 지그먼 다 나타남니다	팍팍팍하는데 그 피가 팍팍팍 가는 게 지금은 다 나타납니다
아주 저기	아주 저기
현대시그로 대 이써 가주구	현대식으로 되어 있어 가지고
아주 수수라능 기 다 보이두룩 그르캐 대이찌요	아주 수술하는 게 다 보이도록그렇게 되어 있지요
그 하라부지 태어나셔서부터 지금까지 사라오신 내려개 대애서 한 번 얘기 줌해주새요	그 할아버지 태어나셔서부터 지금까지 살아오신 내력에 대해서 한번얘기 좀 해 주세요
머 하이튼 얜날 얜나래 놀등 거 머 칭구들 머 머하구 이렁 거	뭐 하여튼 옛날옌날에 놀던 거 친구들 뭐 뭐하고 이런 거
예예	예
그렁	그런
하이튼 머 하실 말씀 인능 거 다 한 번 얘기해 줘 보새요	하여튼 뭐 하실 말씀있는 거 다 한 번 얘기해 줘 보세요
그렁건 머 얘기할 쑤 있지요	예 그런 건 뭐 얘기할 수 있지요
나는 인재 이 지배서 태어난 사라밈미다	나는 이제 이 집에서 태어난 사람입니다
이 지배서	이 집에서
에 이 지배서 태어나꾸	에 이 집에서 태어났고
이 아주 초갇찌비써써요 지비 옌나래	이 아주 초갓집이었어요 집이 옛날에
아주 초가찌비고	아주 초갓집이었고
이 집 이 뜨러기 한 질 댐니다	어 이 집 이 뜰이 한 길 됩니다
한 질	한 길
그런 초가찌배 사라서 살민성 태어난 사라미요 내가	그런 초갓집에 살아서 살면서 태어난 사람이에요 내가
그런대아번님깨서 일찌기 도라가시찌요	그런데 에 아버님께서 일찍이 돌아가셨지요
그라구 이재 어먼님하구 인재 눈님덜 둘 인재 동생 한 사람	그리고 이제 어머님하고 이제 누님들 둘 동생 한 사람
그래 나아고 고래 사남매가 여기서 사라찌요	그 나하고 그렇게 사남매가 여기서 살았지요
그런 쪽 머 여기두 옌나래 아주 초님미다	그런 죽 뭐 여기도 옛날엔 아주 촌이었습니다
아주 초니니까 머	아주 촌이니까 뭐
그냥 농사진는 초니니까	어 그냥 농사짓는 촌이니까
읻 나무도 지개로 저다가 사내 가서 저다가 불 때 가밍서 밥패먹꼬 살고	이 나무도 지게로 져다가 산에 가서 져다가 불 때 가면서 밥 해 먹고 살고
그래 살다보니까 결구건 어디 나가본 대두 우꼬	어 그래 살다 보니까 결국은 어디 나가 본 데도 없고
그 일찌기 도러가셔쪼	그 일찍이 돌아가셨지요
아번니미 나 스물한 살 때 도라가시쓰니까	아버님이 나 스물한 살 때 돌아가셨으니까
머 내가 다 인재 에 집 채기멀 맏따시피 하고 사라끼 때미내	내가 다 이제 에집 책임을 맡다시피 하고 살았기 때문에
여기 내려근 대주 대충 다 암니다	여기 내력은 대충 대충 다 압니다
그러면 하라번니미 장나미싱가요	그러면 할아버님은 장남이신가요
내가 장 장나민대 눈님덜 두리꼬	내가 장 장남인데 누님들 둘 있고
동생은대정가 살다 삼년 저내 주거써요	동생은 대전에 가서 살다가 삼년전에 죽었어요
나보다 먼저 주거찌요	나보다 먼저 죽었지요
그러면 누님드른뇨	그러면 누님들은요
누님드런 인재 지금 사라 개심미다 두 분 다	누님들은 이제 지금 살아 계십니다 두 분 다
한 부넌그르닝깨 팔씹 여서시지요	한 분은 에 그러니까 팔십여섯이지요
둘째 누니먼 팔씹 섿	둘째 누님은 팔십 셋
그 나는 팔씹	나는 팔십
내 동생은 세 살 터우리조	내 동생은 세 살 터울이지요
그르닝깨 내 동상언 칠씨빌곱 지금 사라 이쓰먼	그러니까 내 동생은 일흔일곱지금 살아 있으면
그럼 누님뿐드른 어디 사세요	그럼 누님분들은 어디 사세요
한 부넌	한 분은 에
츠매넌 인재 요 백짜릴리라고 요 가까운대로 시집벌 간는대	처음에는 이제 요기 백자리리라고 요기 가까운 데로 시집을 갔는데
에 지그먼 인재 사능 거넌 저 청주 가 살구 이써요	에 지금은 이제 사는 건저기 청주에 가서 살고 있어요
청주	청주
청주애 내가 따리 한 따리 딱 하난대	청주에 내가 딸이 한 딸이 딱 하난데
따라나하구	딸 하나 하고
고고 아더리 또 두째 아더리 고가 살고 이끼 때매	그그 아들이 또 둘째 아들이 거기에 살고 있기 때문에
거기서 살구 이찌요 지금	거기서 살고 있지요 지금
그라구 인재 자근 누니먼 요 청사니라카는대 살고 이꼬요 지금	그러고 이제작은 누님은 여기 청산이라고 하는데 살고 있고요 지금
청산	청산
다 정정하시구요	다 정정하시고요
근대 지금 다 정정하지 안치요	그런데 지금 다 정정하지 않지요
기도 어두꼬	귀도 어둡고
또 모미 다 조털 아나조	또 몸이 다 좋지 않지요
그르캐	그렇게
또 자근 누니먼 허리가 이 꼬보랑 함니다	또 작은 누님은 허리가 꼬부랑 합니다
머 좀 환자 테기지요 머	뭐 좀 환자 같지요
가끔 이르캐 만나시거나	가끔 이렇게 만나시거나
만내지요	예 만나지요
일려내 한 번 쓰건 만내고	일년에 한 번 씩은 만나고
두 번두 만내기두 하고 만내지요	두 번도 만나기도 하고 만나지요
절물 절물 때 가치 클 때보다 더 요새 만나면 더 새록새로 카지시요	젊은 때같이 클 때보다 더 요새 만나면 더 새록새록하시지요
그르치오	그렇지요
근 머 참 늘거갈쑤록자꾸 만내쓰먼 하는대	그건 뭐 참 늙어갈수록자꾸만났으면 하는데
자주 몸 만내지요 더 옌날보담	자주 못 만나지요 더 옛날보다
인재 나이 머꾸 이라닝깨 점점 더 몸만내요	이제 나이 먹고 이러니까 점점 더못 만나고
일려누 멥뻔씩 만내 써 만내서 하는대	일 년에 몇 번씩 만나서 만나서 하는데
지그먼 인재 활똥려기 즈거저 가주구 와따가따 자주 모타지요	지금은 이제 활동력이 작아가지고 왔다 갔다 자주 못 하지요
그러면 스무 살 스무란 살 이때 선친깨서 도라가시고	그러면 스무 살 스물한살 때 선친께서 돌아가시고
그리구 인잳 농사지싱거요 그럼	그리고 이제 농사지으신 거예요 그럼
그르치오	그렇지요
농사럴 참 여러 가지 해씀니다	농사를 참 여러 가지 했습니다
농사도	농사도
근대 이 농사를 지따 보니까	그런데 이 농사를 짓다 보니까
고 땅이 만치 안초	그 땅이 많지 않지요
여기 땅이 마는대가 아님미다	여기 땅이 많은 데가 아닙니다
아주 살기가 어려운지여기여써요	아주 살기가 어려운 에 지역이었요
그래서	그래서
이 그라고 옌나래 지금도 마창가지지만	이 그리고 옛날에는 지금도 마찬가지지만
이 농사질 땅이 여기 저기 이래 부터이씀니다	이 농사질 땅이 여기 저기 이렇게 붙어 있습니다
그라먼 이 지개로거러멀 저다가	그러면 이 지게로 에 거름을 져다가
버 가주고 그 누멀 가주고 인재 에 퇴비 하 해 가주고	부어 가지고 그 놈을가지고 이제 에 퇴비를 해 가지고
농살 지키타보먼 보통 고여기 아니지요	농사를 짓다 보면 보통 고역이 아니지요
그리고 요 땅이 존 지여기 아니애요	그리고 여기 땅이 좋은 지역이 아니에요
토오카질 안씀미다 요개	토옥하질 않습니다 여기
저 잘 안 대지요	잘 안 되지요
곡씨기	곡식이
그래두 이 농사꺼리는 머 만치도 앙코 이래서	그래도 이 농사거리는 뭐 많지도 않고 이래서
여러 가지 농살 지바찌오	여러 가지 농사를 지어 봤지요
바태는 담배도 싱가 보고	밭에는 담배도 심어 보고
인삼도 해 보고	인삼도 해 보고
머 이 채소장물도 해 보고	뭐 이 채소 작물도 해 보고
별걸 다 해바써	별 걸 다 해봤어
근대 팔로가 조칠 안치요 여긴 또	그런데 판로가 좋질 않지요 여긴 또
그릉 건 옌나래	그런 건 옛날에 음
에 인재 옌나랜 경웅기 이렁 개 나와 가주 인재	에 이제 옛날에 경운기 이런게 나와 가지고 이제
경웅기로도 가따 팔고	경운기로도 가져다 팔고
그 아주 옌나래넌 소나 이렁 걸로 씨르다가 팔든지	그 아주 옛날에는 소나 이런 걸로 실어다가 팔든지
지개루 저다 파라야 대요	지게로 져다 팔아야 돼요
그라고 인재 여기 장이 여기도 장언 슴미다	그러면 이제 여기 장이 여기도 장은 섭니다
그걸 인재 여러 군대 갈라먼	그걸 이제 여러 군데를 가려면
여기 세군대 장언 갈 쑤가 이써요	여기 세 군데 장은 갈 수가 있어요
세 군대	세 군데
영동 장	영동 장
영동 장이 잴 크지요	영동 장이 제일 크지요
항간 장	황간 장
청산 장	청산 장
인재 여기 장이 스니깨 여기 장 보고	이제 여기 장이 서니까 여기 장 보고
그렁 걸 맹그러노먼 그르캐 도라 댕기민 파라야 대요	그런 걸 만드러 놓으면 그렇게 돌아 다니면서 팔아야 돼요
그으	그
그 수아기 별로요 일려내	그 수확이 별로요 일 년에
사라온 내여걸 얘기해 보머뇨	살아온 내역을 얘기해 보면요
농토는 얼마나 대션는대요	농토는 얼마나 대셨는데요
농토는약 한 전채애서 한 이천 평 정도 부처 보고	농토는 약 한 전체에서한 이천 평 정도 부쳐 보고
그래 아드리 여러시니까 자꾸 학삐애 파라머거야 대요	그래 아들이 여럿이니까자꾸 학비에 팔아먹어야 돼요
그래 자꾸 줄과찌요 머	그래서 자꾸 줄였지요 뭐
그 학삐럴 점부 내고 학 공부시켜씀니다	그 학비를 전부 내고 학 공부시켰습니다
한 사람도 혜택뽄 니리 업써요	한 사람도 혜택본 일이 없어요
수업뇨 다 내야 대고	수업료 다 내야 되고
기성해비 다 내야 대고	기성회비 다 내야 되고
머 일리리 다 내가민성 공부 시키찌요	뭐 일일이 다 내가면서 공부를 시키지요
그래 대학교 한 사람배깨 모 시키써요	그래 대학교 한 사람밖에 못 시켰어요
그라고점부 고동학꾜 중학꾜애 끈마 끈마치기도 하고	그리고 에 전부 고등학교 중학교 끝마 끝마치기도 하고
그런 곡씨글 시물 때 제일 그래도 수하기 마능 개 어떵거여써요	그런 곡식을 심을 때 제일 그래도 수확이 많은 게 어떤 거였어요
도우미 마니 댕거	도움이 많이 된 거
수하기 마이 댕거넌 그래두 잘 지먼 인사미 잴 나찌요 머	수확이 많이 되는것은 그래도 잘 지으면 인삼이 제일 낫지요
그라고 인재 담배가 땅거보담 수하기 좀 나닝까	그리고 이제 담배가 다른 것보다 수확이 좀 나으니까
이 건조시래 옌날 걸조시런 이 흐그로 싸 올린 흑뼉	이 건조실에 옛날 건조실은 흙으로 쌓아 올린 흙벽
거기 그렁 기 건조시림니다	거기 그런 게 건조실입니다
지그먼 인재 다 이 기개 건조시리지요	지금은 이제 다 이 기계 건조실이지요
그른대 에 그 두 개까지도 가지구 담배 농사두 해 바써요	그런데 에 그 두개까지도 가지고 담배 농사도 해 봤어요
근대 인삼 농사넌 그 한 심년 해써요 인삼 농사럴	그런데 인삼 농사는 한 십년 했어요 인삼 농사를
인삼 농산 참 그거는 어렵씀니다	인삼 농사는 참 그것은 어렵습니다
인삼 농사	인삼 농사
이 땅얼 일련 간 무커야 대요	이 땅을 일년 간 묵혀야 돼요
거 인삼 거르멀 할라먼	인삼 거름을 하려면
아주 그개 옌나랜	아주 그게 옛날엔
그라고 옌나래 한시보 년 저내 잉삼 농살 해써요	그리고 옛날에 한 에십오 년 전에 인삼 농사를 했어요
그때만 해도 지금 인삼 농사하고 다름니다 지그먼	그때만 해도 지금 인삼 농사하고 다릅니다 지금은
그때넌 푸럴 해다가 바태다 까라 가주구 소로 가라 가주 디지버 가주구 그걸써쿰니다	그때는 풀을 해다가 밭에다 깔아주고 소로 갈아 가지고 뒤집어 가지고그걸 썩힙니다
그 저 가랑닙꺼틍 걸 이렁 걸	그 저 가랑잎 같은 걸 이런 걸
인삼 농사진능 건 보시쓸 끼여 더러 교순님도	인삼 농사 짓는 건 보셨을 거야 더러 교수님도
그르캐 하며넌 그 심 년쭈건 해야지	그렇게 하면 그 십 년쯤은 해야지
그래도 그 수하걸 재대로 볼 쑤가 이써요	그래도 그 수확을 제대로 볼 수가 있어요
그 짜료럴 안 내뿌릴라만	그 재료를 안 내버리려면
그래 가주구 이기 씨럴 일련 키와야지요	그래 가지고 이게 씨를 일 년 키워야지요
그래 또 사년	그래 또 사년
지금 여긴 융년근 농사 여가내 안 진 몯 찜니다 여기는	지금 여긴 육년근 농사여간해서 안 짓 못 짓습니다 여기는
융년그니야 거 홍삼이죠	육 년근이야 홍삼이지요
근대 인재 여기는 뱅싸무루 다 파라야 댐니다	그런데 이제 여기는 백삼으로 다팔아야 됩니다
그라먼 그기 에 얼매 걸리나먼 융 년 걸림니다	그럼 그게 얼마나 걸리느냐하면육 년 걸립니다
융 년	육 년
융 년 걸리고 함 번 딱카먼 전부 소냄니다	육 년 걸리고 한 번 딱 하면 전부손해입니다
한 번만 암만 자래따캐도 소내여	한 번만 아무리 잘 했다고 해도 손해야
자료드러강 기개	재료 들어 간 게
근대 이걸 오래하고 수이벌 좀 더 볼라먼	그런데 이걸 오래하고 수입을 좀 더보려면
게소캐서 연자걸 해야 대넝 거여	계속해서 연작을 해야 되는 거야
게소캐서	계속해서
근대 그거뚜 또 여 여유치 아눕띠다	그런데 그것도 또 여의치 않습디다
그래서 한 심년 간 따카고 마라찌요	그래서 한 십 년간 딱 하고 말았지요
하라부지는 여기서 나서 여 이지배서 나셔서 이지배서 쭉 사셔꼬	할아버지는 여기서 나서 이 집에서 나셔서 이 집에서 쭉 사셨고
그개 그르니까 팔씸 년 여기서 사션내요	그게 그러니까 팔십 년 여기서 사셨네요
그르쵸	그렇죠
지금 연새애	지금 연세에
왱기지 아낟씀니다	옮기지 않았습니다
연새가 여드니라고 하시니까	아 연세가 여든이라고 하시니까
그 잔나비띠라고 그러셔쬬	그러니까 잔나비띠라고 그러셨죠
그러고 인재 크싱거뚜 여기서 크셔꾸 그지요	그리고 크신 것도 여기서 크셨고그렇지요
그러쵸	그렇죠
학꾜는	학교는
학꾜는 지금 여 구령초동학꾜가 인넌대 저 용산초동학꾤 댕기써요	학교는 지금여기 구룡 초등학교가 있는데 저 용산 초등학교를 다녔어요
그기 잴 먼저 설리비 대떤 학꾜요 여기넌	그게 제일 먼저 설립된 학교요 어기는
그때는 이르미 머여써요	그때는 이름이 뭐였어요
그때 그때도 동수리지요 사묻	그때도 동술이지요 사뭇
아니 학꾜 이름	아니 학교 이름
학꾜 이름	학교 이름
용산궁민학꾜요	용산 국민학교요
그때 용상궁민학꾜라캐요	그때 용산 국민학교라고 해요
일쩡 때	일정 때
진 학꾜니까	지은 학교니까
그러면 그때 면년 간 다니셔써요	그러면 그때 몇 년 간 다니셨어요
융 년뇨	육 년이요
융 년	육 년
융 녀니지요	육 년이지요
그러면 일째때 그말기나요 일째	그러면 일제 때 그 말기였나요 일제
일째 말기죠	일제 말기죠
일째 말기	예 일제 말기
오 오항년까징 거기서 다니고	오 오학년까지는 거기서 다니고
인재 참 저 일 일쩡 교유걸 바꼬	이제 참 저 일 일정 교육을 받고
일항 이래 일항년만 거 유캉년 때만항글 배우고	에 일학 일학년만그 육 학년 때만한글 배우고
조러블 해찌요	졸업을 했지요
그때는 그러면 나이가 어느 쩡도 대쓸때 다녀써요	그때는 그러면 나이가 어느 정도 됐을 때 다녔어요
그때는 연새분 드신분들도 다니고 막 그래따 그래대요	그때는 연세분 드신 분들도 다니고 막 그랬다 그러대요
그러쵸	그렇죠
장개 간 사람도 다니써요	장가 간 사람도 다녔어요
장개간 사람도 가치 다녀써요	장가 간 사람도 같이 다녔어요
하라번니문 그때 연새가 어어	할아버님은 그때 연세가
그링깨 드러갈 째 아옵쌀 때 드러간나요	그러니까 들어 갈 적에 아홉 살 때 들어갔나요
아홉 쌀 때	아홉 살 때
옌나랜 지금가치 머 일곱 쌀 여서 쌀로 아나죠	옛날엔 지금같이 뭐 일곱 살여섯 살로 안 하지요
더 느깨 가지요	더 늦게 가지요
초동학꾜	초등학교
그리구 나서 그럼 학꾜 마치구서는	그리고 나서 학교 마치고서는
학꾜 마치고부터먼 농사일 해쬬	학교 마치고부터는 농사일 했지요
농사	농사
농사일	농사일
농사일 하다가 하하 유기오 사벼니 나 가주 인재	농사일 하다가 하하 육이오사변이 나가지고 이제
구닌 가따 오고	군인 갔다 오고
전쟁언 아내씀니다	전쟁은 안 했습니다
유기오 때는 그럼 어트개 지내셔써요	아 육이오 때는 그럼 어떻게 지내셨어요
유기오 때 그 유기오가 이	육이오 때 그 육이오가 이
용사니 여기 전장텀니다	용산이 여기가 전쟁터입니다
진짜 여 아주 빽쩌늘 한 대요	진짜 여기 아주 백전을 한 데요
요거 아주 유명한 댐니다	요기가 아주 유명한 데입니다
옌날부터 이 전장이 부터따하먼	옛날부터 이 전쟁이 붙었다 하면
전장하문서 치르는 니 동내라고 그라는데	전쟁하면서 치르는 이 동네라고 그러는데
여 사람 마이 주거써요	여기 사람이 많이 죽었어요
인임군도 마이 죽꼬	인민군도 많이 죽고
여 미군두 와서 여기 주두내 가주고 전장한 대요	여기 미군도 와서 여기에 주둔해 가지고 전쟁한 데요
미군 여 유기오 때 츰	미군 여기 육이오 때 처음
저 대전하고	저 대전하고
대전서 전장하고 나면 여기 에 진찌 구추캐 가주구 여기 와서 전장한 대요	대전에서 전쟁하고 나면 여기 에 진지 구축해 가지고 여기 와서 전쟁한 데요
그래서 전장이 이러나니까 머 피라늘 앙 갈 쑤가 업쬬	그래서 전쟁이 일어나니까 뭐 피란을 안 갈 수가 없지요
그 피라널 알루 니리간다능 기 가다 가다가 저	그 피란을 아래로 내려간다는 게 가다가 가다가 저
성조 그러닝깨 낙똥강	성주 그러니까 낙동강
지금 저 왜 왜간 거 다리 끄너전 그 다리	지금 저 왜 왜관 거기 다리 끊어진그 다리
그걸 모껀내 가고 우린 대로 올라와쬬	그걸 못 건너가고 우린 도로 올라왔지요
저녕 거 내리가다봉깨 그 머 차다니 대 가주구 모까개 하니 머 할쑤 웁쬬	저녁 거 내려가다 보니까 그 뭐 차단이 돼 가지고 못 가게 하니 뭐 할 수 없지요
그래 다시 올라와 가주	그래 다시 올라와 가지고
그른대 지내다가	근데 지내다가
해복 참 저구닌더리 인재 우리 국꾼더리 이 올라와 가주	회복 참 저 에군인들이 우리 국군들이 이 올라와 가지고
그냥 그대로 살다가 이재 정시그로 가는 군대로 가쬬	그냥 그대로 살다가 이제 정식으로 가는 군대로 갔죠
제주도 가서 훌려는 바꼬	제주도 가서 훈련은 받고
그 그 유기오 때 얘기 줌 해줘 보새요	그 그 육이오 때 얘기 좀 해줘 보세요
그때 상황이 어땐는지	그때 상황이 어댔는지
상항언 여기 아주 시만 전투럴 한대라나서	상황은 여기 아주 심한 전투를 한데라놔서
이 부리 싹 이 동내가 싹 타써씀니다	이 불이 싹 이 동네가 싹 탔썼습니다
싹 타고	싹 타고
그 가따 오는 온 그 결과를 쪼꿈 얘기해 보먼	에 그 갔다오는 온 그 결과를 조금 얘기해 보면
지금 저 심무내 노근니라고 마이 나오지요	지금 저 신문에 노근리라고 많이 나오지요
노근니 사꺼니라고	노근리 사건이라고
예예예	예
이재 우리가 피란갈 때는 저짜그로 이래 도라서 철 첟 천 천날 피라넌 여덕찐동이라는대 가서 피라늘 하고 하루찌녁 자고	음 이제 우리가 피란갈 때는저쪽으로 돌아서 철 첫 첫날 피란은 여기 덕진동이라는 데 가서 피란을 하고 하루저녁을 자고
발쌔 막자꾸 인재 후태해 내리오고 이라는대 그거럴 참 기가 매킨 꼴두 보지요 우리	벌써 막 에 자꾸 이제 후퇴해 내려오고 이러는데 그거를 참 기가 막힌 꼴도 보지요 우리가
이재 이 덕찐가서 막 피란 하루찌녁카는대 임민구니 막 선발 때 와써요	이 덕진 가서 막 피란을 하루 저녁을 하는데 인민군이 막 선발대 왔어요
그 덕찐동이라는대 와써요 와써	그 덕진동이라는 데 왔어요 왔어
그래 막 지내가고 이써요 아패	그래 막 지나가고 있어요 앞에
피란미니랑 가치 지내가능 거 우리가 모껴글 하고 봐써요 우리	피란민이랑 같이 지나가는 것을 우리가 목격을 하고 봤어요 우리가
그래도 어트감니까	그래도 어떻게 합니까
자꾸 피라늘 갈 쑤배끼	자꾸 피란을 갈 수밖에요
전장은 여기서 안 안즉 아나는대	전쟁은 여기서는 안 아직 안 하는데
이재 그라고차차차차 찬차이 니리가능 거지요	그리고차차차차 천천히내려가는 거지요
우리넌 거러서	우리는 걸어서
소도 함 마리 몰고 가지 아들 등애 어꼬 지고	소도 한 마리 몰고 가지 아들등에 업고 지고
인재 그때마내두 뭐인재 초동하꾜 재우 조러파고 구닌 갈 나이는 대쓰니까	이제 그때만 해도 뭐이제 초등학교 겨우 졸업하고 군인 갈 나이는 됐으니까
머 질머지구 댕기고 아들도 가치 막 질머지고 이래 내리가찌요	뭐 짊어지고 다니고 아이들도 같이 막 짊어지고 이렇게 내려갔지요
그래 인재 우리 니리갈 때 막 점부 여기 에 전장 준비함니다	그래 이제 우리내려갈 때 막 전부 여기 에 전쟁 준비합니다
그링깨 여기넌 전장터니까	아 그러니까 여기는 전쟁터니까
야포넌 바 저 요 너매 당지그튼대 저 항간그튼대 가따포진찌 차려 노코	아 야포는 저 요 넘어 당지 같은데 저 황간 같은 데 가져다 포진지를 차려놓고
우리가 인재 전쟁하능 걸 보구 내리가능 거여 막	우리가 이제 전쟁하는 걸 보고 내려 가는 거요 막
여기 전장하넝 걸	여기 전쟁하는 걸
이 우리우리 아구니 구꾸니 포 쏘능 기 보임니다	이 우리우리 아군이 국군이 포 쏘는 게 보입니다
보이고 가서 떠러지넝 거뚜 보이고	보이고 가서 떨어지는 것도 보이고
폭파라넝 거또	폭발하는 것도
그리구 우리가 인재 자꾸 피라늘가야 살쌍부르닝깨 자꾸 내빼지요 머	그리고 우리가 자꾸 피란을 가야 살 것 같으니까 자꾸 내빼지요 뭐
그 여기서 사밀 가닝가 오 오일 간 해따카등가	그 여여기에서 삼일 간인가오 오일 간 했다고 하던가
사밀 간 해떤지 기어개 아삼푸리하내요	삼일 간 했던지 기억이 아슴푸레하네요
그래 전장얼 여기서 하고 인넌대 자꾸 니리가지요	그래 전쟁을 여기서 하고 있는데 자꾸 내려가지요
니리가서 니리가다가 인재	내려가서 내려가다가 이제
자꾸 그 인밍군드리랑 가치 니리가능 거요	자꾸 그 인민군들이랑 같이 내려가는거요
우리가 선발때랑	우리가 선발대랑
전장언 인재 여기서 하고 이꾸	전쟁은 이제 여기서 하고 있고
그래 우린 자꾸 니리가문	그렇게 우리는 자꾸 내려가면
그 총 미구 가능 기 바매넌 마리요	그 총 메고 가는 게 밤에는 말이야
그 완전 그 인밍군 푸른 복짱하구두 니리가요	뭐 완전 그 인민군 푸른 복장하고도 내려가요
가덜	걔들이
그래두 그 몯 몯 모짜바요	그래도 그 못 못 못 잡아요
가치 거러난자덜하곤 전장얼 아내요	같이 걸어가는 자들 하고는 전쟁을 안해요
가문서 자꾸 내리가기만 하지	가면서 자꾸 내려가기만 하지
그 인재 낭중애 인재 며칠 한 사밀 가닝가	그 이제 나중에 이제 며칠 한 삼일간인가
자꾸 니리가다 봉개	자꾸 내려가다 보니까
저 성주라는대까지 가써요	저 성주라는 데까지 갔어요
우리가 성주	우리가 성주
인재 피란끼를 자꾸 따라 니리 가능 거지요	이제 피란길을 자꾸 따라 내려 가는거지요
그래 벌써 인재 여긴 전장이 끈나고	그래 벌써 여긴 전쟁이 끝나고
그 인재 낙똥강 전투가 버러전다능 기요	그 이제 낙동강 전투가 벌어진다는거요
그링깨 빡 꽁수벌 하넌대	그러니까 막 공습을 하는데
피란미니 갈 쑤인나요	피란민이 갈 수 있나요
그 철거 막 끄너부렫 끄너재끼고	그 철긴 막 끊어버렸 끊어 젖히고
근대 다시 올라오는 수배끼 어트기요	근데 다시 올라오는 수밖에 어떻게
니리가덜 모다고 다시 올라와쬬	내려가지를 못하고 다시 올라왔지요
다시 올라올 때애는 인재 기름낄로 와쬬	다시 올라올 때는 지름길로 왔지요
기름낄로	지름길로
이 피라널 가따 올라오넌대	이 피란을 갔다 올라오는데
한 사흘 네리가느라고 잠 모짜고	한 사흘 내려가느라고 잠 못 자고
올라오느라구 하루 찌녁 잠 모짜고	올라오느라고 하루 저녁 잠 못 자고
이틀찌녁 잠 자멀 안 자닝깨	이틀 저녁 잠 잠을 안 자니까
거러 오는대도 자미 와요	걸오 오는 데도 잠이 와요
그럼 논뚜렁애 이래 지채가다가 푹 빠지기도 하고	그럼 논두렁에 이래 지나가다가 푹 빠지기도 하고
그런대 가족찌리 가따가 난 지비 하도 궁구매서	그런데 가족끼리 갔다가 난 집이 하도 궁금해서
찬차이 올라오라카고	천천히 올라오라고 하고
미리 미리 미리 올라오는대 그런 꼬럴 보고	미리 올라오는데 그런 꼴을 보고
그 노근니 진짜 구래 사람 주긍 걸 집쩍 모껴캐찌요	그 노근리 진짜 굴에 사람 죽은 걸 직접 목격했지요
참 마이 주거씀니다 거기서	참 많이 죽었습니다 거기서
그 양짝 구래 빡빠카개 주거가주이꼬 산 날망 삐탈까지	그 양쪽 굴에 빡빡하게죽어 가지고 있고 산 등성이 비탈까지
공수까지 해따카는대요 공수 비행기가	공수까지 했다 하는대요 공수 비행기가
이 사경만 하먼 이짜개 그 굴하고 으 이짜개 보만 사라미 중넌대	이 사격만하면 이쪽에 그 굴하고 에 이쪽에 보면 사람이 죽는데
산나무애서 주거쓰니까	산나무에서 죽었으니까
그 치우아낭 그대로죠	그 치우지 않은 그대로지요
그대로 내가 모껴칸 사라미요	그대로 내가 목격한 사람이요
그라고 지배까지 와 보고	그리고 집에까지 와 보고
지배 오니깨 머 임민 정치 하지요	집에 오니까 뭐 인민군 정치하지요
그때 막 여기 저 좌익 한 사람더리 마니 이짜나요	그때 막 여기 저 좌익한 사람들이 많이 있잖아요
그 사람더리 인재 다 머 이장도 배치가 대이꼬 막	그 사람들이 이제 다 뭐 이장도 배치가 되어 있고 막
정치럴 빨리 하드라고요	정치를 빨리 하더라고요
거 공산당덜 창 기가 매키개 짜구 항 기요	공산당들 참 기가 막히게 짜고 한 거예요
거 유기오 전쟁얼	그 육이오 전쟁을
그런 경허멀 지킬쬬	그런 경험을 지요
유기오 사벼늘	육이오 사변을
그러면 동내는 언재 부리 타써요	그러면 동네는 언제 불이 탔어요
그 일차	그 일차
일차 전장할 때	일차 전쟁할 때
내려갈 때	내려갈 때
그리잉깨 임밍군덜 전장할 때	그러니까 인민군들 전쟁할 때
이 동내럴 싹 태웅 거요 고만	이 동네를 싹 태운 거요 그만
여긷 전차가 두 대 파개가 대씀니다	여기 전차가 두 대 파괴가 됐습니다
임밍군 전차가	인민군 전차가
가드리 직쩝 끌고 옹 거	걔들이 직접 끌고 온 거
그래 다 거러가찌만	그래서 다 걸어갔지만
여 아주 전장 옌날부텀 전장 해따하문 여 전장얼 한담니다 여기넌	여기 아주 전쟁 옛날부터 전쟁 했다하면 여기서 전쟁을 한답니다 여기는
이 상각찌대라 그러탐니다	여기가 삼각지대라 그렇답니다
여가 상각찌대	여기가 삼각지대
저기 저 절라도하고	아 저기 전라도하고
절라도 경상도하고여 상각찌대 아주 이 중심지람니다	전라도 경상도하고 여기 삼각지대 아주 이중심지랍니다
절략쌍으로 그래 대이땀니다	전략상으로 그래 돼 있답니다
그 나두 드른 바지요	그 나도 들은 바지요
그러면 그무려배는 그럼 선친깨서는	그러면 그 무렵에는 그럼 선친께서는
사라 게시쬬	살아 계셨지요
사라 게셔꼬	살아 계셨고
그라구 삼년 후애 도라가시써요	그리고 삼 년 후에 돌아가셨어요
그럼 전쟁끈나자마자	그럼 전쟁 끝나자마나
예애	예
끈난 다매 삼년 후애	끝난 다음에 삼 년 후에
그 이 초가찌비 아주 옌날 초가찌비썬는대	그 이 초가집이 아주 옛날 초가집이었는데
인재 전장하고 와 가주구	전쟁하고 와 가지고
터럴 인재 따꼬	터를 이제 닦고
다시 인재 나추고 이래 가주 으 흑짱얼 내가 바가 가주 집쩍	어 다시 이제낮추고 이렇게 해 가지고 흙장을 내가 박아 가지고 직접
내가 싸 가주구	내가 쌓아 가지고
지벌 지어 지타가 살다가 인재	집을 지어 짓다가 살다가 이제
이 이 집 찐진 그르닝깨 에 팔씹팔련도 오나요	이 이 집 지은 지는 그러니까팔십팔 년도인가요
저 고속또로 나는 나든 해	저 고속도로 나는 나던 해
그래 지쓰요	그렇게 지었어요
고속 경부고속또로가 낭 거는 칠씨비년도 아닝가요	경부고속도로가 난 거는 칠십이 년도 아닌가요
시 시자캉개	시 시작한 게
그를끼오	아 그럴 거요
그른대 애 그리잉깨 인재 경부고속또로이건 거시기 그 그애가 아니구나	그런데 에 그러니까 이제 경부고속도로이건 거시기 그해가 아니구나
새마을운동하고 한참 뒤애	새마을 운동 하고 한참 뒤에
하싣	하신
그 인재 그그쌔 벽똘찌부로 상 거는 인재	그 이제 그 에 글쎄 벽돌집으로산 것은 이제
애 하이간 유기오 전쟁얼 치르고	하여간 육이오 전쟁을 치르고
삼년 이따	어 삼 년 있다가
아주 초가찌번 그래 싹 타뻐린는대	아주 초가집은 그래 싹 타버렸는데
싹 타뻐리닝깨	싹 타버리니까
이 저 딴 저 메찝 이써써요 요	저 저 다른 저 몇 집이 있었어요 요기
요 아느로 메찜 인재 인는 지배 가서 살다가	요기 안으로 몇 집 이제 있는 지베 가서 살다가
지벌 새루 지어 지코 살다가 인재	에 집을 새로 지어 짓고 살다가 이제
이 지번이 지번 한 시보년 십 십칠련 댄나	이 집은 에 한 십오 년 십칠년 됐나
십칠련 저내 진 진 지비요	십칠 년 전에 지은 지은 집이요
새로	새로
그때 머 피란 가고 이러면서	그때 뭐 피란 가고 이러면서
곡씩까틍 거 단지애 너 가주 땅애 무꼬 머 그래때면서요	곡식 같은 거 단지에넣어 가지고 땅에 묻고 뭐 그랬다면서요
무더찌요	묻었지요
그람뇨	그럼요
그른대 이 무든 무더도	그런데 이 묻은 묻어도
이 화 부리나먼 몸몸몸 몸 먹씀니다	이 화 불이 나면 못못못 못 먹습니다
무등 거뚜 몸 머거요	묻은 것도 못 먹어요
왜그러쵸	왜 그렇지요
화근내가 나고	화근내가 나서
그래서 몸 머거요	그래서 못 먹어요
그래 지비 안 타고 이씨야 그개 유지가 대이꼬	그래 집이 안 타고 있어야 그래도 그게 유지가 돼 있고
다른 사라미 암 파머그먼 파 머거도 대도	다른 사람이 안 파먹으면 파 먹어도돼도
이 부리 나서 화재가 나먼 고만 다 몸 먹씀니다 다	이 불이 나서 화재가 나면그만 다 못 먹습니다 다
상 모씀니다	모조리 못 씁니다
아무 거뚜	아무 것도
하나도 건질 깨 업써요 아주	하나도 건질 게 없어요 아주
머글 꺼	먹을 거
땅 쏘개 인는대두요	땅 속에 있는데도요
땅 쏘개 무던는대	땅 속에 묻었는데
땅 쏘개 무터 인는 거뚜 헌니리요	땅 속에 묻혀 있는 것도 헛일이요
몸 머거요	못 먹어요
그러캐돼요	아 그렇게 돼요
몸 머거요	예 못 먹어요
그래두 또 무더 농 거뚜 저 아까 말쓰마신거처럼 머 좌이카는 분들 이런 분들	그래도 또 묻어 논 것도 저 아까 말씀하신 것처럼 뭐 좌익하는 분들 이런분들
다 파 머거요	다 파 먹어요
다 팜 걷	다 파서
다 파 머거찌요	다 파먹었지요
피란 나간 사람꺼넌 다 파 머거요	피란 나간 사람 거는 다 파 먹어요
미리 막 드러 온 사람덜 이런 사람더리	미리 막 들어 온 사람들 이런 사람들이
머글 끼 웁쓰니까요 머	먹을 게 없으니까요 뭐
농사도 그때 한동안 모찌찌머	농사도 그때 한동안 못 지었지요
그르잉깨 파 먹어	그러니까 파 먹어
지배 키우던 짐승두 머 자버 머꼬 그래때면서요	집에 키우던 집승도 뭐 잡아먹고 그랬다면서요
그때는	그때는
짐승두 자바 먹찌요	짐승도 잡아 먹지요
지붕 짐승두 그 나마 인넝 거넌 나마 인넌 사람더리 자바 먹씀니다	짐승 짐승도 그 남아 있는 건 남아 있는 사람들이 잡아 먹습니다
나마 인넝 거 알기만 알먼	남아 있는 걸 알기만 알면
근대 인재 요기넌 전장얼 한 아주 소개럴 한 지여기니까 머	근데 요기는 전쟁을 아주 소개를 한 지역이니까 뭐
더군다나 그런 짐성이 이쓰먼 아무나 자바 머거도 상과니 우꼬	더군다나 그런짐승이 있으면 아무나 잡아 먹어도 상관이 없고
막 자바 머거꼬요	막 잡아 먹었고요
그래두 인재 이 초내넌 일방 피란 해따가 여패 피란 해따가 온 사람더리 이쓰니까	그래도 이제 이 촌에는 일방 피란했다가 옆에 피란했다가 온 사람들이 있으니까
그 그르캐 망 모 짜바 머거찌요 머	그 그렇게 막 못 잡아 먹었지요 뭐
그래서 이 피란 가구 움는 지블 꺼넌 자바 먹찌요	그래서 이 피란 가고 없는집을 거는 잡아 먹죠
그러면 구닌 가싱 거는 유기오가 끈나고 가션나요	그러면 군인 가신 거는육이오가 끝나고 가셨나요
끈나고 가쬬	예 끝나고 갔죠
인재 유기오 사변 그 당시애 간 사람도 마이 이쪼	이제 육이오 사변 그 당시에  간 사람도 많이 있죠
피랑 가서 간 사람도 마니 이꼬	피란 간 사람도 많이 있고
그린대 나넌 유기오 사 사변 다 치리고	그런데 나는 육이오 사 사변 다 치르고
정식 인재 영짱 바다 가주	에 정식 이제 영장 받아 가지고
제주도 가서 육 깨월 간 훌련 바꼬	제주도 가서 육 개월 간 훈련 받고
전방 배치 대가주	전방에 배치가 되어 가지고
구닌 생활 하고 나와쪼	군인 생활 하고 나왔지요
제주도애는 그 저기 모슬포인넌대 거기서	제주도에는 그 저기 모슬포 있는데거기서
그래고	예 그러고
교육빠다	교육받아
모슬포가 그 훌련솜니다	모슬포가 그 훈련솝니다
저이 저이 아버지두 거기서 훌련 하셔따 그래요	저희 아버지도 거기서 훈련하셨다고 그래요
그리고 저이 아버지는 유기오 전투에 참석 참전 하셔꺼든뇨	그리고 제 아버지는 육이오 전투에 참전하셨거든요
참전하시써도 매제일 훌련소 거기 바든 사람더리 마니 이쬬	아 참전하셨어도 뭐 제일 훈련소 거기서 받은 사람들이 많이 있지요
저 이 제이 훌련소 쪼금 낭중애 생깅검니다	제이 훈련소 조금 나중에 생긴 겁니다
저거	저거
그름 군 저기 군대는 어디애서 금무하셔써요	그럼 군 저기 군대는 어디에서근무하셨어요
군대는 전방애 애 이십 싸단 애 육씸 연대 가서 에 한 한 일련 근무하다가	군대는 전방에 에 이십 사단 육십 연대에 가서 에 한 일 년 근무하다가
또 유꾼본부 가서 한 일련 좀더 근무하고 이래 재대해쪼	또 육군본부 가서 한일 년 좀더 근무하고 이제 제대했지요
그 이십 싸다니면 어디에 인능거죠	그 이십 사단이면 어디에 있는 거죠
지그먼 어디 인능가 잘 모르 건내요	지금은 어디에 있는지 잘 모르겠네요
그때넌 이십 싸다니 애 저기 사창니 이써써요	그때는 이십 사단이 에 저기 사창리에 있었어요
사창니	사창리
그래따가 이리저리 왱기 왱기 댕기기두 하구 그래찌요	그랬다가 이리저리 옮겨옮겨 다니기도 하고 그랬지요
그리고 인재 재대하고 지배 오셔쓰꺼 아니애요	그리고 이제 제대하고 집에오셨을 거 아니어요
그르쵸	그렇지요
와쭁	왔지요
그러먼 겨로넌 언재 하셔써요	그러면 결혼은 언제 하셨어요
겨로넌 군대 가기 저내 해씀니다	결혼은 군대 가기 전에 했습니다
군대 가기 저내	군대 가기 전에
가기 저내	가기 전에
스물한 사래 해써요	스물한 살에 했어요
스무살 한 사래	스무 살 한 살에
그럼 할머니 어트개 만나션느대요	그럼 할머니 어떻게 만나셨어요
그르잉깨 중매 겨론 해찌요	그러니까 중매 결혼을 했지요
인재 누니미 중매럴 한태기죠	누님이 중매를 한 턱이지요
누니미 먼저	아 누님이 먼저
누니미 청산 인는대	예 누님이 청산 있는데
인재 이 우리 내자가 여 청산 싸라미요	이 우리 내자가 여기 청산 사람이요
청산 저 청 청사니 아니고	청산 저 청 청산이 아니고
청성	청성
청성면 장수리	청성면 장수리
청성	청성 예
장수리라는 대 사라써요	창수리라는 데 살았어요
그럼 거기서 사시다가 이리 오시구 인재	그럼 거기서 사시다가 이리 오시고
게속 또 여기서 사시능 거내요	계속 또 여기서 사시는 거네요
그르치요	그렇지요
그러먼 저 할머니는 며쌀 때 이리 오셔써요	그러면 저 할머니는 몇 살 때 이리 오셨어요
열려서 쌀	열여섯 살
열려	열여
열려덜 쌀	열여덟 살
세 살 차이지요	세 살 차이지요
그래서	그래서
열려덜 쌀	열여덟 살
조온 함니다 옌나랜	조혼 합니다 옛날엔
옌나랜 조호니지요 다	옛날엔 조혼이지요 다
또 할머니는 그 그쪽 청성애서 거기두 농사 지션나요	또 할머니는 그 그쪽청성에서 거기도 농사지으셨나요
그르쵸	그렇지요
거기도 머 농초니니까 농사찌고 머	거기도 뭐 농촌이니까 농사짓고 뭐
중매는 어트개 해써요	중매는 어떻게 했어요
그거 과정은 아셔요	그거 과정은 아셔요
어트개 누가	어떻게 누가
그쌔 중매넌 인재 애 자근누니미 그 청성며내 살고 이끼 때미내	글쎄 중매는이제 작은누님이 그 청성면에 살고 있기 때문에
그 쪼그로 또 영겨리 자꾸 이래 가까우니까 건	그쪽으로 또 연결이 자꾸 이래가까우니까 그건
동내가 가까우니까	동네가 가까우니까
와따가따 하는 사라미 내지서 가주 중매가 댕 거죠	왔다갔다하는 사람이 내지 서 가지고 중매가 된 거지요
그 그 중매하면 그때부터 어떤 시그로 해써요	그 그 중매하면 그때부터 어떤식으로 했어요
그냥 얘기가 인재 처매	그냥 얘기가 이제 처음에
중매	중매
애 중매하먼 옌나랜 그때 사지니 겨우 젤 사진도 여가내 모 찌거요	에 중매하면 옛날에는 그때 사진이 겨우 제일 사진도 여간해서 못 찍어요
어짜다 찡는 사진 머 쪼매난 증명사진 니	어쩌다 찍는 사진 뭐 조그만 증명사진이
증명은 유기오 사벼 나고 증명이 바루 발그비 대쓰니까	증명은 육이오 사변이나고 증명이 바로 발급이 되었으니까
증명사진 찍끼 위한 거 증명사진 거틍 거 고렁 거배끼 웁써요	증명사진 찍기 위한 그 증명사진 같은 거 그런 거밖에 없어요
초내선 큰 사진 안 찍슴니다	촌에서는 큰 사진 안 찍습니다
큰 사지넌 어꼬	큰 사진은 없고
고렁 걸로 그냥 이래 보고서 과정이 나오죠	그런 걸로 그냥 이렇게 보고서 과정이 나오죠
사전 사진 보고	사진 사진 보고
사진 요고	예 사진 요거
사주나 비키 주고	사주나 보여 주고
에 그라고 인재 에 사주 하지요	에 그리고 에 사주 하지요
사주	사주
약 그래 가주 야콘시기 대능 거죠	그래 가지고 약혼식이 되는 거지요
그거 사주 하먼	그거 사주하면
사주 하능 기 지금 야콘시걸 하는대	사주 하는 게 지금 약혼식을 하는데
지금 그기 에 사주 써 보내고 이라먼 그기 야콘시기죠	지금 그게 에 사주 써  보내고 이러면 그게 약혼식이지요
고건 어트개 해요	그건 어떻게 해요
사주 보낼 때	사주 보낼 때
사주 보내넝 건 옌나래 하이니 이씀니다	사주 보내는 건 옌나래 하인이 있습니다
증 마라자먼 우리 일가먼 일가애 산지기라고 이써요	에 즉 말하자면 우리일가면 일가에 산지기라고 있어요
그 아시개쪼	그 아시겠지요
산지기 그 사라믈 시켜서 보냄니다	산지기 그 사람을 시켜서 보냅니다
사줄 써 가주고	사주를 써 가지고
써 가주 보따리애다 이래 싸 가주구 거기다 보내먼	써 가지고 보따리에다가 이렇게 싸 가지고 거기에다 보내면
인재 신부 찌배 보내먼 신부 찌배서 태기럴 거기서 해 옴니다	에 신부 집에보내면 신부집에서 택일을 거기서 해 옵니다
인재 얼 언재 결 겨로널 할라고 겨론 날짤 자바 가주고	이제 얼 언제 결혼을하려교 결혼 날짜를 잡아 가지고
인재 에 겨론 할라고 겨론시걸 하자고 그 통지가 옴니다	에 이제 에 결혼 하려고 결혼식을 하자고 그 통지가 옵니다
그라먼 인재 그 날짜가 정해지넝 거지요	그러면 이제 그 날짜가 정해지는 거지요
겨론식 날짜가	결혼식 날짜가
그 사주보낼 때 그 사주 사줃 딴 단자라 그러자나요	그 사주 보낼 때 그 사주 사주단자라고 그러잖아요
그건 어트개 해요	그건 어떻게 해요
고거뚜 머	그것도 뭐
그거	그거
저기 종이	저 종이
그거 인재 창호지애다가 생녀워릴 딱 쓰고	네 그거 이제 창호지에다가 생년월일 딱 쓰고
인재 이 실랑 생녀워릴 쓰고	어 이제 이 신랑 생년월일 쓰고
그 인재 이쑤쑤때공 맨 우애 인넝 거 쪼개 가주	그 이제 이 에 수숫대 맨위에 있는 것 쪼개 가지고
이래 딱 이래 봉해서	이렇게 딱 이렇게 봉해서
이래 색씰로 이래 감씀니다	이렇게 색실로 이렇게 감습니다
아래 우로 가마서 이래	아래 위로 감아서 이렇게
에 거시기 봉토지애다 느 가주고	에 거시기 봉투에다가 넣어 가지고
그라고 인재 이 저 보재기럴 사주뽀재기라구 이써요	어 그리고 이제 이 저보자기를 사주보자기라고 있어요
거길 싸가주고	거기에 싸 가지고
짬매서 인재 그하이널 씨켜서 보내능 거지요	동여매서 이제 그 하인을 시  켜서 보내는 거지요
전 그거는 저는 말만 드러보고 실째로는 암 바꺼든뇨	전 그것은 말만 들어 보고 실제로는 안 봤거든요
그러구	그리고
실째로 암 보시써요	실제로 안 보셨어요
하 그래요	하 그래요
말만 드러바써요	말만 들어봤어요
그래 가주고 그 창호지애다가 써서 저버 가주구	그래 가지고 그 창호지에다가써서 접어 가지고
그 수수 그걸루 어트개 한다 그러는대	그 수수 그것으로 어떻게 한다고 그러는데
고고	그거
이게 쑤수 글쌔 맨 우애 올라간 그 수수	예 이게 수수 글쎄 맨위에 올라간 수수
이 저 여는 고 대공이 이 가늘민성 이래 쪽빠로 그 짐니다	이 저 열리는 그대궁이 이 가늘면서 이렇게 똑바르고 깁니다
그리잉깨 인재 고 사주 써서 인재 사주 머 이 요만칭 요러캐 맹글지요	그러니까 이제 사주 써서 이제 사주 뭐 이 요만큼 이렇게 만들지요
이거 요러캐	이거 요렇게
요만치	요만큼
예예	예
에 요망칭 맹그넌대	요만큼 만드는데
그래 가주 양짜개 인재 딱 이걸 쑤수때공얼 딱 까운탤 잘르먼	그래 가지고 양쪽에 딱 이걸 수숫대를 딱 가운데를 자르면
머 인재 고래 합치 가지고	뭐 이제 그렇게 합쳐 가지고
요고 요골 그냥 봉토지 그냥 노코 요래 합치 가지고	요고 요걸 그냥 봉투에다가그냥 놓고 이렇게 합쳐 가지고
양짜갤 이래 아래 우앨 짜 맴니다	양쪽을 이렇게 아래 위에를 동여맵니다
하하	하하
그러면 이 요 요 요로캐	그러면 이 요 요 요렇게
그르쵸	예 그렇지요
이르캐 길개 해 가주 여기두 쫌매고 요기두 쫌매고	이렇게 길게 해 가지고 여기도 동여매고 여기도 동여매고
사주 씅 거 이르캐 저붕 거애다가 가운대를 이르캐 짝 저 쪼개지니까	사주 쓴거 이렇게 접은 거에다가 가운데를 이렇게 쫙 쪼개지니까
예예	예
가운대다가 끼어 가주구	가운데다가 끼워 가지고
예예	예
양짜개를 이르캐 쫌매고	양쪽을 이렇게 동여매고
예예	예
그러면 이재 여기 고정되니까	그러면 이제 여기가 고정되니까
그르캐 하지요	그렇게 하지요
그르캐 해 가주구 그거	그렇게 해 가지고 그거
그르캐 해 가주 이재 보재기애다 싸지요	그렇게 해가지고 보자기에다 싸지요
또 보재기애다	또 보자기에다
보재기 머 색깔가틍 거뚜 거 구벼래요	보자기 뭐 색깔 같은 것도 구별해요
색 꼬 색까른 아펀 홍 하 뒤앤 청 머 이렁 걸로 주로 하지요	색 고 색깔은앞은 홍 뒤엔 청 뭐 이런 걸로 주로 하지요
고로캐 인재 여 겨부로 대 인능 거	그렇케 이제 겹으로 돼 있는 거
고론 시그로 하지요	그런 식으로 하지요
그기 무슨 의미가 인나요	그게 무슨 의미가 있나요
그기 글쌔 남녀럴 갈리넌 인저 그 머 에 생가카넌 그런 의미가 인넝 거지요	그게 글쎄 남녀를 가르는 이제 그 뭐 에 생각하는 그런 의미가 있는 거지요
그럼 이재 사주 보내면 태길 해 오고	그럼 이제 사주 보내면 택일 해 오고
그 궁합까틍 건 안 바써요	그 궁합 같은 건 안 봤어요
궁하번 미리 보고서	궁합은 미리 보고서
결쩡할 때 에 인재 그 사주 보내기 저내	결정할 때 에 이제 그 사주 보내기전에
그 중매자가이 아무 무순 띠하고 무순띠 하군 이 궁하비 마따	그 중매자가 에 이 아무 무슨 띠하고 무슨 띠하고는 이 궁합이 맞다
머 이런 얘긴 하고서 하지요	뭐 이런 얘기는 하고서 하지요
미리	미리
미리	미리
사저내 미리	사전에 미리
궁합뽈 때는 머 멀 가주구 궁하불 바요	궁합 볼 때는 뭐 뭘 가지고 궁합을봐요
궁하번 띠 가주 보지요	궁합은 띠 가지고 보지요
띠 가주	네 띠 가지고
생녀눠릴 이렁 건 인재 세미라개 보는 사라먼 그렁 거까지 다 따지고 보고	생년월일 이런 거 이제 세밀하게 보는 사람 그런 것까지 다 따지고 보고
양짝	양쪽
생녀눠릴까지 다 따지 보고	생년월일까지 다 따져 보고
그 인재 띠 날 가주 주로 궁아불 결쩡얼 하지요	그 이제 띠 날 가지고 궁합을결정하지요
그럼 그건 저 색씨 찌배서 주로 하나요	그러면 그건 저 색시 집에서 주로 하나요
양쪽 찌배	양쪽 집에
그때 양짝 찌배서 다 보넝 거지요	그때 양쪽 집에 다 보는 거지요
따지고 보먼	따지고 보면
다 본다고 봐야지요	다 본다고 봐야지요
그러고 나서 인재 태길하면 인재 겨론 준비하자나요	그리고 나서 이제 택일하면 이제 결혼 준비하잖아요
준비해야 되자나요	준비해야 되잖아요
해야지요	예 해야지요
머 어떵 걸 준비하나요	뭐 어떤 걸 준비하나요
그른대 인재 준비하넝 거는 머 그기 날짜가 결쩡이 대먼	그런데 이제 준비하는거는 뭐 그게 날짜가 결정이 되면
잔치 준비가 중요하지요 머	잔치 준비가 중요하지요 뭐
잔치 준비	잔치 준비
그라고 인재 옌나랜 가매 타고 댕기야지요	그리고 이제 옛날엔 가마 타고 다녀야지요
가매	가마
가매 타면 하이널 구해야 대고	가마타면 하인을 구해야 되고
그라고 인재 상가 머 여자 찌배 오는 사라먼 요까기라 고라지요	그리고 이제뭐 여자 집에 오는 사람은 요각이라 그러지요
여자 츠개서 오넌 사라먼 요각	여자 측에서 오는 사람은 요각
요각	요각
대표	예 대표
요가기라 그래요	예 요각이라고 해요
그걸	그걸
그라먼 인재 부모가 아부지가 오든지 주로	그럼 이제 부모가 아버지가 오든지주로
아부지가 웁쓰먼 머 크노빠가 온다든지 머	아버지가 없으면 큰오빠가 온다든지 뭐
오빠가 이쓰먼 그르캐 하고	오빠가 있으면 그렇게 하고
요각 요가근 여자 츠개서 오능 걸 요가기라 하고	요각 요각은 여자 측에서 오는 걸 요각이라고 하고
남자 츠개서 가능 건 상가기라 그라죠	남자 측에서 가는 건 상각이라 그러지요
상각	상각
그 인재 상가근 남자 츠개서 인재 아부지가 웁쓰먼 머 마텽이 가던지	그 상각은 남자 측에서 아버지가 없으면 뭐 맏형이 가든지
아니먼 그 지바내 에 중요한 대표 인무리 댈마난 사라미 가고 가능 거죠	아니면 그 집안에 에 중요한 대표 인물이 될만한 사람이 가고 가는 거죠
아부지가 업쓰면	아버지가 없으면
그때	그때
그른 준비럴 하고 인재	그런 준비를 하고
에 그 가매럴 미고 머이래 가야 대고 남자 츠갠	에 그 가마를 메고 에이렇게 가야 되고 남자 측에서는
또 여자 츠갠 이 농이나 머이 이불 머 오까지 이렁 걸 해 가주 가주와야 대닝깨	또 여자 측에서는 이 농이나 뭐이 이불 뭐 옷가지 이런 걸 해 가지고가져와야 되니까
사라미 마이 피료하지요	사람이 많이 필요하지요
옌나랜	옛날에는
아주 복짜파지요 머	아주 복잡하지요 뭐
옌날	옛날
그러면 감 가매를 남자 츠개서 가저 가서	아 그러면 가마를 남자 측에서 가져 가서
신부를 거기 모셔오능 건가요	신부를 거기 모셔 오는 건가요
그른대 인재그기 으 양짝 따 피료항 기요	그런데 이제 그게 양쪽 다 필요한 거요
장개 가는 나런 남자 츠개서 피료항 기고	장가 가는 날은 남자 측에서 필요한거고
올 때넌 여자 츠개서 피료항 검니다	올 때는 여자 측에서 필요한 겁니다
여자 츠개서 그렁 걸 인재 다 이 하인더럴 시키 가주	여자 측에서 그런 걸 이제 다 이 하인들을 시켜 가지고
사람 하이니 웁쓰먼 사람이라두 어트개 사서라도	사람 하인이 없으면 사람이라도 어떻게 사서라도
그 질머지고 올 싸람 가매 맬 싸람 이런 사라미 선정이 대야 대니까	그 짊어지고 올 사람 가마 멜 사람 이런 사람이 선정이 돼야 되니까
그라먼 인재 여자 츠개서 부다멀	그럼 이제 여자 측에서 부담을
남자 츠개서부다멀 할 쑤도 인넌대	남자 측에서 에 부담을 할 수도 있는데
이 충청도 시건 여잔 여자대로 남잔 남자대로	이 충청도 식은 여자는 여자대로 남자는 남자대로
그래서 그리 항 걸로 알고 이써요	그래서 그렇게 한 걸로 알고 있어요
근대 경상도 가먼 그기 다르다 그래요	그런데 경상도 가면 그게 다르다고해요
남자 츠개서 다 부담한담니다	남자 측에서 다 부담한답니다
남자가 부자고 이라먼 남자가 다 채김지고 해따고 그런 얘긴 드러쪼	남자가  부자고 이러면 남자가 다 책임지고 했다고 그런 얘기는 들었지요
그런 과정이 에 준비 과정이지요	그런 과정이 준비 과정이지요
그라먼 잔치	그러면 잔치
그 다매 인재 잔치 준비하넝 건 머 손님 대저팔라고 하능 거니깨	그 다음에 이제 잔치 준비 하는 건 뭐 손님 대접하려고 하는 거니까
자기 성지애 따라서인재 더 자라고 스우면 자라고	자기 형편에 따라서 더잘하고 싶으면 잘 하고
그런 방버부로 하고	그런 방법으로 하고
또 인재 이 음시걸 주고 바찌요	또 이제 이 음식을 주고 받지요
인재 상 그 그쌔 상얼 해 가주	이제 상 그 글쎄 상을 해 가지고
남자가 인재 여자 츠개 보내고	남자가 이제 여자 측에 보내고
여자 츠갠 또 남자 츠그로 보내고	여자 측에서는 또 남자 측으로 보내고
그래 가주 인재 장가 인재 참 저 잔친 치른 다매 인재 그걸 가주 노나 먹찌요	그래 가지고 장가 참 저 잔치 치른 다음에 그걸 가지고 나누어 먹지요
또 동내 돌리 주기두 하고	또 동네 돌려 주기도 하고
그러면 인재 여자가 준비하능 거 하고 남자가 준비하능 거는 보면	그러면 이제 여자가 준비하는 거 하고 남자가 준비하는 거는 보면
남자는 주로 가마나 이런 잔치쪼개더 준비가 마늘 꺼 가꼬	남자는 주로 가마나 이런 잔치 쪽에 더 준비가 많을 거고
여자는 인재 혼수도 마려내야 대자나요	여자는 이제 혼수도 마련해야 되잖아요
그르쵸 옌나랜 인재 함 번 하먼	그렇지요 옛날에 이제 한 번 하면
그개 인재 더 마늘 꺼 가튼대 여자 츠개서 준비할 깨	그게 이제 더 많은 거 같은데 여자 측에서 준비할 게
여자 츠개서 준비하능 기 마늘 쑤배끼 엄능 기	여자 측에서 준비하는 게 많을수밖에 없는 게
전부 옥까지 해 가주 와이지	전부 옷가지 해 가지고 와야지
그라고 인재 에 이 시지보는 사라미 좀 인는 사라미고 움넌 사라미먼 성사대루하넝 깅깨	그리고 이제 이 시집 오는 사람이 좀 있는 사람이고 없는 사람이면형세대로 하는 거니까
마이 아내와도 대지만	많이 안 해와도 되지만
이 가족뜰꺼까지 부자넌 다 해다 주자나요	가족들 것까지 부자는 다 해 주잖아요
하다모태 양 참 저 버선 항커리라도 지어서 가저 와야 대고	하다못해 참 저 버선 한 켤레라도 지어서 가져 와야 되고
머 만치요	뭐 많지요
여자드리 하능 건	여자들이 하는 건
옥까지 머이 이불 머 자기 일평생 부자는 저 익꾸 머글 껄 가저 온다능 건대요 머	옷가지 뭐 에 이 이불 뭐 자기 일평생 부자는 저 입고 먹을 거 가져 온다는 건데요 뭐
씨지볼 때	시집 올 때
옌나래 그래캐하널 걸로 알고 이써써요	옛날에 그렇게 알 하는 걸로 알고있었어요
우린	우리는
이불두 여러 가지가 이짜나요	이불도 여러 가지가 있잖아요
뭐 솜 능 거	뭐 솜 넣은 거
그르치요 인재 에	그렇지요 이제 에
종뉴두 이르캐	뭐 종류도이렇게
에 그람뇨	예 그럼요
머 이 인재 그기 글쌔 부자 움는 사람 하곤 구부니 다릉 기고	뭐 이 이제 그게 글쎄 부자 없는 사람 하고는 구분이 다른 거고
성새대로 하넝 거니까	형세대로 하는 거니까
아주 머 복짜파지요	아주 뭐 복잡하지요
이부래	이불에
저기 껍때기 혿 혿	저기 껍데기 홑
호청	홑청
호청이라구두 또까틍거요 호청하구	예 홑청이라고도 똑같은 거요 홑청하고
호청이라 하고 껍띠기래구	홑청이라 하고 껍데기라고 하고
그렁 거까지도 하고	그런 것까지도 하고
그리구 그 그개 두꺽깨 항 거뚜 이꾸	그리고 그 그게 두껍게 한 것도 있고
그 얄깨 항 거뚜 이꾸 그르치요	그 얇게 한 것도 있고 그렇지요
그르치요	그렇지요
인재 이 이 그 인재 이부를 글쌔 인재 에 옌나래 부자넌 이불두 한 채만 하능기 아니지요	이제 이 이 그 이제 이불을 글쎄 이제 에 옛날에 부자는 이불도 한채만 하는 게 아니지요
여러 채 하고	여러 채 하고
이 씨 씨어머이 씨아부지 이불까지도 해 가주 오구머	이 시 시어머니 시아버지이불까지도 해 가지고 오고 뭐
그건 자기 성새대로 하능 거닝깨 머	그건 자기 형세대로 하는 거니까 뭐
그 부자더런 아주 복짜파개 해 가주 오지요	에 그 부자들은 아주 복잡하게해 가지고 오지요
그 호 혼니불두 이꼬	그 호 홑이불도 있고
혼니불 인재 여르매 덤능 거 이렁 거뚜 해 가주 오고 머	홑이불 이제 여름에 덥는 거 이런 것도 해 가지고 오고 뭐
혼니불하고 호청하고는 다릉 거자나요	홑이불이라고 홑청하고 다른 거잖아요
요 온 호청언 게 이부를 싸넝 거지요	요 홑청은 그게 이불을 싸는 거지요
이부럴	이불을
거껍띠기	겉껍데기
그라먼 인재 빨래하기 조으라고	그러면 이제 빨래 하기 좋으라고
자주 아내두 거껍띠기만 빨먼 쉽짜너요	자주 안 해도 겉껍데기만 빨면 쉽잖아요
그랑깨 인재 그걸 이부럴 싸 가주 오능 게 호청이지요	그러니까 이제 그걸 이불을 싸 가지고 오는 게 홑청이지요
금 혼니부른 머 어떠캐 만드러요	그러면 홑이불은 뭐 어떻게 만들어요
혼니부른 인재 여르매	홑이불은 이제 여름에
솜니부럴 여러매 터풀 쑤가	솜이불을 여름에 덥을 수가
혼니부리라고 인재 또 그 여러매 덤넌 이불로 난 그르캐 알고 이써요	홑니불이라고 이제 또 그 여름에 덥는 이불로 난 그렇게 알고 있어요
그러먼 혼니부른 그 항 겨부루 항 건가요	그럼 홑이불은 그 한 겹으로 한 건가요
혼니불도 겨부로 하긴 하는대	홑이불도 겹으로 하기는 하는데
소물 아느쵸 솜	솜을 안 넣지요 솜
소물 안 느코	아 솜을 안 넣고
소물 안 해요	솜을 안 넣어요
소물 안 능 거에요	솜을 안 넣은 거예요
솜 능 거는 솜니부리구	솜 넣은 것은 솜이불이고
그거 두 겹 두 겨부루 하능 거뚜 이짜나요	그거 두 겹 두 겹으로 하는 것도있잖아요
인재 두 겨분 두 겨비지요 장	이제 두 겹은 두 겹이지요 항상
점니부리래능 거또 이써요 그럼	겹이불이라는 것도 있어요 그러면
혼니불 점니불 이르캐	홑이불 겹이불 이렇게
점니불 쏘린 별루 안 드러 반는대	접이불 소린 별로 안 들어 봤는데
인재 혼니부라고 이부른 글쌔	홑이불이라고 이불은 글쎄 에
솜니불	솜이불
그링깨 호청이라고 인재 이불 싸능 거하고	그러니까 홑청이라고 이제 이불 싸는 거하고
그르캐 구분하문 대지요	그렇게 구분하면 되지요
누 뉘비 이불두 이써요	누 누비 이불도 있어요
누비이부런 누비런 이래 이래 줄 줄로 이래 항 깅깨 누비이부림니다	누비이불은 누비는 이렇게 이렇게 줄 줄로 이렇게 한 거니까 누비이불입니다
줄 줄루 이래 바긍 거	줄 줄로 이렇게 박은 거
이재 그랭깨 옌나래 지그먼이 재봉으로 박찌만	이제 그러니까 옛날에 지금은 재봉으로 박지만
옌나래 소느로 바가서 맹긍 걸 누비이부리라 그라능 기여	옛날에 손으로 박아서 만든 걸 누비이불이라 그러는 거야
보료라능 거뚜 이써요	보료라는 것도 있어요
보료	보료
보료	보료
이르캐 깔고 앙꼬	이렇게 깔고 앉고
이르캐 등애	어렇게 등에
아 그거 이찌요	아그거 있지요
그기 인재 지금 자부동 시그로 해 가주 와요 다	그게 이제 지금 방석 식으로해 가지고 와요 다
옌나래도	옛날에도
그 하지요	그거 하지요
그거 누가 만드러요	그거 누가 만들어요
그건 인재 하이간 저 실 새닥 츠개서 맹그라 가주 오능 기요	그건 이제 하여간저 신 새댁 측에서 만들어 가지고 오는 거요
여자 츠개서	여자 측에서
옌나래는	옛날에는
이 츠 틀까요 쫌	이거 틀 틀까요 조금
저는 갠차나요	저는 괜찮아요
갠차나요	괜찮아요
하라번님 더웅가요	예 할아버님 더운가요
아이 쪼꿈 더웅 거 가트내요	아니 조금 더운 것 같네요
아이 제가 저거 마니 도라가면 소리가 나서	아니 제가 저게 많이 돌아가면소리가 나서
그래서 살짝 쪼코마캐 트러놀깨요	그래서 살짝 조그맣게 틀어놓을게요
쪼꿈	아 조금
제갇	제가
옌나래는 다 솜너짜나요	옛날에는 다 솜 넣잖아요
솜 느초오	솜 넣지요
그 이 글쌔 부자는 솜두 두꾸깨 늘 쑤 이꾸	그 이 글쎄 부자는 솜도 두껍게넣을 수 있고
근대 가나나문 그 머 모카럴 마이 안 너서 한 저 마이 몯 몯 쭉 고하거나 이라먼소물 약깨 하지요	그런데 가난하면 그 뭐 목화를 많이 안 넣어서 한 저 많이못 구하거나 이러면 솜을 얇게 하지요
그래 이재 이 부자는 두꾹깨 해 가주	그래 이제 이 부자는 두껍게 해 가지고
두꾸깨 해야 뜨시자나요	두껍게 해야 따뜻하잖아요
그런 시그로 그래 해서 하고 이찌요	그런 식으로 그래 해서 하고 있지요
모카두 마니 시머써요	목화도 많이 심었어요
여기 모카도 마이 싱과 본 댐미다	여기 목화도 많이 심어 본 데입니다
이래 가주 일쩡 때	이렇게 해 가지고 일정 때
일쩡 때 그거 목커럴 싱구먼 부 이 바다가써요	일정 때 그거 목화를 심으면 전부 이 받아 갔어요
일본 애드리 인재 저드리 써 머글라고	일본 애들이 저희들이 써 먹으려고
마이 해기는 모카 또 여 마이 싱군 댐니다	많이 하기는 목화 또 여기 많이 심은 데입니다
생산 마이 한대요	생산 많이 한 데요
그거는 농사를 어트개 해요	그거는 농사를 어떻게 해요
모콰넌 이 바태다가모콰씨럴 뿌림니다	목화는 이 밭에다가 목화씨를 뿌립니다
뿌려	뿌려
가라 가주 고럴 맹그라 가주	갈아 가지고 골을 만들어 가지고
뿌리고서인재 더프먼 나오죠	뿌리고서 에 덮으면 나오지요
그 인재 거러멀 마니 하먼 더 마이 열고	그 이제 거름을 많이 하면 더 많이열고
인재 여넝 건	이제 여는 건
인재 그라먼 그기 모카 씽구넌 시기가 좀 일러 일 쪼끔 일찌기 싱과야 디요	이제 르러면 그게 목화 심는 시기가 좀 일러 일 조금 일찍 심어야 돼요
그래 가주 너무 느깨 싱구먼 그 모카가 수화기 즈쬬	그래 가지고 너무 늦게 심으면 그 목화가 수확이 적지요
그래 인재 모콰 농사넌 그라먼 머 꼬시 피 가주	그래 이제 목화 농사는 그러면뭐 꽃이 피어 가지고
머이 다래라고 열먼	뭐 다래라고 열면
그개 인재 모콰가 대넝 건대	에 그게 이제 목화가 되는 건데
그거 다래럴 절무 저머쓸 때 그걸 따 머끼도 함니다	그거 다래를 젊었 젊었을때 그것을 따 먹기도 합니다
따 머그먼 달캉하니 마시써요	따 먹으면 달달하니 맛있어요
허허	허허
그 이구먼 인재 이 솜 고치 피지요	그 이제 솜 같이 이렇게 피지요
피지요	피지요
모콰가 피지요	목화가 피지요
그라먼 그걸 따능 기고	그러면 그걸 따는 거고
그럼 수화글 수화기 끈날 무려배 뽀바 가주고	그러면 수확을 수확이 끝날 무렵에 뽑아 가지고
저 뒤똥사내 가따 들 들 핑 거 그겅 가따 너러서 말리먼	저 뒷동산에 갖다 덜덜 핀 거 그것은 갖다 널어서 말리면
필 껀 다 핌니다	필 건 다 핍니다
건 그래 수화걸 하고	그건 그렇게 수확을 하고
수하카능 건	수확하는 건
그 씨두 이짜나요	그 씨도 있잖아요
그 대추씨 가치 생겨찌요	그 대추씨 같이 생겼지요
이찌요	있지요
그기 인재 씨가 인는대	그게 이제 씨가 있는데 어
그 씨넌 쌔아시라고 이써	그 씨는 씨아라고 있어
쌔앋	씨아
씨아시	씨아
씨아시라는 그 저 우리나라애서 맹근 거요	씨아라는 그 저 우리나라에서 만든거요
그건	그건
우리 옌날부텀 그기 이써요	우리 옛날부터 그게 있어요
씨아시	씨아가
이래 돌리넝 거요	이렇게 돌리는 거요
돌리먼 이 아래 우애 막 따라 도라가기 때미내	돌리면 이 아래 위가 따라 돌아가기 때문에
모과가 씨넌 다 그냥 이짜그로 빠저고	목화가 씨는 다 그냥 이쪽으로 빠지고
씨앋	씨아
씨가 발라점니다	씨가 발라집니다
아래 위애 머가 도라가요	아래 위에 뭐가 돌아가요
아래 우애 이 똥그라캐 이래 맹그렁 길 이기 양짜그루 이래 북깨 대이써	아래위에 이 동그랗게 이렇게 만든 것이 이게 양쪽으로 이렇게 붙게 되어 있어
요래 마처 가주고 이래 돌리먼	이렇게 맞춰 가지고 이렇게 돌리면
모칼 이래 느먼	목화를 이렇게 넣으면
이래 지넌 바라매 씨넌 이짜그로 떠러저고	어 이렇게 되는 바람에 씨는 이쪽으로 떨어지고
모카는 이리 나온다 이거여	목화는 이리 나온다 이거야
그라먼 씨럴 바르넝 거여	그러면 씨를 발리는 거야
이재 고 다매 그라먼 그기 그 과정이 끈나먼	이제 그 다음에 그게 그 과정이 끝나면
활로 화리라고 이써요	활로 활이라고 있어요
여기 진짜 이래 쏘넌 활 그거랑 비스타개 이래 맹긍 기 대나무로	여기 진짜 이렇게 쏘는 활 그거랑 비슷하게 이렇게 만든 것 대나무로
대나무 활로 맹그라 가주	대나무 활로 만들어 가지고
퉁퉁 팅기먼 소미 대뿌리넝 거여	퉁퉁 튕기면 솜이 돼 버리는 거야
소미	솜이
그기 그 소미 대먼 인재 그거럴 이런대 이래 널린대다 이래 깔고	그게 그 솜이 되면 이제 그것을 이런 데 이렇게 넓은데다 이렇게 깔고
이불만 이불 이불쏨 할라먼 이불만칭 이르캐 이런 대다 가따 노코	이불만 이불솜을 하려면 이불만큼 이렇게 이런 데다 갖다 놓고
이래 피 노무 그거 인재 활로 티그 팅깅 걸 그걸 소미라카능 거여	이렇게 펴놓으면 이제 활로 튕긴 걸 그것을 솜이라고 하는 거야
소물 가따 이러캐 이불 널비만칭 해 가주고	솜을 갖다 이렇게 이불 너비만큼해 가지고
딱 눌러 멀루 좀 이래 빤뜨탕 걸로 눌러먼	딱 눌러 무엇으로 좀 이렇게 반듯한걸로 누르면
이 짜브라전 다매 이래 개 가주고	이 눌린 다음에 이렇게 개어 가지고
나두따가 이불 맹그넝 거요	놔 두었다가 이불 만드는 거요
이불	이불
솜니불 맹그넝 거요	솜이불 만드는 거요
그르캐	그렇게
그라고 인재 또 그건 인재 베 날라먼	그리고 또 그걸 이제 베를 하려면
이 베를 맹글라 인재 옫 옫 찔 꺼 이래 베를 맏 맹글라먼	이 베를 만들어 이제 옷 옷 지을 것 이렇게 베를 만 만들려면
그거 소무로 인재 탕 거럴 눌루지도 앙코	그거 솜으로 이제 탄 것을 누루지도않고
그기 내 고대 얘기해찌요	그게 내 금방 얘기했지요
여 거시기사주 사주할 때 그 쪼개넝 거	여 거시기 에 사주 사주 할때 그 쪼개는 것 어
그 그걸 그걸 끄너 가주고	그 그걸 그걸 끊어 가지고
이 소느로 가꼬 요 쪼망칭 요래 소물 요래 띠 가주고	이 손으로 가지고 요 조그만큼 이렇게 솜을 이렇게 떼어 가지고
고기다 노코 이르개 소느로 비비먼	거기에다 놓고 이렇게 손으로 비비면
이래 거시기 떡까래 거치 그르캐 대능 거여	거시기 가래떡 같이 그렇게 되는거야
그걸 인재 에 맹그넌 과정언 물래라고 이써요	그걸 이제 만드는 과정은 물레라고 있어요
물래	물레
물래애다가 이 가락꼬지 거틍 기 여 쌔로 맹긍 기 이써요	물레에다가 이 가락꽂이 같은 게 여기 쇠로 만든 게 있어요
여기다 이재 댕깅 대 고기애 인재 또 그라구 저 조 조껍띠기 이 그걸 가따 요기끄트머리다 찡구고	여기에다 이제 동인데 거기에 이제 또 그리고 저 조 조껍데기 그걸 갖다 여기 끄트머리에다 끼우고
인재 이 씨럴 뽐넝 거요	이제 이 실을 뽑는 거요
이걸 돌리먼 이래이래하먼 시리 대넝 거여	어 이걸 돌리면 이렇게이렇게  하면 실이 되는 거야
그 인재 요기수리요	그 이제 요 아주 기술이요
요걸 국깨 하먼 뿔떡 뿔떡뻬가 대고 아주 가늘개 하먼 조온 고 베가 대능 기요	요걸 굵게 하면 뿔떡 뿔떡베가 되고 아주 가늘게 하면 좋은 그 베가 되는거요
그래 새가	그래 사이가
뿔떡뻬라 그래요	뿔떡베라 그래요
뿔떠뻬라는 젤 나뿡 거	뿔떡베라는 건 제일 나쁜 거
나쁜 녿 맹근 만 만드는 오시대고	나쁜 옷 만든 만 만드는 옷이 되고
시럴 잘 모뽀부먼	실을 잘 못 뽑으면
시럴 잘 뽀부만 아주 곤 오시 대능 거여	시을 잘 뽑으면 아주 고은 옷이 되는거야
그 그 킁 기술링 기여 그기	그 그게 큰 기술인 거야 그게
이 실 뽐는 기수리	이 실 뽑는 기술이
그래 가주 이 오서 맹그능 거여 옌나래	그래 가지고 이 옷을 만드는 거야 옛날에
그러면 굴그 굴깨 나옹 개 뿔떡뻬 하능 거고	그러면 굵은 굵게 나온 게 뿔떡베 하는 거고
에 뿔떡뻬고	에 뿔떡베고
고은 거는	고은 거는
고옹 건 조은 베다 이거여	고은 건 좋은 베다 이거야
아주 가늘개 잘 뽀바야	아주 가늘게 잘 뽑아야
가늘게 잘 뽀부먼 존 베가 대넝 거여	가늘게 잘 뽑으면 좋은 베가 되는 거야
옌나랜 그래찌요	옛날에 그랬지요
그 그거 저기 그 머라 그래요	그 그거 저기 그 뭐라고 해요
수 수수깨이	수 수수깡
쑤수깽이	수수깡
그걸루 항 거자나요	예 그걸로 한 거잖아요
고고 요망쿰 짤러 가주고	그거 요만큼 잘라 가지고
이 이거 비빌떵거라고	이 이거 비비던 거라고
또 인재 요고 뽀불 때는 그걸 여기다 꼼능 개 아니고 저 거시 조	또 이제 요거뽑을 때는 그걸 여기다 꼽는 게 아니고 거시기 조
어떤 조	어떤 조
조 조 졷때 조껍띠기 저 키워 크는	조 조 좃대 조껍데기 저 키워 크는
고거럴 여 매지럴 끄너 가주 요기다 끼워 가주구	고거를 여 마디를 끊어 가지고여기다 끼워 가지고
실타래 실타래 감능 건 고걸루 하능 기여 또	에 실타래 실타래 감는 건 고걸로 하는 거야 또
그 조 조가 머 어떠캐 생깅 거애요	그 조가 뭐 어떻게 생긴 거예요
그 저 스숭 얘기하능 거 아니지요	그 저 조 얘기하는 거 아니지요
수숙	서숙
스스기요	서구이요
수스기라카지 조럴	어 서숙이라고 하지 조를
수숙	예 수수
스수기라고도 하고 조라고도 하는대	서숙이라고도 하고 조라고도 하는데
좁쌀 알자나요	좁쌀 알잖아요
좁쌀	좁쌀
쌀 째맹콤항 거	쌀 조그만한 거
저 저 이 수 머여	저 저 이 수수 뭐야
수숙 여기 저이 수수깽이 머여 맹그능 건 아리 더 굴긍 건	수수 여기 저에 이 수수깡 뭐야 만드는 건 알이 더 굵은 것은
쑤수라카고	수수라고 하고
쑤수	수수
쑤수	수수
쑤수라고 안히야	수수라고 안해
쪼마낭 건 조라카능 기고	조그만한 건 조라고 하는 거고
좁쌀	좁쌀
좁쌀	좁쌀
좁싸래 그	좁쌀에 그
그 껍띠기	그 껍데기
싸리 안댕 걸 조	쌀이 안 된 걸 조
그 껍때기라 그러먼	에 그 껍데기라 그러면
머 귿 저기 줄기	뭐 그 저기 줄기
그거 껍때기애요	그게 껍데기예요
인재 이 알 굴긍 거넌 쑤수	이제 이 알 굵은 것은 수수
쑤수라고 그거저 사주 사주애 쓰멍능 기고	수수라고 그거 에 저 사주 사주에 써 먹는 것이고
그 조 아까 그 조껍때를 거기 끼운다고 핸는대	그 조 아까 그 조 껍데기를 거기 끼운다고 했는데
그 조껍때기는 어떤 어떵 걸 얘기하능 거요	그 조껍데기는 어떤 걸 얘기하는거요
그 껍때기가	그 껍데기가
껍때기는 인재 에 그 대공	껍데기는 이제 에 그 대궁
대공	대궁
대공애 이파리 인능 거	대궁에 이파리 있는 거
대공	어 대궁
대공얼 잘르먼 그 쏘기 비 가주 이따고	대궁을 자르면 그 속이 비어 있다고
대공이	대궁이
그래잉깨 인재 이거 끼우먼 대도록 대 이따고	그러니까 이제 이게 끼우면 되도록 되어 있다고
요래 요망콤 짤라 가주고	이렇게 요만큼 잘라 가지고
그기 인재 실타래라카능 기여	그게 이제 실타래라고 하는 거야
실타래	실타래
그래 가주고 요로캐 가마노면 요로캐 배 불르개 요로캐	아 그래 가지고 요로캐 감아 놓으면 이렇게 배부르게 요로케
에 똥구라캐 요래	예 동그랗게 요렇게
요로캐 생깅 거	요렇게 생긴 거
으 꼬래지	응 그런 꼴이지
마저	예 맞아
그걸 실타래라 그래요	그걸 실타래라고 해요
그걸 실타래라카능 거 아녀	예 그걸 실타래라고 하는 거 아니야
그르니 요새 애들 머 저두 잘 모르갠는대	그러니 요새 애들 뭐 저도 잘 모르겠는데
요새 애드리야 알깨써요	요새 애들이야 알겠어요
으흐흐 그리요	으흐흐 그래요
애더리 알마낭 건 아니지	어 애들이 알만한 건 아니지
이렁 거넌	이런 거는
지끄매더런 아주 저녀 모르지	지금 애들은 아주 전혀 모르지
지금 구경두 아낸는대 머	지금 구경도 안 했는데 뭐
저녀 몰를거여	전혀 모를 거야
음음	음
아까그 활로 탄다그러자나요	아까 그 활로 탄다 그러잖아요
활로 탄다고	활로 탄다고
활로 타능 기여	어 활로 타는 거야
그거를 전 잘 모르개써요	그거를 전 잘 모르겠어요
머 이르캐 두 두드리능 거	뭐 이렇게 두 두드리는 거
탁탁 이래	탁탁 이렇게
이 화를 이래 들고	이 활을 이렇게 들고
진짜 이 활거치 요르캐 대 인능대	진짜 이 활같이 요렇게 되어 있는데
요 활 주리 이짜나	이 활 줄이 있잖아
그걸로 이 이르캐 씨아 씨 발라농 그 모콰럴 가따가 노코서	그걸로 이 이렇게씨앗 씨 발라 놓은 그 목화를 갖다가 놓고서
탕탕탕탕 타먼 그기 버러저 가주 소미 대능 거요	탕탕탕탕 타면 그게 벌어져가지고 솜이 되는 거요
소미 대버려	솜이 돼 버려
그람 막 이러캐 벙하니 이러캐 대지	그러면 막 이렇게 벙하니 이렇게 되지
그르며는 이르캐 반달 모양으로 대쓸꺼 아니요	그러면 이렇게 반달 모양으로되었을 거 아니예요
이러캐	이렇게
그르쵸 반달 모양	그렇지요 반달 모양
그럼 여기 이르캐 인재	그러면 여기 이렇게 이제
여 주리 이쬬	여기 줄이 있죠
주리 이꼬	줄이 있고
그러문 요 주를 주래다가 대고 하능 거요	그러면 요 줄을 줄에다가 대고 하는거요
이 익	이 이
그거 모콰를 여기다 노코	그거 목화를 여기다 놓고
주래다 고 고 줄 이걸 탕탕 팅기먼 주래서 팅기 가주구	줄에다 고 고 고 줄 이것을 탕탕탕 튕기면 줄에사 튕겨 가지고
그거 소물 맹그라 논능 거야	그거 솜을 만들어 놓는 거야
그러면 화를 여 노코	아 그러면 활을 여기 놓고
고 줄 인는대다 모콰를 노코	고 줄 있는 데다가 목화를 놓고
이거 주를 탕 노먼	이거 줄을 탁 놓으면
그르치	그렇지
끄라능 기여	그러는 거야
그 주리 튈 때마다 모카가	그 줄이 튈 때마다 목화가
모카가 버러저넝 거여 고래	아 목화가 벌어지는 거야 그렇게
아 그래서 이러캐 벙그러캐	아 그래서 이렇게 벙그렇게
그래서 벙하개 벙하개 그래 아주 골고루 고만 잘 이래 튕기야 댄다고	그래서벙하게 벙하게 그렇게 아주 골고루 그만 잘 이렇게 튕겨야 된다고
그래 가주서 소멀 맹그넝 거요	그래 가지고 솜을 만드는 거요
옌나래	옛날에
그래니까 그개 인재 옌나래 지배서 하든 방버비고	아 그러니까 그게 이제  옛날에 집에서 하던 방법이고
그 뒤애 항 개 인재 귿 솜틀찌배 가주 가서 타 온다능 거뚜 결구근 그러캐 붕하개 해오능 거지요	그 뒤에 한 게 이제 그 솜틀집에 가져 가서 타 온다는 것도 결국은 그렇게 붕하게 해오는 거지요
그르치요	그렇지요
그렁 거지 그건	그런 거지 그건
지배서 저 솜 오래 쓰면 이르캐 눌려 가주고 가라안짜나요	집에서 저 솜 오래쓰면 이렇게 눌려 가지고 가라앉잖아요
그래서 그거 가끔 보니까 그 솜 타 가주고 오루 그러기도하든대	그래서 그거가끔 보니까 그 솜 타 가지고 오고 그러기도 하던데
그러지요 인재 지그문 기개루 다 하지	그렇지요 이제 지금은 기계로 다하지
여기 인재 아내	여기 이제 안 해
옌나랜 그래따 이런 얘깅 기요	옛날에 그랬다 이런 얘긴 거예요
예예	예
옌나랜	옛날에는
그리고 인재 그르캐 해서 그걸 이부래다가 너어 논능 거구	그리고 이제 그렇게 해서 그걸 이불에다가 넣어 놓는 거고
그다매 또 머리애 이르캐 베능 거뚜 이짜나요	그 다음에 또 머리에 이렇게 베는 거 있잖아요
비개	베개
그건 어트개 해요	예 그건 어떻게 해요
베개야 머 여러 가지로 맹그를 쑤 인능 깅깨 옌나래도 마창가지요	베개야 뭐 여러 가지로 만들 수 있는 것이니까 옜날에도 마찬가지요
머 거기 에 곡씨걸 는넌 사람도 이꼬	뭐 거기 에 곡식을 넣는 사람도 있고
앙 그라먼 머 좀몰개	안 그러면 뭐 좀 에 모래
몰개두 아내는 느코	모래도 안에는 넣고
그라고 인재 머 그 베개 맹그넝 건 이 수럴 노치요	그리고 이제 뭐 베개 만드는 건 이 수를 놓지요
그수 아시지요	그 에 수 아시지요
여패	옆에
으 여패 하는대	으 옆에 하는데
그건 인재 수루 해 가주구 막 아주 보기 조캐 맹그능 건 머 근 솜씨대루 가능 거죠	그건 이제 수로 해 가지고 막 아주 보기 좋게 만드는 것은 뭐 그건 솜씨대로가는 거지요
곡씨근 멀러써요 주로	곡식은 뭘 넣었어요 주로
곡씨건 그거 메물	곡씩은 그거 메밀
매물껍띠기두 너코 곡씩 껍띠기	메밀 껍데기도 넣고 곡식 껍데기
인재 곡씨건 머 그 알맹인 먹끼 위해서 그 하고 머	이제 곡식은 뭐 그 알맹이는 먹기 위해서 그거 하고 뭐
여러 가질 늡띠다	여러 가지를 넣습디다
곡썩 껍띠기도	곡식 껍데기도
저는 어릴때보니까 저 저 왱겨	저는 어릴 때 보니까 저 저 왕겨
왱겨는 흐니 마이 는능 기고	아 왕겨는 흔히 많이 넣는 거고
그거 그캐	그거 그렇게
왕겨는 머 벼 왕겨는 머 거 흐니 마이능 거	어 왕겨는 뭐 벼 왕겨는 뭐 그거 흔히 많이 넣는 거
근대 메물껍띠기	그런데 메밀 껍데기
이렁 거뚜 느코 머 메밀	이런 것도 넣고 뭐 메밀
여러 가지 느코 하더라고	여러 가지를 넣고 하더라고
몰개도 너써요	모래도 넣었어요
몰개두 너써요	모래도 넣었어요
몰개두 느치요	모래도 넣지요
그 인재 무굽찌	그 이제 무겁지
몰개 느먼	모래 넣으면
무굽짜나요	무겁잖아요
무구워요	무거워요
쪼마내도	조그만해도
지금 머 황토	지금 뭐 황토
황토 저 비개 이렁 거 무굽짜나	황토 저 베개 이런 것 무겁잖아
딱따카개 맹글기도 하고 머 그런 시건 머 비스태요	딱딱하게 만들기도 하고 뭐그런 식은 뭐 비슷해요
그거 맹기넝 건	그거 만드는 것은
그 여패 수 논대 거기 양쪼개 똥그라차나요	그 옆에 수 놓은 데 거기 양쪽에동그라잖아요
이르캐	이렇게
그르쵸	그렇지요
고 고거 이르미 머 따로 이써요	그 그거 이름이 뭐 따로 있어요
아이고 이러미 그 따루 인넌대	아이고 이름이 그 따로 있는데
그 여자더리 자랄지	그 여자들이 잘 알지
난 잘 모르건는대	난 잘 모르겠는데
허허	허허
이르먼 따루 이찌요	이름은 따로 있지요
그 껍떼기늠 머라 그래요	그 껍데기는 뭐라고 해요
비개	베개
비개	베개
배개	베개
그거뚜 껍띠기두 빨자나요	예 그것도 껍데기도 빨잖아요
껍때기만 주로 잘 자주 빠라서 갈 가라서	껍데기만 주로 잘 자주 빨아서 갈갈아서
그 그르죠	그 그렇지요
그 비 베개 껍띠기라 그랄껄 아마	베 베개 껍데기라 그럴 걸 아마
베개 껍띠기라 그라지 시픈대	베개 껍데기라 그러지 싶은데
이르캐 깔고 안능 거뚜 맨들고	이렇게 깔고 앉는 것도 만들고
그 매빵서기라카지	그거 맷방석이라고 하지
매빵서기요	맷방석이요
그거 멀루 만드러요	그거 뭘로 만들어요
매빵서근 멀루 만드러요	맷방석은 뭘로 만들어요
매빵서근 내내 소금 느코 그래 맹글라요 옌나래도	맷방석은 내내 솜 넣고 그래렇게 만들어요 옛날에도
소고미요	소금이요
솜 느코 솜	솜 넣고 솜
솜 느코	솜 넣고
옌나랜 솜 느코 주로 맹글지	옛날엔 솜 넣고 주고 만들지
혹껄론 아납띠다	홑걸로는 안 합디다
혹껄론 아나고	홑걸로는 안 하고
그걸 매빵서기라 그래요	그걸 맷방석이라 그래요
글쌔 매빵서기라 그라지 아매	글쎄 맷방석이라 그러지 아마
흐흐	흐흐
그 저거는 머라 그래요	그 저거는 뭐라 그래요
저 집 지푸루 여끙 거 이르캐 뚱그러캐 댕 거	저 짚 짚으로 엮은 거 이렇게그렇게 된 거
집 지부로 영긍 거 그 저 매 매 노코 하넝 거	아 짚 짚으로 엮은 거 그저 매 매 놓고 하는 거
그뚜 매빵서기라카는대	에 그것도 맷방석이라 하는데
이근 깔방 깔빵서기라카등가	이건 깔방 깔방석이라고 하던가
깔빵석	깔방석
깔빵서깅가	깔방석인가
깔방서길끼여	깔방석일 거야
이근 깔방서기라칼끼여 아매	이건 깔방석이라고 할 거야 아마
이근 그냥 깔구 안넝 거닝깨	이건 그냥 깔고 앉는 거니까
그걸 매빵서기라캬	그걸 맷방석이라고 해
그건 참 매빵서기여	그건 참 맷방석이야
이 매에두	이 매에도
이 저 돌로 맹긍 거 이래 돌러넝거	이 저 돌로 만든 거 이렇게 돌리는 것
그거 매빵서기여	그게 맷방석이야
하라버니미 그럼 겨론하셔쓸 때가 인재 구내 가기 저니라고 하셔짜나요	할아버님이 결혼하셨을 때가 이제 군에 가기 전이라고 하셨잖아요
선친두 사라개시구	선친도 살아계시고
응 그르치	응 그렇지
그때 가족뜨른 누구 누구 이써써요	그때 가족들은 누구 누구 있었어요
가족뜨런 어머니먼 아부지 다 이꼬	가족들은 어머님은 아버지 다 있고
동생이 이꾸	에 동생이 있고
눈님덜 둘 런 시직 가꼬	누님들 둘은 시집 갔고
하라버지 할머니는	할아버지 할머니는
사라개셔써찌	살아계셨었지
그때 그러며는 연새가 어느 정도 되셔써요	그때 그러면 연세가 어느 정도 되셨어요
할아버님	할아버님
그때가 인재 글쌔 스물한 살	그때가 이제 글쎄 스물한 살
아니 하라버지애 저기 조분님	아니 할아버지의 저기 조부님
아번님	아 아버님
아번니먼 한 삼십 한 육쌔쯤 대찌유	아버님은 한 삼십 한 육 세쯤 되었지요
삼십	삼십
그러며는 그위애 어르시는	그러면 그 위에 어르신은
조분니믄	조부님은
하라버지애 조분님은	할아버지의 조부님은
우리 하라버지는 그때애 에 한 오래살다 도라가시씅깨	우리 할아버지는 그때에에 한 오래 살다 돌아가셨으니까
아매 한 칠씹 년새 대찌요	아마 한 칠십 연세 됐지요
칠씸여덜	칠십여덟
정학카개는 짐 몰러	정확하게는 지금 몰라
한 칠씹 한 오새쯤 대꺼나	한 칠십 한 오 세쯤 됐거나
오래살다 도라가시쓰니까	오래 살다 돌아가셨으니까
하라번니먼	할아버님은
갱장이 조아하셔깬내요	괸장히 좋아하셨겠네요
옌나래는 쩌기 손자 겨로나고 머 이러능 거 보능 개 그르캐 쉽찌는 아나짜나요	옛날에는 저기 손자 결혼하고 뭐 이런 거 보는 게 그렇게 쉽지는 않았잖아요
쉽찌안쵸	쉽지 않지요
쉽찌아나	쉽지 않아
인재 하라번니먼 그때 도라가시찌	아 이제 할아버님은 그때 돌아가셨지
저 어릴 때 보니까 머 한 오십 육씹때면 다 저기 대 대꼬바리 저 저 장죽	저어릴 때 보니까 뭐 한 오십 육십 되면 다 저기 대 대꼬바리 저 저 장죽
꼬꼬 댕기요	꽂고 다녀요
꼬꼬 댕기요	꽂고 다녀요
그거 이르캐 여기 등애다 꼭꼬 다니구 이르시구	그거 이렇게 여기 등에다 꽂고다니고 이러시고
등애다 꼬꼬 댕기요	어 등에다 꽂고 다녀요
지금 오십때면 머 제가 오십땐대	지금 오십 대면 뭐 제가 오십 대인데
흐흐	흐흐
헤헤 점짜나요	흐흐 젊잖아요
그러치요	그렇지요
그러먼 예저내 인재 에 겨론시카자나요	그러면 에전에 이제 결혼식 하잖아요
홀럐식	혼례식
홀래식	혼례식
그럼 인재 요새하고 다르개 옌날 전 전통 홀래식할 때는	그럼 이제 요새하고다르게 옛날 전 전통 혼례식 할 때는
또 그 절차도이꾸 머 차리능 거뚜 이꼬 그 여러 가지가 이때요	또 그 절차도있고 뭐 차리는 것도 있고 그 여러 가지가 있대요
그개 행래쌍이라구 해 가주구	그게 행례상이라 해 가지고
차리능 기 이찌	어 차리는 게 있지
이기 그 참 옌날랜 정하카개하구 이찌	이게 그 참 옛날엔 참 정확하게 하고있지
그거 차리넝 걸	그거 차리는 걸
멀 어뜨캐 줌비해써요	뭐 어떻게 준비했어요
그거 차릴라먼	그거 차리려면
차리넝 거 인재 장개 가먼	차리는 거 이제 장가 가면
에 여자 여자 지배 지배서 먼저 차리지요 그게	에 여자 여자 집에 집에서 먼저차리지요 그게
먼저 차려요	먼저 차려요
여자 지배서	여자 집에서
여자 지배서 인재 차리능 건대 근	여자 집에서 이제 차리는 건데 그건
에 지쌍이라고 이찌요	에 큰상이라고 있지요
지쌍	큰상
이래 노푼 지쌍	이렇게 높은 큰상
지쌍애다가잔치지낼라고 장마난 그 음시글 대충 거기 다 차려 노치	큰상에다가 에 잔치 지내려고 장만한 그 음식을 대충 거기 다 차려 놓지
차리 노코	차려 놓고
다글 암딱	닭은 암탉
암딱 이래 자버다 노먼 양짜개다 가따 노코	암탉 이렇게 잡아 놓으면 양쪽에다갖다 놓고
보재기애다 싸 가주	보자기에다 싸 가지고
암따기요	암탉이요
암딱 장따 개 가주	응 암탉 장닭 해 가지고
암딱 장딱	아 암탉 장닭
그래 싸서 노코	어 그래 가지고 싸서 놓고
인재 초뿌럴 키노코	이제 촛불을 켜 놓고
상차리멀	상차림을
그라고 인재 에 실랑 츠개도술쌍을 가따 노코	그리고 이제 에 신랑 측에도 에 술상을 갖다 놓고
다 인재 여자 츠개도 술쌍얼 가따 노코	다 이제 여자 측에도 술상을 갖다 놓고
그 인재 이 마빠라보고 서서	그 이제 맞주 바라보고 서서
행니를 치르넝 거지 행닐	행례를 치르는 거지 행례를
그라먼 인재 남자가 함번 하먼 여잔 두 번 하고	그러면 이제 남자가 한 번 하면 여자는 두 번 하고
저른 그르카개 그르캐 하능 기고	절은 그렇게 하게 그렇게 하는 것이고
그라고 인재 절 시키넌 사라미 이써요	그리고 이제 절 시키는 사람이 있서요
그라먼 인재 지금 저사해 보드시 하나가 인재 이꼬	그러면 이제 지금 저에 사회 보듯이 하나가 이제 있고
여패 서서 이꼬	에 옆에 서서 있고
절차는 인재 그개 수럴 실랑은 츠매 부캉재배럴 함 번 함 분 부캉재배럴 하지	에 절차는 이제 그게 술을 신랑은 처음에 북향재배를 한 번 한 번 북향재배를 하지
부칸	북향
부컁재배	북향재배
그거 먼지 하고 시자걸 하넝 거여	그거 먼저 하고 시작을 하는 거야
그 인재 에 수럴 인재 이짜개서 따러 주먼 저짜개서두 따라서 인재멍넌 방시그로 해	그 이제 술을 이제 이쪽에서 따라주면 저쪽에서도 따라서 먹는 방식으로 해
함 번치린 그행 그행살 하고	한 번 치르고 그행 그행사를 하고
그라먼 인재 그 이 행냬는 끈나넌 거지	그러면 이제 그 행례는 끝나는 거지
행냬는 끈나능 기고	행례는 끝나는 거고
그라먼 인재 에 그 신방 차려 논 대로 가기 마려닝 거지	그러면 에 그 신방 차려 놓은 대로 가게 마련인 거지
거기	거기
따루 이따가 따루 이따가 인재	따로 있다가 따로 있다가 이제
거기 상애 그 그르니까 월래는 인재 아까 지쌍이라 그래짜나요	거기 상에 그그러니까 원래는 이제 아까 큰상이라고 그랬잖아요
지쌍애다 차리놔	어 큰상에다 차려놔
그거 그거 가따가 인재 거기다가 차리자나요	그거 그거 갖다가 이제 거기다가차리잖아요
그르치요	그렇지요
그 위애 어떵 거 어떵 거 올려요	그 위에 어떤 거 어떤 거 올려요
그 우애넌 글쌔 인재 이 잔치할라고 음시걸 장마나자나	그 위에는 글쎄 이제이 잔치하려고 음식을 장만하잖아
옌날 잔치넌 지배서 하거던	옛날 잔치는 집에서 하거든
지배서	집에서
예예	예
지배서 하닝깨 손님덜 줄라고 장마난 거 적끄텅 거 하고	집에서 하니까 손님들주려고 장만한 것 적 같은 거 하고
머 인재 어물류라도 이쓰먼 어물류 과일두 줌 차려 노코	뭐 이제 어물류라도있으면 어물류 과일도 좀 차려 놓고
그 우애다 차려 노코 양짜그로 차려 노코	그 위에다 차려 놓고 양쪽으로 차려놓고
인재 울 그라고 인재 행살 치르능 거요	어 그리고 이제 행사를 치르는 거요
행살치러요	행사를 치러요
기 우애 떡뚜 해 노치요	그 위에 떡도 해 놓지요
떡또 대 노치	떡도 해 놓지
떠뚜 개노는	떡도 개 놓는
왜 그리냐하문 떠걸 인재 에 상이라고 보내	왜 그러냐하면 떡을 에 상이라고보내
상이라고	상이라고
상얼 보낸다 이거여	상을 보낸다 이거야
잔치한 음식 이 일쩔하고이거럴 잔치 항거럴 저짝 찌배 보내지	잔치한 음식이 일체하고이것을 잔치한 것을 저쪽 집에 보내지
하인드럴 시키 가주구	하인들을 시켜 가지고
지금 마라자먼 인재 젇새닥 찌배서 먼저 오넝 거지	지금 말하자면 이제 저에 새댁 집에서 먼저 오는 거지
그 상이	그 상이
그기 새다글 디리와야 자 저 실랑언 낭중애 잔치럴 하넝 거닝깨	그게 새댁을 데려와야 저 신랑은 나중에 잔치를 하는 거니까
그리차나요	그렇잖아요
그리닝깨 인재 새다걸 딜구 오먼 이짜개서 인재 또잔치한 그 얘대로 고거럴싸서	그러니까 새댁을 데려 오면 이쪽에서 또 잔치한 그 예대로 그거를 싸서
모가치럴 항 함 모가지 보내넝 거여	에 몫을 한 몫 보내는 거야
그르캐 하능 기 그 상이라카능 거지	그렇게 하는 게 그 상이라 하는 거지
상 보내고 반능거라 카능 거지	상 보내고 받는 거라 하는 거지
그러먼 그 상이 에 음시글 얘기하능 거애요	그러면 그 상이 에 음식을 얘기하는 거예요
음식	음식
음시걸 얘기하능 거지	음식을 얘기하는 거지
음식	음식
음시걸	음식을
노나 머글 음시걸저짝 펴내다 보내주넝 거여	나누어 먹을 음식을 에 저쪽편에다 보내 주는 거야
그라먼 그걸 바드먼 동내애다가 또 골고로 접씨나 이런대 다머 가지고	그러면그걸 받으면 동네에다가 또 골고루 접시나 이런 데 담아 가지고
집찝마다 노나 조따고요	어 집집마다 나누어 주었다고요
여기는	여기는
여기 한 시근 그르캐 해따고	여기 한 식은 그렇게 했다고
그럼 마니 보내야 되갠내요	아 그럼 많이 보내야 되겠네요
여러찌반태	여러 집한테
그릉깨 옌나래 목 목모코리라고 이래 컹 기 이찌	그러니까 옛날에 목코리라고이렇게 큰 게 있지
그거 두 개씩 보내지	그거 두 개씩 보내지
인재 항 거 하난 떡 떵뉴 보내고	이제 한 거 하나는 떡 떡류 보내고
하나넌그 저 과일하고 저 적 머 이 대지고기 다리만 다리 하나	하나는 에그 저 과일하고 저 적 뭐 이 돼지고기 다리만 다리 하나
셰 개까지도 보내고 머 이라넝 거여	세 개까지도 보내고 뭐 이러는 거야
모코리	모코리
모코리라고 이따고	모코리라고 있다고
모코리	모코리
멀루 만드러요	뭘로 만들어요
모코리라루 저 버드나무로 맹그넝 거여 그	모코리라고 저 버드나무로 만드는 거야 그거
버드나무	버드나무
드 저 또랑애	들 저 도랑에
쪼마한 버드나무 이래 쪽쪽 올라오능 거 고거	조그만한 버드나무 이래 쭉쭉 올  라오는 거 그거
베껴 가주 맹그넝 거요	벗겨 가지고 만드는 거요
그거 모코리라카능 기여	그거 모코리라고 하는 거야
모코리	모코리
그거 머 요새 구경도 하기 어려운대요	그거 뭐 요새 구경도 하기 어려운데요
모코리넌 어디 저 방물과니나 이런대 가먼 더러 볼 쑤 이꼬	모코리는 어디 저박물관이나 이런 데 가면 더러 볼 수 있고
기냥 기냥은 그개 암 맹근다고 잘	그냥 그냥은 그게 안 만든다고 잘
옌나랜 다 지배 이떵 거자나요	옛날에 다 집에 있던 거잖아요
그거	그거
그리요	그래요
거기애 그 올려논 중애 용떠기라능 거 이써요	거기에 그 올려 놓는 것 중에용떡이라는 거 있어요
용떡	아 용떡
용떠걸 인재 헤 그기 인재 에 이 떠꾸걸 떡꾹 짠치 하는 집뚜 이짜나	용떡을이제 그게 이제 에 이 떡국을 떡국 잔치 하는 집도 있잖아
떡꾹	떡국
근대 이 에 그기 지영마다 쪼금썩 틀리능 기	그런데 이 에 그게 지역마다 조금씩 다른 게
이 상가기나 요각 이렁 거 우쏘널 대저팔 때는 떡꾸그로 하는 디도 이꼬	이상각이나 요각 이런 거 웃손을 대접할 때는 떡국으로 하는 데도 있고
인재 바부로 하는 대도 이꼬	이제 밥으로 하는 데도 있고
그 지영마다 다르더라고요	그게 지역마다 다르더라고요
그라먼 인재 그기 그 용떡이 가래떡 아니여	그러면 이제 그 용떡이 가래떡 아니야
가래떠그로 맹그능 기 이기 용떠기라카능 기여	가래떡으로 만드는 게 이게 용떡이라하는 거야
근대 그걸 흐니 흐 재 머여 그 행녜쌍 우애다 올려 노치	그런데 그걸 흔히 흐제 뭐야 행례상 위에다 올려 놓지
그리여 그건	그래 그건
그건 어트개 만드능 거애요	그건 어떻게 만드는 거예요
거 쌀 쌀두 쌀두 한 한 시끼 다마 노코 머	그 쌀도 쌀도 쌀도 한 식기 담아 놓코 뭐
여러 가지 그래 다마 논능 기요	여러 가지 그래 담아 놓는 거요
그머 의미가 이 인능 건 가요	그 뭐 의미가 있 있는 건가요
으무가 인능 인능 기 약까는 이따고 봐야 대능 기여	의미가 있기 있는 게 약간은 있다고 봐야 되는 거야
그래닝깨 인재 에 이 다걸 암딱 쑤딱 올리노는 시그로 이 실 실랑 펴내도 하나해 노코	그러니까 이제 이 닭을 암탉 수탉 올려 놓는 식으로 이 신랑 편에도 하  나 해 놓고
또까치 두 개씩 하거덩	똑같이 두 개씩 하거든
거기 올리 논능 건	거기 올려 놓는 건
또꺼치	똑같이
그저 겨론시걸 하닝깨	그저 결혼식을 하니까
남녀가 합처저능깅깨 두 개씨카능 거여	남녀가 합쳐지는 거니까 두 개씩 하는거야
두 개씩 두 개씩	두 개씩 두 개씩
그 구부는 그 그르캐 보먼 대능 기요	그 구분은 그렇게 보면 되는 거요
용떠근 왜 용떠기라 그래요	용떡은 왜 용떡이라 그래요
어트개 만드러요	어떻게 만들어요
그기 요트림그치 이래 맹그라 가주	그게 용트림같이 이렇게 만들어 가지고
고기다 대출 하나 꼽뜬지 이래 꼬바 노치	거기다 대추를 하나 꼽든지 이래 꼽아놓지
그래 용구치 이래 에 시그로 맹그라 논능 기구	그래 용같이 이렇게 식으로 만들어 놓는 것이고
용이 하늘로 올라가는 시그로 해 가주 빠빠타개 새와 노코든	용이 하늘로 올라가는 식으로 해 가지고 빳빳하게 세워 놓거든
용트림	용트림
떠글 그러캐 맨드러요	아 떡을 그렇게 만들어요
허허허허	허허허허
그르캐 하지	그렇게 하지
그러먼 인재 여자 치개서 이르캐 와서 겨론시글 할라면	그러면 이제 여자 측에서 이렇게 와서 결혼식을 하려면
머 오뚜 이버야 대고 머 머리애도 화장도 하고 이렁 거 하자나요	뭐 옷도 입어야 되고 뭐 머리에도 화장도 이런 거 하잖아요
하지	하지
그렁 건 머 머가 이써요	그런 건 뭐 뭐가 있어요
그른대 그렁 건 여자가 하는 기라나서 난 지금두 별 간시멀 안 두구서 잘 모르는대	그런데 그런 건 여자가 하는 거라나서 난 지금도 별 관심을 안 두고서 잘 모르는데
그저내 머 보먼 부넌 바른다카고	그전에 뭐 보면 분은 바른다고 하고
연지곤지 찡는단 마리지	연지곤지 찍는단 말이지
뺄강 거	빨간 거
뺄강 거 치라고	빨간 거 칠하고
어디가 연지고 어디가 곤지애요	어디가 연지고 어디가 곤지예요
연지곤지 머 이래 양짜글 마라능 기고	연지곤지 뭐 이렇게 양쪽을 말하는 거고
여기하고	여기하고
요요요요 요기하고 요기하고 이래 세군대 하지	요요요요 요기하고 요기하고 이렇게 세 군데 하지
세 군대	세 군데
이 연지곤지라 하닝깨 머 이 여가 먼저닝깨 여기 하개찌	이 연지곤지라 하니까뭐 이 여기가 먼저니까 여기 하겠지
연 연 연지라카능가	연 연 연지라고 하는가
여긴 곤지라카고	여긴 곤지라 하고
모르개써요 저는	모르겠어요 저는
허허허허 나도 그 고고럴 확씨랑 걸 모르거써 잘	허허허허 나도 그 그것을 확실한 것을 모르겠어 잘
고리개	그렇게
거기 찍꼬	그거 찍고
오슨	옷은
오슨 인재 에 아이고 그기 머여	옷은 이제 아이고 그게 뭐야
아 이르미 뱅뱅 도넌대	에이름이 뱅뱅 도는데
오선 그 오설	옷은 그 옷을
아이고 머라카나	아이고 뭐라고 하나
소개 임능 거는 머요 저	속에 입는 건 뭐요 저
치 치마	치마
치마	치마
저고리	저고리
저고리인재	저고리이제
치마 저고리 이꼬	치마 저고리 입고
그 우애다가 원삼	그 위에다가 원삼
원삼	원삼
원사미라캐	원삼이라고 해
창 그 원삼	참 그 원삼
원삼	원삼
원삼므로 인재 거도선 하넝 거지	원삼으로 이제 것옷은 하는 거지
원사무로	원삼으로
치마 저고리는 새까리 어떵 거 이버요	치마 저고리는 색깔이 어떤 거 입어요
새까런	색깔은
새까	색깔
새까런 아이고 청홍으로 입떵가	색깔은 아이고 청홍으로 입던가
그르치 아능 거 가티요	그렇지 않은 거 같아요
어디가 청이애요	어디가 청이에요
치마가 청이애요	치마가 청이에요
치마가 치마가 치 치마가 청이 아니자나	치마가 치마가 치 치마가 청이 아니잖아
치마가 홍일껄	치마가 홍일 걸
치마가 홍이고 위애 저고리가 청이고	치마가 홍이고 위에 저고리가 청이고
그러캐 보능 건대	그렇게 보는 건데
머리애두 쓰자나요 또	머리에도 쓰잖아요 또
그 쪽뚜리	그 족두리
쪽또리	족두리
글 쪽또리라그라지	그걸 족두리라 그러지
남자두 머 머리애	남자도 뭐 머리에
남자는 그거시기 에	남자는 그거시기 에
무승 과니라카나	무슨 관이라고 하나
사 사 사 사모	사 사 사 사모
사모	사모
사모관대라카능 기	사모관대라 하는 게
사모	사모
이근 관대넌 이 허리띠는 관대	어 이건 관대는 이 허리띠는 관대
사모관대	사모관대
사모관대라 그래요	사모관대라 그래요
시 바래 신능 거뚜 다르자나요	신 발에 신는 것도 다르잖아요
바래 신능 거뚜 다르지	발에 신는 것도 다르지
그건 머라 그래요	그건 뭐라 그래요
그건 아이고	그건 아이고
좀 장화가치 생겨뜬대	좀 장화같이 생겼던데
장화가치 생 생겨써요	예 장화같이 생 생겼어요
그 향교애서 배완는대도 또 이저버려따고	그 향교에서 배웠는데도 또 잊어버렸다고
이저버려써	잊어버렸어
장화거치 생기찌 그기	장화같이 생겼지 그게
저는 이 이르문 함 번두 모 뜨러바써요 아직까지	예 저는 이 이름은 한번도 못 들어 봤어요 아직까지
거 모콰라구 아나나	거 목화라고 안 하나
목콰	목화
그러구 또 실두 가따 노차나요	그리고 또 실도 갖다 놓잖아요
거기 실	거기 실
시른 청홍실	실은 청홍실
청홍시른 가따 나	청홍실은 갖다 놔
청홍시른 그 따라 댕기넝 거닝깨 머	청홍실은 그 따라 다니는 거니까 뭐
그거 뭉능 거뚜 청홍실로 무끄던	그거 묶는 것도 청홍실로 묶거든
저기 저 사주 쓸 때	사주 쓸 때
그래 청홍시른 따라 댕기여 아주 그건	그래 청홍실은 다라다니는 거야 아주 그건
옌나래도	옛날에도
이유가 인나 인나요	이유가 있나 있나요
그링깨 에 청홍	그러니까 에 청홍
그래 인재 에 남녀럴 구분하능 거	그래 이제 남녀를 구분하는 거
노꼬니지요 그기	노끈이지요 그게
그리고 나서 인재 그거 끈나면	그리고나서 이제 그거 끝나면
시댁 어른드란태 또 인사하고 저라고 이르지요	시댁 어른들한테 또 인사하고절하고 이러지요
인재 그기 당이른 아나지	아 이제 그거 당일은 안 하지
당일라는 아내요	아 당일날은 안 해요
인재 성구리라고 바드면 햐	이제 선구례라고 받으면 해
성구리라고 그라지	선구례라고 그러지
승수리	선구례
선구리	선구례
선구래	선구례
선구래라구 해서	선구례라고 해서
그걸 바드먼부모드란태 하능 기여 인재	그걸 받으면 에 부모들한테 하는거야 이제
왜 그리냐하머 새다기 이 실랑한태 와쓸 때	왜 그러냐하면 새댁이 이 신랑한테왔을 때
실랑이 잔치할 때	어 신랑이 잔치할 때
그 인재 씬부가 하능 기여	그 이제 신부가 하는 거야
씬부가	신부가
성구래넌 어머이 아부지한태 에 저럴 하넝 거	선구례는 어머니 아버지한테 에절을 하는 거
그기 인재 참 저겨론시개 인재 여자가 하는 행봉이요	그게 이제 참 저 에결혼식에 이제 여자가 하는 행동이요
처태	첫째
처째	첫째
그 성구래라 구라지	그 선구례라 그러지
성구래	선구례
그 씨어머이 씨아부지한태 하넝 거여	그 시어머니 시아버지한테 하는 거야
성구래	선구례
그러면 이 이거는 여자가 예시기 끈난 다으매 그지요	그러면 이거는 여자가 예식이 끝난 다음에 그지요
인재 이건 성구래넌그쌔 여자가 여자가 인재 이 씨지벌 와쓸 때 하능 거시여	이제 이건 선구례는 에 글쎄 여자가 여자가 시집을 왔을 때 하는 거야
시지벌 와쓸 때 거 선구래	시집을 왔을 때 거 선구례
잔친날	잔칫날
잔친날	아 잔칫날
천 진사여	첫 인사여
그기 처 진사	그게 첫 인사
옌나랜 그기 처 진사여	옛날엔 그게 첫 인사야
씨어머이 씨아부지한태는	시어머니 시아버지한테는
폐배카고는 어트개 달라요	폐백하고는 어떻게 달라요
페배건그기 인재 페배건 행녜지낼 때 하능 기지	폐백은그게 이제 폐백은 행례지낼 때 하는 거지
행래지낼 때	행례지낼 때
그래 인재 다 끈난 다매 에 예이가 다 끈 예시기 다 끈난 담애	그래 다 끝난다음에 예의가 다 끝나 예식이 다 끝난 다음에
에 페배걸그 머밤하고 머 대추하고 이렁 걸 던진다고 그라고 머	폐백을 에 그 뭐 밤하고 대추하고 이런 걸 던진다고 그러고 뭐
그걸 인재 에 새다기 바다 가주 가등가	그걸 이제 에 새댁이 받아 가지고 가던가
그르캐 하고 그라고 또 인재 오리럴 전다럴 하고	그렇게 하고 그리고 또 이제오리를 전달을 하고
오리넌장모한태 전다럴 하덩가 이라지 아매	오리는 에 장모한테 전달을하던가 이러지 아마
그라도록 대 이따고	그러도록 돼 있다고
오리요	음 오리요
오리	오리
오릴 싸 가주 가개 대고 오리	오리를 싸 가지고 가게 되고 오리
그 그럼 어떤 오리애요	그 그럼 어떤 오리예요
저 사라인는 그 산 오리애요	저 살아있는 그 산 오리예요
아니요나무로 맹긍 거	아니에요 나무로 만든 거
나무로 맹긍 거	나무로 만든 거
나무로 맨등거	나무로 만든 거
흐흐	흐흐
그거 월래 저기 저 저 예시칼 때두 그 상위애두 그거 올려노치 안나요	그거원래 저기 저 저 예식할 때도 그 상위에도 그거 올려 놓지 않나요
올려 놔따가 글쌔 올려 놔따가 예식 다 끈난 다매	아 올려 놨다가 글쎄 올려놨다가 예식 다 끝난 다음에
그 저 장모가 바다 가주가지 아매 그건	그 저 장모가 받아 가지고 가지 아마그건
흐흐	흐흐
그거뚜	그것도
페 페배건인재 각 각까지 과일 이렁 거하고 각까지 마신능 걸 고기다 다마다카고 이렁 걸 다마 가주구	폐 폐백은 에 이제 갖가지 과일 이런 거하고 갖가지 맛있는 걸 거기에 담아서 닭하고 이런 걸 담아 가지고
인재 페배건 하먼	에 이제 폐백은 하면
고 그기 인재 증 마라자먼	그 그게 이제 즉 말하자면 에
페백뚜 여자가 해 가주 오내	아 폐백도 여자가 해 가지고 오네
여작뚜 여자가 해 가주 와 가주구	여자도 여자가 해 가지고 와 가지고
시 이 시지불 오 와서	시 이 시집을 오 와서
그걸 페배걸 가주구 그 대저벌 하능 기여	그걸 폐백을 가지고 그 대접을 하는거야
술하고 가주 와 가가주	술하고 가지고 와 가지고
고건 페배카고 그기 페배기 안주태기여	그건 폐백하고 그게 폐백이 안주 턱이야
안주	안주
시지븐 씨아부지 씨어무이 이 술 대저파고	에 시집은 시아버지 시어머니 이술대접하고
안주가 패배기여	안주가 폐백이야
으 그라고 인재 근 머 간따니 머꼬서 다른 사라미 다 노나 먹찌	으 그리고 이제 그건 뭐 간단히 먹고서 다른 사람이 다 나누어 먹지
그때	그때
그 고들창 고로캐 대 인능 거지	그 원래부터 그렇게 돼 있는 거지
그때 절 하자나요	그때 절하잖아요
절하지 인재	아 절하지 이제
에 절하고	에 절하고
그러구 시아버지 시어머님만 한태 하능 개 아니고	그리고 시아버지 시어머니만한테 하는 게 아니고
인재 가족 가족럴를 안치 노코	이제 가족들을 앉혀 놓고
순서대로 인재 잴먼저 성구리는 저른 그래 바꼬	순서대로 이제 제일 먼저 선구례는 절른 그렇게 받고
나머지는 인재 할 싸람만 메싸람정애 가주 하고	나머지는 할 사람만 몇 사람 에 정해 가지고 하고
그저낸 에 씨어머이 씨아부지만 한태만 하능 거라능 기여 저 이 사실런	그전에는 에 시어머니 시아버지만 한테만 하는 거라는 거야 이 저 사실은
씨어머이 씨아부지한태만	시어머니 시아버지한테만
에 지끄먼 고만 인사하기 겨매가주 겨론시글 해도 그거 하민서 대꾸 인사럴 다시켜 뻐리지	에 지금은 그만 인사하기 겸 해가지고 결혼식을 해도 그거 하면서대구 인사를 다 시켜 버리지
지그먼	지금은
씬시기요 근	신식이요 그건
옌나랜 딱 씨어머이 씨아부지만 한태만 하두룩 대 이따 대 인능 기라능 기요	옛날엔 딱 시어머니 시아버지만 한테만 하도록 돼 있다 돼 있는 거라는 거요
그래요	아 그래요
그개 선구래라능 거애요	그게 선구례라는 거예요
성구리	예 선구례
저는 또 그거 첨 드러써요	저는 또 그거 처음 들었어요
그 말도	그 말도
옌나랜 꼭 그걸 하넝 기요	아 옛날엔 꼭 그럴 하는 거요
근대 페배글 하면	예 그런데 폐백을 하면
시 시댁 씩구드란태 다 이르캐 하는줄 아라꺼등뇨	시 시댁식구들한테 다 이렇게 하는 줄 알았거든요
아녀	아 아니야
그개 아니에요	그게 아니에요
옌나랜 꼭 씨아무이 씨아부지만 한태 하만 하두룩 대 인능 건대	옛날엔 꼭 시어머니 시아버지만 한테만 하도록 돼 있는 건데
지그먼 인재 현대 시그로 해 가주	지금은 현대식으로 해 가지고
다 그만 항 꺼 한 자리애서 그냥 인사차 그래	다 그만 한 꺼 한 자리에서 그냥 인사차 그래
이 사라만태도 하고 저 사라만태도 하 기냥 저럴 한다능 기여	이 사람한테도 하고 저 사람한테도 그냥 절을 한다는 거야
술 한 잔썩 가치 노나 머꼬 이런 시기지	에 술 한 잔씩 같이 나누어 먹고 이런 식이지
옌나랜 그르키 아나능 기여	옛날엔 그렇게 안 하는 거야
그리고 나먼 인재 그 예식뽀러 온 사라들란태 음식두 대저파고 머	그리고 나면 이제 그 예식 보러 온 사람들한테 음식도 대접하고 뭐
또 술두 대저파고 이래자나요	또 술도 대접하고 이러잖아요
그르치요	그렇지요
그건 머	그건 뭐
그렁 건 멀 대저패요	그런 건 뭘 대접해요
어떵 거뜰	어떤 것들
손니모문	손님 오면
소니만태넌	손님한테는
소니만태넌 그쌔 인재 내가 성이껃 손니멀 대저파고 수푸만 머	손님한테는 글쎄이제 내가 성의껏 손님을 대접하고 싶으면 뭐
그기 상가니 움넝 거여	그게 상관이 없는 거야
대지	돼지
옌나랜 돼지럴 대지 주로 자꼬	옛날엔 돼지를 돼지 주로 잡고
아주돈 마는 사라먼 소도 자바 가주 하넝 거여	아주 에 돈 많은 사람은 소도 잡아 가지고 하는 거야
소도 자바 가주 하구 머	소도 잡아 가지고 하고 뭐
성새대로 하능기요 그건	형세대로 하는 거요 그건
머 웬마난 사라먼 그냥 쪼마난 대지 자바 가주	뭐 웬만한 사람은 조그마한 돼지 잡아 가지고
손니멀 쪼만치 청하먼 그래 간따나기도 하고	손님을 조금만 청하면 그렇게 간단하기도 하고
그러닝깨 머 적또 꾸코	그러니까 뭐 적도 굽고
떡뚜 하고	떡도 하고
이래 가주 골고루 지금 저 이 현대 예식짱애서 하능 거나 비스타개 그래 하는대	이렇게 해 가지고 골고루 지금 저 현대 예식장에서 하는 거와 비숫하게 그렇게하는데
지그먼 과일류가 옌나랜 웁쓰니까	지금은 과일류가 옛날엔 없으니까
머 간따난 과일아니요	아 뭐 간단한 과일 아니에요
옌나랜 감 대추 머밤	옛날에는 감 대추 뭐 에 밤
그라고 인저 배거틍 건 이꼬 사과넌 옌나랜 사과두 웁써따구요	그리고 이제배 같은 건 있고 사과는 옛날엔 사과도 없었다고요
우리나란	우리나라는
사과거틍 건 옌나래 써찌요	사과 같은 건 옛날에 썼지요
아주 예나랜 쓰두 아나드라고	아주 옛날에는 쓰지도 안하더라고
그럼 인재 손니무루 인재 잔치찌배 와서	그럼 손님으로 잔치집에 와서
잔치 보러 와따가 가는 분한태는 머 밥이라도 항 끼 식싸대저파고	잔치 보러왔다가 가는 분한테는 뭐 밥 이래도 한 끼 식사대접하고
밥 바배	밥 밥에
바비 아니고 국씨지	밥이 아니고 국수지
국씨	국수
술 주민성 그거 주밍성 인재 에 국씨 항 그럭 주고	술 주면서 그거 주면서 이제 에 국수 한 그릇 주고
국씨 항 그러기 인재 그기 전심 대저파능 기고	국수 한 그릇이 이제 그게 점심대접하는 거고
그라문 인재 수럴 자꾸 더 머그라칼라먼	그러면 이제 술을 자꾸 더 먹으라고하려면
어디 그늘 라무나 어디저지배 인재 이 저 옌나랜 사랑이라 구라지	어디그늘 나무나 어디 저 에 집에 이 옛날엔 사랑이고 그러지
사랑	사랑
사랑방 거튼대다 이래 더 놀다 가라카고 모아 노코	사랑방 같은 데다 이렇게 더놀다 가라고 하고 모아 놓고
자꾸 가따 주지	자꾸 갖다 주지
술 머그라고 가따 주고 다	술 먹으라고 갖다 주고 다
그래 대저벌 항 거지요	그렇게 대접을 한 거지요
저 국씨 먹꼬	저 국수 먹고
그 다매 그러먼 다릉 거 인재 머	그 다음에 그러면 다른 거 이제 뭐
그링깨 인재 타	그러니까 이제 타래반
고기나	고기나
타래바니라구 맹그라 가주	타래반이라고 만들어 가지고
그 인재 채미 쩝씨라고 놔 가주고	그 이제 채미 접시라고 놓아 가지고
아주 국씨 머글 때 아주 모가치루 딱 한 사람 한 사람씩 해서 주지	아주 국수먹을 때 아주 몫으로 딱 한 사람 한 사람씩 해서 주지
그 다매 인재 더 놀다 갈 싸라먼 그런대다 모이 노코	그 다음에 이제 더 놀다가 갈 사람은 그런 데다 모아 놓고
타래바니라구 맹그라 가주	타래반이라고 만들어 가지고
안주	안주
인재 에 안주럴 인재 타래바니라고 이래 줌 여러시 먹뚜룩 맹그라 가주	이제안주를 타래반이라고 이렇게 좀 여럿이 먹도록 만들어 가지고
술하고 자꾸 가따 주지	술하고 자꾸 갖다 주지
술하고	술하고
타래반	타래반
타래바니 머에요	타래반이 뭐예요
상이애요	상이에요
으 상이지	으 상이지
상은 인재	상 이제
똥그랑 거	동그란 거
에 안주럴이재 골고루 해서	에 안주를 이제 골고루 해서
술 안주 대개 해서 여러시 머그라고 가따 주능 걸 타래바니라고 하고	술 안주되게 해서 여럿이 먹으라고 갖다 주는 걸 타래반이라고 하고
타래반	타래반
타래바니라구 하능 개 상만 얘기하능 개 아니라	타래반이라고 하는 게 상만 얘기하는 게 아니라
상 위애 음시글 언즌 걸 얘기하능 겅가요	상 위에 음식을 얹은 걸 얘기하는건가요
음시카구 상하구 다 얘기하능 거요	음식하고 상하고 다 얘기하는 거예요
고 타래바넌 수란주꺼리만 해서 내보내능 거인대	그 타래반은 술 안주거리만해서 내보내는 것인데
인재 바파고 이렁 건 다 미리 다 함 분 대저벌 하고	이제 밥하고 이런 건 다 미리 다 한 분 대접을 하고
일딴 맹긍 거 이렁 거 일쩔	일단 만든 거 이런 거 일체
근 채미	그 채미
채미럴 나 가주고전시마고 가치 대저벌 하고	채미를 놓아 가지고 점심하고같이 대접을 하고
낭중애 수럴 더 머글 때넌 타래바늘 맹그라 가주	나중에 술을 더 먹을 때는 타래반을 만들어 가지고
쑤 쑤란주로 내보낸다 이거여	술 술안주로 내보낸다 이거야
채미	채미
채미	채미
채미라 고라지	채미라고 그러지
여기선 채미라 고란다고	여기서는 채미라 그런다고
채미	채미
그럼 채미가	그럼 채미가
밥 인재 점심 머글 때 따라 내보내능 기여	밥 이제 점심 먹을 때 따라 내보내는 거야
하나패 하낙씩	한 앞에 하나씩
그건	그건
그거 그거는 채미라고 하는대 머 고기도 이꾸	그거는 채미라고 하는데 뭐 고기도 있고
그르치 떡또 노코	그렇지 떡도 놓고
떡뚜 이코 부칭개두 이개 일따는	떡도 있고 부침개도 있고 이게 일단은
다 골고루 해서 채미럴 놔서	어 다 골고루 해서 채미를 놓아서
전심 식싸할 때 에 개이나패 하낙씩 주고	어 점심 식사할 때 에 개인 앞에하나씩 주고
그라고 인재 그걸 다 끈난 다맨 더 놀다 갈 때 인재	그리고 이제 그거 다 끝난 다음에 더 놀다 갈 때 이제
에 별또로 채 참 타래바널 롸 가주고	별도로 채 참 타래반을 놓아 가지고
안주	어 안주
안주 타래바널 롸 가주 여러 사라미 가치 먹뚜룩 내보낸다 이거지	안주 타래반을 놓아 가지고 여러 사람이 먹도록 내보낸다 이거지
잔치럴 그르캐 치르능 거지	잔치를 그렇게 치르는 거지
옌나랜	옛날에
그르니까 채미라고 하능 개 인재 음시기라 음시기라는 뜨시내요	그러니까 채미라고 하는 게 이제 음식이라 음식이라는 뜻이네요
그르치요 으으음시기라는 뜨시야	그렇지요 음식이라는 뜻이야
한 사람이 저 사라만태 주는 음식	한 사람이 저 사람한테 주는 음식
으 아주 별또로 인재 한 사람 항 사라마패 인재 그걸	으 아주 별도로 이제 한사람 한 사람 앞에 그걸
요기 인재 접씨 하나애다가 그 사람 머글 망큼 주능 거	여기 이제 접시 하나에다가 그 사람 먹을 만큼 주는 거
머글 망큼	머 먹을 만큼
고걸 채미라고 거기 인재 머	그걸 채미라고 거기 이제 뭐
채미라	어 채미라
대지고기두 이꼬 떡뚜 이꾸	돼지고기도 있고 떡도 있고
그르치	그렇지
부칭거뚜 이꾸 머 이르캐 골고로	부친 것도 있고 뭐 이렇게 골고루
허허 골고로 맹긍 걸 골고로 해서	허허 골고루 만든 걸 골고루 해서
개별쩌그로 하낙씩 주고	어 개별적으로 하나씩 주고
그러고 인재 그 더 마니 이르캐 상애다가 이걷쩌걷 언저서 가따 주능 거는 그건타래바니라구 하구	그리고 이제 더 많이 이렇게 상에다가 이것저것 얹어서 갖다주는 거는 그건 타래반이라고 하고
타래반	타래반
그 인재 떠 꺼텅 건 아나지 인재	그 이제 떡 같은 건 안 하지
일쩔	일절
과이리나 별또로 고래 담넝 거 우애	과일이나 별도로 그렇게 담는 거 외에
여 기냥 안주 댈꺼 이렁 걸로	여기 그냥 안주 될 거 이런 걸로
떠근 안 느코	떡은 안 넣고
과이른 노코	과일은 놓고
이런 마를 저 첨 드러바요	아 이런 말은 저 처음 들어봐요
흐흐	흐흐
그래니까 이 이렁 거 저 저가 이거 맨날 이르캐	그러니까 이런 거 저 제가 이거 매일 이렇게
허허허	허허허
아무리 차자 다니면서 무러바도	아무리 찾아 다니면서 물어봐도
아니 근대	아니 근데 예
진짜 저 시고래 게소캐서 안니꼬	진짜 저 시골에 계속해서 안 있고
도시애서 살문 그렁 기 웁써저쓰니까	도시에서 살면 그런 게 없어졌으니까
모들 수도 이따고 건	아 모를 수도 있다고 그건
우린 인재 그걸 해 본 사라미고	우린 이제 그걸 해 본 사람이고
또 나거턴 사라먼 이런 사라미라고	또 나 같은 사람은 이런 사람이라고
여기 살민성	여기 살면서
그저내 인재 그런대 가먼 이 저렁 검 저렁 거 담꼬 노나 주 능걸 나한태 채기믈매끼요	그전에 이제 그런 데 가면 이 저런 것 저런 것 담고 나누어 주는 걸 나한테 책임을 맡겨요
방애다 따로해나찌요	방에다 따로 해놨지요
여기 광이나	여기 광이나
그르치 인재	그렇지 이제
에 아주 저 채밀쩝씨라 논는대라고	에 아주 저 채미접시라고 놓는 데라고
아주 저 가방	아주 저 과방
가방이라 카능 겨	과방이라 하는 거야
과방	과방
과방	과방
과방이라고 별또로 아주 이래 방얼 하나 채비하든지 채비해서 거기서 자꾸 놔서	과방이라고 별도로 아주 이렇게 방을 하나 채비하든지 채비해서 거기서 자꾸놓아서
인재 심부릉꾼더리 인재 와서 날라 가지	어 이제 심부름꾼들이 와서 날라가지
그라먼 인재 자꾸 인재 에 손님덜 대저파는대 가따 상애다 가따 놔 가주 가따 주고 이라능 거지	그러면 이제 자꾸 이제 에 손님들 대접하는데 갖다 상에다 갖다놔 가지고 겆다 주고 이러는 거지
그 채김을 내가 엄청 마타 가주 해 본 사라미요	그 책임을 내가 엄청 맡아 가지고 해 본 사람이요
아주	아주
그거 하는 사라믈 머라구 해요	그거 하는 사람을 뭐라고 해요
그 과방쟁이라 그라지 머	그 과방쟁이라 그러지 뭐
과방쟁이	과방쟁이
으흐	으흐
과방쟁이러 이러멀 하능 기지 머	과장쟁이라고 이름을 하는 거지 뭐
과방	과방
과방 보넌 아주 쟁이유	과방 보는 아주 쟁이요
과방 보는 쟁이	과방 보는 쟁이
과방쟁이라 그란다고 그걸	과방 쟁이라고 그런다고 그걸
그거 잘 해야지 대능 거 가뜨라구요	그거 잘 해야지 되는 것 같더라고요
그개	그게
또까치 해야지	똑같이 해야지
그기 으 음시걸 푸근푸근 망 노나 주먼	그게 음식을 푸근푸근 막 나누어 주면
모지래고 암 모지래능 건 그사람드란태 고 고고 보넌 사라만태 달려 가주 이땀마리여	모자라고 안 모자라는 건 그 사람들한테 그거 그거 보는 사람한테 달려가지고 있단 말이야
예예	예예
그래서 우리그튼 사라먼 이런대 우리 일가더리나 이 또 머탄 사람드런 다 이거어티개 해쓰먼 조으까	그래서 우리 같은 사람은 이런 데 우리 일가들이나 이또 뭣한 사람들은 다 이거 어떻게 했으면 좋을까
상이럴 해 보지 나한태	상의를 해 보지 나한테
그라먼 손님 얼매 초청해씀니까	그러면 손님 얼마 초청했습니까
그걸 먼저 무러바야 디야	그걸 먼저 물어봐야 돼
그라먼 인재 손니미 얼매다 이라먼	그러면 이제 손님이 얼마다 이러면
그때 인재 생각때로 대질 메 끈 짜리 자부먼	그때 이제 생각대로 돼지를 몇 근짜리를 잡으면
기냥 노나 머꺼씀니다	그냥 나누어 먹겠습니다
이래 가주 대질 인재 잠능 걸루 하고	이렇게 가지고 돼지를 이제 잡는 걸로 하고
대지도 큰 놈 이꾸 자근 놈 이쓰니까	돼지도 큰 놈이 있고 작은 놈이 있으니까
이 그런 시그로 해서 조정얼 마차 주지	이 그런 식으로 해서 조정을 맞춰주지
그라먼 인재 고걸로 가주 마차선 메기야 인재 정화카개 끈나넝 거지	그러면 이제 그걸로 가지고 맞춰서 먹여야 이제 정확하게 끝나는 거지
쪼꼼 나물 쑤도 이꼬 쪼꼼 모지랠 쑨 인넝 거지	조금 남을 수도 있고 조금 모자랄 수는 있는 거지
그래두 이런댄 그래두 장터니까	그래도 이런 덴 그래도 장터니까
오히려 머 좀 사 나를 껀 사 날라도 대지만	오히려 뭐 좀 사 나를 건 사 날라도되지만
초내는 그거뚜 심든다구요 옌나랜	촌에는 그것도 힘든다고요 옛날에는
그거 어렵쪼	그거 어렵죠
그거뚜 힘드러	그것도 힘들어
옌나래는 머 여름처래는 더워 가주 보관두 어려워짜나요	옛날에는 뭐 여름철에는 더워 가지고 보관도 어려웠잖아요
그릉깨 여르매 자라나지	그러니까 여름에는 잘 안 하지
여르맨 항갑짠치도 자라나고	여름엔 환갑잔치도 잘 안 하고
이 호닌 대사를 여르매 안치르지유	에 이 혼인 대사를 여름에 안 치르지요
무조껀 안치르요	무조건 안 치러요
그래서 봄 가을로 주로	아 그래서 봄가을로 주로
아주	아주
음석 간수하기가 나뿌니까 안하넝 거요	음식 간수하기가 나쁘니까 안 하는거요
그래서 가을 겨울 보매 하능검니다	그래서 가을 겨울 봄에 하는 겁니다
그래서 그르캐 하능 거지요	그래서 그렇게 하는 거지요
난 그르캐 알구 이써	난 그렇게 알고 있어
예저내 저이 그 할머니 보니까 여르매 머 요새까치 냉장고가 이써요 머가 이써요	예전에 저희 할머니 보니까 여름에 뭐 요새같이 뭐 냉장고가 이써요 뭐가있어요
아무 거또 업쓰니까	아무것도 없으니까
아무 거뚜	아무 것도
그르닝깨 글쌔 여르매 하먼 써거서 그 머	그러니까 글쎄 여름에 하면 썩어서그 뭐
아무 거뚜 몬 머글 파니먼 그거 안 대닝깨 여르매 아나능 거지요	아무 것도 못먹을 판이면 그거 안 되니까 여름에 안 하는 거지요
먹따가 밥 까틍 거뚜 나무면 그거뚜 쉬자나요	그러니까 먹다가 밥 같은 것도남으면 그것도 쉬잖아요
그럼뉴	그럼요
그리니까 그거 아까우니까	그러니까 그거 아까우니까
그 저기 그르새 다 저기 싸릿가지나 머 이렁 걸루 하자너요	그 저기 그릇에다 저기 싸릿가지나 뭐 이런 걸로 하잖아요
어어	어
저기 저 아까 버드나무나 이렁 거	저기 저 아까 버드나무나 이런 거
고고 해 가주고 끄느루 무꺼서 새매다가 요러캐 너따가 그르캐두 먹때요	그거 해 가지고 끈으로 묶어서 샘에다가 요렇게 넣었다가 그렇게도 먹데요
그리여	응 그래
근대 옌날 옌나랜 그 인재 술 거틍 거 이릉 거 간수할라먼 새아미다 당구넝 거여	그런데 옛날 옛날에는 그 이제 술 같은 거 이렇게 간수하려면 샘에다 담그는거야
그저 새매두 이름 맘대로 다이써	그저 샘에도 이름이 맘대로 다 있어
그러구 맘머 여러시 대중이 멍는댄 그르치도 모타고	그러고 여러시 대중이 먹는덴 그릏지도 못하고
내 지배 인넌 시앙이면 그 가능한대	내 집에 있는 샘이면 가능한데
그거뚜 힘드능 거람 마리여	그것도 힘든 거란 말이야
옌나랜	옛날에
그럼 아까 인재 국씨 먹짜너요	그러면 아까 이제 국수 먹잖아요
국씨애두 머 위애다가 올려 노쿠 좀	국수에도 뭐 위에다 올려 놓고 좀
깨미라카지	고명이라 하지
응 뀌미	그 고명
끼미	고명
으흐	으흐
그럼 인재 에 잘하넌 사라먼 소고길 사서 소고기 끼밀 한다든지	그럼 이제 에잘하는 사람은 소고길 사서 소고기 뀌미를 한다든지
대지고기 뀌미한다든지 머	돼지고기 고명한다든지 뭐
쪼끔썩 이래	조금씩 이래
그라곤 다 게라널 쌀머 가주 인재	그리고 다 계란을 삶아 가지고 이제
에 참 저 꿔가주구	에 참 저 구워 가지고
꿔가주 잘개 쓰러 가주	구워 가지고 잘게 썰어 가지고
씰꼬추하고 고추는 씰꼬추루 맹그라 가주	실고추하고 고추는 실고추로 만들어가지고
가늘기 쓰러 가주	가늘게 썰어 가지고
고골 올리 노코 이라지	그걸 올려 놓고 이러지
그 그걸 꿰미라 그래요	그걸 고명이라 그래요
으 꿰미라고 이랍디다	으 고명이라고 이랍디다
꿰미한다고	고명한다고
이뿌 잘 그링까 마뚜 나구 보이기두 조캐 할려구 하능 건가요	이쁘 잘그러니까 맛도 나고 보기도 좋게 하려고 하는 건가요
그르쵸	그렇지요
보기 조캐 하기도 하고	보기 좋게 하기도 하고
그 고명이래능 거뚜 이써요	그 고명이라는 것도 있어요
고명	고명
고명	고명
고명언 무슨 마린지 잘 모르건는대	고명은 무슨 말인지 잘 모르겠는데
꿰미	고명
여기선	여기선
고기루두 하구 머	고기로도 하고 뭐
글쌔 고기로도 하능 기여	아 글쎄 고기로도 하는 거야
고기로도 하고 머	고기로도 하고 뭐
김도 뿌시 노코	김도 부셔 놓고
글쌔 그기 게란도	에 글쎄 그게 계란도
게란도 이래 꼬 가주고 하능 겨	계란도 이렇게 구워 가지고 하는 거야
꼬추	고추
꼬치도 뺄강꼬치럴 잘 쓰러 가주 이래 올리 노코 이라능 거	고추도 빨간 고추를 잘 썰어 가지고 이렇게 올려 놓고 이러는 거
국씨 우애는	국수 위에는
그리고 밀까루루 부치능 거 이짜나요	그리고 밀가루로 부치는 것 있잖아요
부치넝 거 이찌	부치는 거 있지
그거 밀까루두 하고	예 그거 밀가루도 하고
녹뚜루두 하고 머	녹두로도 하고 뭐
근대 저니라 두라능 거닝깨 머	근데 전이라고 그러는 거니까 뭐
녹뚜저니니 머	녹두전이니 뭐
청포저니니 머	청포전이니 뭐
그렁 건 저 이 그 곡씨 이름대루 따라서	그런 건 저 이 그 그 곡식 이름대로 따라서
전 부치능 기라 구라지	전 부치는 거라 그러지
그거뚜 곡씨개 따라서 쪼꿈씩 차이가 이찌 안나요	그것도 곡식에 따라서 조금씩 차이가 있지 않나요
곡씨개 따라서 차이가 이깨쪼	곡식에 따라서 차이가 있겠죠
건 다 인능 걸로 바야지	그건 다 있는 걸로 봐야지
제일 마니 항개 멀로 해써요	제일 많이 한 게 뭘로 했어요
제일 마이 하능 건 그 머 지금 이 채소류로 마이 하능 건대	제일 많이 하는건 그 뭐 지금 이 채소류로 많이 하는 건데
그 머 고기로도 마이 하고 지그먼	그 뭐 고기로도 많이 하고 지금은
지금 고기가 마느니까 머 여러 가지로 하능 거니까	지금 고기가 많으니까 뭐 여러 가지로 하는 거니까
전 부치먼 머 머 아주 한 마느닝깨	전 부치면 뭐 뭐 아주 많으니까
주로 멀 마이 하는지 잘 모르거써	주로 무엇을 많이 하는지 잘 모르겠어
그래두 배추나 이렁 기 재일 마늘 꺼여	그래도 배추나 이런 게 제일 많을거야
여기 인재 농사주로 마이 하능 거	여기 이제 농사 주로 많이 하는 거
그렁 거 마이 하지	그런 거 많이 하지
절후애 절후애 따라 다르고	절후에 절후에 따라 다르고
호박 이쓸 땐 호박쩐 마이 꼬 머꼬 머	호박 있을 땐 호박전 많이 구워 먹고 뭐
그 인재 생산댄 시기마덤 쪼꿈썩 달르개 해먹찌	그 이제 생산된 시기마다 조금씩 다르게 해 먹지
전 부처 멍능 기	전 부쳐 먹는 게
밀까루로 하능 거죠	밀가루로 하는 거죠
으 밀까루로 하능 기여	으 밀가루로 하는 거야
그 전	그 전
밀까루애다가 머 저 채 채소류	이 밀가루에다가 뭐 저 채소류
이재 채소류 거틍 거 머 머	이제 채소류 같은 거 뭐 뭐
골고로 골파 머 파 머 여러가지로 하능 거니까요	골고루 골파 뭐 파 뭐 여러가지로 하는 거니까요
그 머	그 뭐
무적또 꿔 먹꼬 머	무적도 구워 먹고 뭐
여러	여러
머또 꿔 머거요	무엇도 구워 먹어요
아이 무정 머	아이 무적 뭐
꼴파정 머	골파적 뭐
두부적 머	두부적 뭐
전 꾸 전 부치넝 거라고 해 가주	전 구워 전 부치는 거라고 해 가지고
머시 안 대능 기 웁찌 머 그	무엇이든 안 되는 게 없지 뭐 그
하먼 되넝 거니까 머	하면 되는 거니까 뭐
금 저카고 저니 다 가틍 거요	적하고 전이 같은 거예요
가틍 거요	같은 거예요
저글 저니라카구	적을 전이라 하고
저걸 저니라 카넝 거여	적을 전이라 하는 거야
무나 골파나	무나 골파나
인재 머	어 이제 뭐
배 배차 이렁 걸로	배 배추 이런 걸로
인재 저기라고도 하고 저니라고도 하넝 거여 건 머	이제 저기라고도 하고 전이라고도 하는 거야 그건 뭐
두 가지루 쓰능 거여	두 가지로 쓰는 거야
또 요마나캐 부치능 거또 이짜나요	또 요만하게 부치는 것도 있잖아요
고렁 건 머 육쩌니니 해 가주구 고렁 거뚜 이찌요	그런 건 뭐 육전이니 해 가지고 그런 것도 있지요
쪼끄망 거	조그만 거
고기로 고기로 맹근다든지	고기로 고기로 만든다든지
이래 가주	이렇게 해가지고
그를 때 그 인재 아까 돼지 잠는 말씀하셔짜나요	그럴 때 그 아까 돼지 잡는 말씀하셨잖아요
그거는 어트개 자버요	그거는 어떻게 잡아요
대지 잠능 건 인재지그먼 머 이 도살짱애서 잡찌만	돼지 잡는 건 이제 어지금은 뭐 이 도살장에서 잡지만
옌나랜 이 지방애서 그냥돌 도로지 그틍 거 하능 거 인재	옛날엔 이 지방에서 그냥도로지 같은 거 하는 거 이제
서루 자바 가주 노나 멍능 걸 도로지라카능 아녀	서로 잡아 가지고 나누어 먹는걸 도로지라고 하는 거 아니야
도로지요	도로지요
그라먼 인재 몬 모이 가주 자바 가주 노나 멍능 거	그러면 이제 모여 가지고 잡아 가지고 나누어 먹는 거
그라먼 인재 에 그기 인재 주로해본 사라미 내가 해본다고 이라먼 그사라미 잡찌요 머	어 그러면 이제 에 그게 주로 에 해본 사람이 내가 해 본다고 이러면 그 사람이 잡지요 뭐
잠능 건	잡는 건
인지 잘줌 그래두 능수개서 자란다카능 사라문 이리 저리 자꾸 와서 자바 달라카먼 자바 주고 이라지	잘 좀 그래도 능숙해서 잘 한다고 하는 사람은 이리저리자꾸 와서 잡아 달라고 하면 잡아 주고 이러지
그 술 기냥 가치 노나 먹꼬	그 술 그냥 같이 나누어 먹고
인재 그 옌나랜 기냥 자바 조	에 이제 그 옛날엔 그냥 잡아 줘
품싸글 부능 거뚜 아니고	품삭을 주는 것도 아니고
지그먼 다 저 도살짱이나 이런대 가서 자꼬	지금은 다 저 도살장이나 이런 데가서 잡고
품싹 주야 자바	품삭 줘야 잡아
옌나랜 기냥 기냥 수리나 한 잔씅 노나 먹꼬	옛날엔 그냥 술이나 한 잔씩 나눠먹고
그 인재 안주꺼리 나옹 거 안주 고고 해 가주 술 머꼬 이라지 머	그 안주거리나온 거 안주 그거 해 가지고 술 먹고 이러지 뭐
도널 주거나 이라진 아넝 거지	돈을 주거나 이러지는 않는 거지
그 돼지 자부면 그걸 여러시 함 마리를 자바서 이르캐 나너 멍능 거 그걸 도로지라 그래요	그 돼지 잡으면 그걸 여럿이 한 마리를 잡아서 이렇게 나눠 먹는걸 그걸 도로지라고 해요
그말도 처음 드러바써요	그 말도 처음 들어 봤어요
허허허	허허허
그르캐 하능 거요	그렇게 하는 거요
옌나랟 돌부리라능 건 머요 그럼	옛날엔 둘부리라는 건 뭐예요 그럼
인재 그 돌부리라 쏘리가 여긴 도라지인대 이 시그로 인재 마럴 표혀하넝 거여	그 돌부리라 소리가 여기는 도로지인데 에 식으로 말을 표현을 하는 거야
그개 가틍 거요	그게 같은 거예요
에 돌부리 마자	에 돌부리 맞아
그게 돌부리	그게 돌부리
도로지	도로지
돌부리라카능 기 더 원 저 표주널끼여	돌부리하고 하는 게 더 원 저 표준어일거야
근대 여긴 도라지라고 그르가는대	근데 여긴 도로지라고 그렇게 하는데
도라지라고 이라능 기 인재 그 표준얼 잘 모표여낭거지	도로지라고 이러는 게이제 그 표준어를 잘 못 표현한 거지
인재 그	이제 그
이 돌부리래능 거는 사저내도 업써요 또	돌부리라는 거는 사전에도 없어요 또
그거뚜	그것도
그 돌부리가 인재 그 도로지라고두 하구	그 돌부리가 이제 그 도로지라고도하고
글쌔 돌부리라구두 인재 하는대 이써요	글쎄 돌부리라고도 이제 하는데 있어요
표여니 쪼곰썩 달라져가주 그를 쑤두 이쓸 꺼요	표현이 조금씩 달라져 가지고그럴 수도 있을 거요
돌부리도 만능 기요 그기 돌부리	돌부리도 맞는 거요 그게 돌부리
돌부리라고도 해요 여기도	돌부리라고도 해요 여기도
돼지 잠능거는 어떤 방버부로 자버요	돼지 잡는 거는 어떤 방법으로 잡아요
돼지 잠능거	돼지 잡는거
돼지 잠능 건 그 지그문 끄시르기두 하고 이라는대 그저낸 터리길 뽑찌요 무럴 디 가주구	돼지 잡는 건 그 지금은 그슬리기도 하고 이러는데 그전엔 털을뽑지요 물을 끓여 가지고
주길 주길 때는 어트개해요	죽일 때는 어떻게 해요
인재 츠매 츠매 죽	이제 처음에 처음에 죽
츠매 주길 때는 이 날카로웅 카럴 가주 모걸 찌름니다	처음에 죽일 때는 이 날카로운 칼을 가지고 목을 찌릅니다
모글 찌르먼 인재 피가 나오지요	목을 찌르면 이제 피가 나오지요
그라먼돼지 그라면 죽씀니다	그러면 에 돼지 그러면 죽습니다
지그문 머 망치로 대가릴 때리 가주 잡꼬 이라지요	지금은 뭐 망치로 대가리를때려 가지고 잡고 이러지요
그래 그저낸 모걸 찔러 가주 피럴 빼구 이라먼 죽씀니다	그래 그전엔 목을 찔러가지고 피를 빼고 이러면 죽습니다
그라먼 인재 그 피는창사구애다 느 가주 피창얼 맹글죠	그러면 그 피는에 창자에다 넣어 가지고 피창을 만들지요
지금도 여거시기 하지요	지금도 여기 에 거시기 하지요
이건 머라 카나	이것은 뭐이라고 하나
손대	순대
순대	순대
에 순대애럴 맹글지요 그 피는	에 순대를 만들지요 그 피는
여러 가지 잡채 참 저 채소거틍 거 마이넝 마시깨 맹글라먼 여러 가질 줌 느가주 써꺼 가주 순대를 맹글지요 피는	여러 가지 잡채 참 저 채소같은 거 많이 넣어 맛있게 만들려면 여러 가지를 좀 넣어 가지고 섞어 가지고 순대를 만들지요 피는
그라고 인재 에 무럴 끄리 가주구 뜨거운 무럴 버 가주 터 터리길 뽑씀니다	그리고 이제 에 물을 끓여 가지고 뜨거운 물을 부어 가지고 털을 뽑습니다
뜨거운 무럴 부먼 터리기가 뭉덩뭉덩 뽀피점니다	뜨거운 물을 부으면 털이 뭉텅뭉텅 뽑혀집니다
이거서 그렁 거지요 껍띠기가	익어서 그런 거지요 껍데기가
아이 껍띠기가 이거찌	아이 껍데기가 익었지
이거 이거 가주 그래 인재	익어 익어 가지고 그래 이제
칼로 깨끄타개 인재 이 때를 삐끼고	칼로 깨끗하게 그이제 이 때를 벗기고
뽀이야캐 비끼 가주구 그 인재 사가기나 머 육까기나 이래 가글 띠서 잘 잡찌요	뽀얗게 벗겨 가지고 그 사각이나 뭐 육각이나 이래 각을 떠서 잘 잡지요
그래 띠 가주 인재 쌈능 거지요 쌀머	그래 떼어 가지고 삶는 거지요 삶아
쌀마서 쌀마서 주로 멍능 기여 옌나랜	삶아서 주로 먹는 거야 옛날에는
이래 가주	이렇게 가지고
그람 대진 자붕 거지요	그러면 돼지는 잡은 거지요
이르키 떼능 거를 각 띤다 그래요	아 이렇게 떼는 것을 각 뗀다 그래요
각 띤다 그라능 기여	예 각 뗀다 그러는 거야
육까그로도 띠고 머 사가그로도 띨라먼 띠고 이래 띠는 띠능 거요	육가으로도떼고 뭐 사각으로도 떼려면 떼고 이래 떼는 떼는 거요
오각또 내고 머	오각도 내고 뭐
부이별로 띠지요 그냥	부위별로 떼지요 그냥
그 돼지 자부면 예저내 그 내장들 이짜나요	그 돼지 잡으면 예전에 그 내장들 있잖아요
내장 이찌요	내장 있지요
그거는 어트개 해써요	그거는 어떻게 했어요
내장언 저 이 돌부리 꼬기로 한다 이라먼거기 수란주로 다 쌀마 머거	내장은 저 이 돌부리 고기로 한다 이러면거기 술안주로 다 쌂아 먹어
쌀마 머거서 그 인재 술하고 그걸 머거 치워 뻐리고	삶아 먹어서 그 이제 술하고 그걸 먹어 치워 버리고
인재 고기는 가끼 팔든지 노나 가든지 이람니다	고기는 각자 팔든지 나눠 가든지 이럽니다
그 아까 피창이라구 하능개	그 아까 피창이라고 하는 게
피창이요	피창이요
그거가 다 만드러 농 걸 너 가꾸 만드릉 걸 얘기하능 거요 그 피만 얘기하능거요	그거 다 만들어 놓은 걸 넣어 갖고 만든 걸 얘기하는 거예요 그 피만 얘기하는 거예요
피창은 글쌔 창사구애다 능 걸 피창이라카능 기고	피창은 글쎄 창자에다 넣은걸 피창라고 하는 거고
그러먼	그러면
옌나랜	옛날엔
옌나랜	옛날엔
지금	지금
요새 순대가 피창이내요	요새 순대가 피창이네요
야 에	네
옌나랜 인재 피창이라 그래써요	옛날에는 이제 피창이라고 그랬어요
순대라고 아나고	순대라고 안 하고
지그먼 순대라 구라지요	지금은 순대라고 그러지요
다 쑨	다 순대
허허허	허허허
다 피창이라구 해뜽 거 가터요 그저내	다 피창이라고 했던 것 같아요 그전에는
여기서는 피창이라구 해따 이거여	여기서는 피창이라 했다 이거야
그거 인저 피럴 고걸 저젇	그거 이제 피를 그걸 저
피를 창사구애 느따구 해서 피창이나 부내요	피를 창자에다 넣었다고 해서 피창이나 보네요
에에에	예 예예예
그러치요	그렇지요
그릉 거지	그런 거지
그렁 거여	그런 거야
저는 어릴 때 그 동내애서 잔치하고 이러먼 돼지 자부먼 그 저 그 머야 저 오줌통	전 어릴 때 그 동네에서 잔치하고 이러면 돼지 잡으면 그저 그 뭐야 저오줌통
오줌통	오줌통
그거 거시 공거치 이래 바라물 느 가주고	그거 공 같이 이렇게 바람을 넣어 가지고
그래가꾸 차구 그랜는데	그래 가지고 차고 그랬는데
그러치요 가주 놀지요 그	그렇지요 가지고 놀지요 그거
허허허	허허허
애드리 머 각 할 쑤 인능 거 그거빠깨 업짜나요	애들이 뭐 할 수 있는 게 그것밖에 없잖아요
마저 그리여	어 맞아 그래
공이 웁쓰니까	공이 없으니까
그러캐 인재 그 잔치 하자나요	그렇게 이제 그 잔치 하잖아요
그럼 그 음식 만드러야 되자나요	그럼 그 음식 만들어야 되잖아요
만드러야지요	만들어야지요
누가 어뜨캐 만드러요	누가 어떻게 만들어요
그릉깨 인재	그러니까 이제
그기 고대 게 얘길 함 분 해 바찌요 우리	그게 아까 계 얘길 한 번 해 봤지요 우리
그 인재 이 경사아애 인재 모이능 게 거틍 걸 하먼	그 이제 이 경사에 이제모이는 계 같은 걸 하면
가치 와서 해 주죠	에 같이 와서 해 주지요
그라고 또 이우싸람더리 그 그렁 행사가 이따먼 다 와서 해줌니다	그리고 또이웃사람들이 그 그런 행사가 있다면 다 와서 해줍니다
옌나랜	옛날에는
다 가치 해써요	다 같이 했어요
나도 가서 해주고 너도 와서 해주는 시그루 다 그래 가치 해찌요	나도 가서 해주고 너도 와서 해주는 식으로 다 그래 같이 했지요
또 그라고 트키나 글쌔 그 혼사께나 이렁 걸 해따 이라먼	또 그리고 특히나 글쎄 그 혼삿계나 이런 걸 했다 이러면
그 사람드리 주로 와서 하지요 머	그 사람들이 주로 와서 하지요 뭐
주로 와서 마이 모이 가주고 하개 하개되지요	주로 와서 많이 모여 가지고 하게 되지요
혼사깨 가틍 거 하면 거기 머 어떵 걸 가따가 이르캐 주나요	혼삿계 같은 거하면 거기 뭐 어떤 걸 갖다가 이렇게 주나요
그 혼사깨 그틍 거 하먼 글쌔 반지 끄틍거 주로 하 해주고 이랍띠다 요기는	그 혼삿계 같은 거 하면 글쎄 반지 같은 거 주로 해주고 이럽디다 여기는
반지요	반지요
이런 반 손	이런 반지 손에
응 반지	응 반지
소내 끼는 반지	손에 끼는 반지
옌나래도 그래써요	옛날에도 그랬어요
옌나래는 옌나래도 인재 그라는 사라미 이찌요	옛날에는 옛날에도 그러는 사람이 있지요
또 그런대 옌나랜 그걸 반지깨 거틍 걸 혼사깨 자라남니다	또 그런데 옛날엔 그걸 반지계 같은 걸 혼삿계 잘 안 합니다
그냥 가서 바 주고 이라고	그냥 가서 봐 주고 이러고
지그문 그렁 걸 마이 해도	지금은 그런 걸 많이 해도
예나랜 그거 마이 아내씀니다	옛날엔 그거 많이 안 했습니다
그저내 보니까 머 막껄리 두 통 이렁 거	그전에 보니까 뭐 막걸리 두 통 이런 거
그르치요	그렇지요
막껄리	막걸리
막껄리 그틍 거 주구 그라지요	막걸리 같은 거 주고 그러지요
그 인재 동내 아줌마드리 와 가주구	그 이제 동네 아주머니들이 와 가지고
또 저 불 피워 가주 거기서 아까 적	또 저 불 피워 가지고 거기서 아까 저
그 적 꾸치요	예 그 적 굽지요
적 꾸코 머 이렁 거 음시걸 가치 협쪼 하지요	어 적 굽고 뭐 이런 거음식을 같이 협조 하지요
그거 저기 꿀 때는 저 솓 그 뚜껑	그거 저기 구울 때는 저 솥 그 뚜껑
그거 뒤지버 가주구 거기서 마니 해찌요	그거 뒤집어 가지고 거기서 많이 했지요
그기 소두방인대 처리라 그라지요	그게 솥뚜껑인데 철이라 그러지요
이건 적 꾼는 처리라 그래요	이건 적 굽는 철이라고 해요
그걸	그걸
보통 때는 소두방으로 쓰능 거자나요	보통 때는 솥두껑으로 쓰는 거잖아요
소두방은 그개 인재 그걸 꾸먼 처리라 그라능 기여	예 솥뚜껑은 그게 이제그걸 구우면 철이라고 그러는 거야
소두방이라고 아나고	소두방이라고 안 하고
그르닝까 소두방으로 쓰다가	그러니까 소두방으로 쓰다가
그런 니리 이쓰먼 그걸 가따가 뒤지버 노코 그 때는 처리라고 한다고	그런 일이 있으면 그걸 갖다가 뒤집어 놓고 그때는 철이라고 한다고
처리라고 고란다고요	예 철이라고 그런다고요
참 우리 으르신드리 옌날 조상드리 이름두 잘 부처써요	참 우리 어르신들이옛날 조상들이 이름도 잘 붙였어요
쓸 때마다 이르믈 다르개	쓸 때마다 이름을 다르게
그르치요	예 그렇지요
인재 거	예 이제 그거
그 소두방두 그르캐 쇠루 됭 거 무쇠루 됭 거자나요 주로	그 솥뚜껑도 그렇게쇠로 된 거 무쇠로 된 거잖아요 주로
그르치요 무쇠요	그렇지요 무쇠요
근대 인재 그렁 거뚜 이꾸 나무루두 맨들때요	그런데 이제 그런 것도 있고 나무로도 만들데요
소죽 까틍 거 끄릴 때	소죽 같은 거 끓일 때
그러치요어	네 그렇지여어    그거는 머라 그래요 그거는 뭐라 그래요
그거뚜 이르미 또까트나요	그것도 이름이 똑같나요
그건 인재 소두방	그건 이제 소두방
그기 소뚜껑이라구 그냥 머래 긍 그래 그래 해주 그라지유 아마 아매	아그게 솥뚜껑이라고 그냥 머래 그건 그래 그래 해도 그러지요 아마 아마
새죽 쏘뚜껑 머	아 소죽 솥뚜껑 뭐
밥쏟 뚜겅이라기도 하고	밥솥 뚜껑이라고도 하고
이라지요	이러지요
근대 옌나래는 그러캐해 가주구 인재 잔치를 하자나요	근데 옛날에는 그렇게해 가지고 잔치를 하잖아요
그러면 인재 나재는 그러캐 음싱머꼬 손님드리 와서 놀다 가고 머 손님드리 와서놀다 가고 머 이르캐 인재 하자나요	그러면 이제 낮에는 그렇게 음식 먹고 손님들이 와서 놀다 가고 뭐 이렇게 이제 하잖아요
그럼 인재 저녁 때 대면 또 저녁 때 인재 머 천날 천날빰 보낸다고 머 이러능 거이짜나요	그럼 이제 저녁 때 되면 또 저녁 때 뭐 첫날 첫날밤 보낸다고 뭐 이러는 거 있잖아요
그르치요	그렇지요
그거 가지고 머 장난도 치고 옌나래 그르지 아나써요	그거 가지고 뭐 장난도치고 옛날에 그러지 않았어요
그거 천날빰 보내능 거 인재 대충 내가 알기는 그 신방얼 차리 주능 거지요	그거 첫날밤 보내는 거 이제 대충 내가 알기는 그 신방을 차려 주는 거지요
인재 음시카고 술하고 머 이렁 걸 조곰 가따 차리 노코	이제 음식하고 술하고뭐 이런 걸 조금 갖다 차려 놓고
천날빠미니깨 이재	첫날밤이니까 이제
거 실랑 신부가 행동하두룩	그 신랑 신부가 행동하도록
그 맹그라 놘 방얼 차리 주지요	그 만들어 놓은 방을 차려 주지요
그라먼 인재 그 뭐 어트카능가 하고 요로캐 문꾸녕을 뚜꼬 디다 봄미다	그럼이제 그 뭐 어떻게 하는가 하고 이렇게 문구멍을 뚫고 들여다 봅니다
허허허  어띠키 하능가	하하하  어떻게 하능가
그렁 거 그기 장나니지요 머	그런 게 그게 장난이지요 뭐
난 그리키 하능 걸루 알고 이써요	난 그렇게 하는 걸로 알고 있어요
그 그 아내 내용언 머 서로 잘 정아캉 건 머	그 그 안에 내용은 뭐 서로 잘 정확한 건 뭐
다 해본 사람드링 걸로 알고 이꼬	다 해본 사람들인 걸로 알고 있고
지그문 그르캐 아나지만	지금은 그렇게 안 하지만
옌날 사람더런 그라먼 인재 에 좀 비내 그틍 걸 뽀바 주고	옛날 사람들은 그  러면 이제 에 좀 비녀 같은 걸 뽑아 주고
옫꼬롬 거틍 거 풀러 주고 머 이런 시그로 아내서	옷고름 같은 거 풀어 주고 뭐 이런 식으로 안에서
그거 어트캐 하능가 뭉꾸녀걸 장난치는 사람더런 고기애 뭉꾸녀걸 뜨꾸 디다 봄니다	그거 어떻게 하는가 문구멍을 장난치는 사람들은 고기에 문구멍을 뚫고 들여다 봅니다
그기 장나니지요 머	그게 장난이지요 뭐
옌나랜 다 창호지루 해끼 때매 침 발라 가꼬 다	옛날에는 다 창호지로 했기 때문에 침 발라 가지고 다
예예 그리잉깨 그쌔	예 그러니까 글쎄
이 이 뭉꾸녀글 뜨꾸 디다 본다고	아 이 문구멍을 뚫고 들여다 본다고
그러 그렁 거 때무내 이써떤 재미 인능 머 이르캐 동내애서 머 싸우미 나따등가 머	그런 거 때문에 있었던 재미 있는 뭐 이렇게 동네에서 싸움이 났다던가 뭐
아니면 또 머 재미 이써떵가 머 이런 얘기	아니면 또 뭐 재미 있었던가 뭐 이런 얘기
이재 그렁 거로넌 머 별로 여기 이써떤 동내도 아니고	이제 그런 것은 뭐 별로여긴 있었던 동네도 아니고
그런 얘긴 머 별로 웁써써요 이동내는	그런 얘긴 뭐 별로 없었었어요 이 동네는
딴 얘길 드러보먼 혹씨 머참 별별 리리 다 이따먼	어 다른 얘길 들어보면 혹시 뭐 참 별별 일이 다 있다면
이런 얘기도 하는 사람더리 이떠구만	뭐 이런 얘기도 하는 사람들이 있더구만
그건 머 자새항 건 우리가	그건 뭐 자세한 건 우리가
하하	하하
모껴칸 사람드리 아니고 또 머 여긴 머 그런 니리 이써떤 대가 아니기 때매	목격한 사람들이 아니고 또 뭐 여긴 뭐 그런 일이 있었던 데가 아니기 때문에
그건 잘 모르개꼬	그건 잘 모르겠고
드른 얘기는 이써요	들은 얘기는 있어요
그렁 거 머	그런 거 뭐
그 그 장 딴 장나니 이써다 머 이런 얘기는실랑이 도망가따 머 새다기 도망가따 이런 얘긴 더러 디끼답 디끼덩구만	그 그 장 다른 장난이 있었다뭐 이런 얘기는신랑이 도망 갔다 뭐 새댁이 도망 갔다 이런 얘긴 더러 들리더 들리더구만
그런 얘긴 더러 디끼더라고	그런 얘긴 더러 들리더라고
그리고 보면 그 그래따가	그리고 보면 그 그랬다가
나중애 그 신부 신부 때개 갈 때 그러덩가요	나중에 또 신부 댁에 갈 때 그러던가요
그 저 실랑 꺼꾸루 매다라 가주구 머	그 저 신랑 거꾸로 매달아 가지고 뭐
그 실랑 다라 멍는다 거 이찌요	아 그 신랑 달구처 먹는다는 거 있지요
그 옌나랜 그기 이 홀래 때는 그기 왜 인느냐 하먼	그 옛날에는 그게 이 혼례때는 그게 왜 있느냐 하면
이재 에 실랑이 인재 새닥 찌배 츰 가능 거지요	이제 에 신랑이 새댁 집에처음 가는 거지요
츰 가문 인재	처음 가면 이제
그 새닥 찌배서 실랑을 딜고 딜로옴니다	그 새댁 집에서 신랑을 데리고 데리러 옵니다
처나미 이따든지 이라먼	처남이 있다든지 이러면
딜러 오먼 가지요	아 데리러 오면 가지요
가먼 인재 천날 저녀개 실랑얼 다라 멍넌다고 고라지요	가면 이제 첫날 저녁에신랑을 달아 먹는다고 그러지요
다라 머거	달아 먹어
다라 멍넌다 구라지요	달아 먹는다고 그러지요
고러문 인재 그 신부 찌배서 인재 준빌 다 하구 이찌	그러면 이제 그게 신부집에서 이제 준비를 다 하고 있지
다하고 이따가	다 하고 있다가
인재 내 오는대	아 이제 내 오는데
그 동아내 아주 참 고야칸 장난널 치는 동내가 이찌요	그 동안에 아주 참 고약한 장난을 치는 동네가 있지요
매다라 노코 인재 발빠다글 뚜디리 패니깨	매달아 놓고 이제 발바닥을 두드려패니까
그거뚜 인재 이 골고루 여러 가지죠	그것도 이제 이 골고루 여러 가지지요
몽딩이로 하는 사람	뭉둥이로 하는 사람
그런 대도 이꾸 목치무루 하는 대도 이꾸	그런 데도 있고 목침으로 하는 데도있고
그라고 되개 아푸개 하는 대도 이꼬	그리고 되개 아프게 하는 데도 있고
기냥 이래 살살 잘 순조로깨 기냥 하는 대도 이꼬 인재 그래서 말로만 하는 대도 이꼬 이르치요 뭐	그냥 이렇게 살살 잘 순조롭게 그냥 이렇게 하는데도 있고 그래서 말로만 하는 데도 있고 이렇지요 뭐
그래도 인재 그라먼 인재 실랑한태 술 요청얼 하거나 해넝 거지요 인재	그래도 이제 그러면 이제 신랑한테 술 요청을 하거나 하는 거지요 이제
그라고 미리 해 능 거 인재 가따 술 머꼬 그래	그리고 미리 해 넣은 것 갖다 술먹고 그래
칭구 인재 살기 보능 거지	친구 이제  보는 거지
씰랑이닝깨	신랑이니까
그동내	그 동네
그런 시기지요	그런 식이지요
실랑 다루능 거	그건 신랑 다루는 거
난 그르캐 알고	난 그렇게 알고
나도 다 재껴 본사라미니깨	나도 다 달려 본 사람이니까
술 가틍 거 으더 머꼬 머 이러면선 놀구 이르캐 장난치능 거지요 그기	술  같은 거 얻어 먹고 뭐 이러면서 놀고 이렇게 장난치는 거지요 그게
그리치 인재 그거지 머	그렇지 이제 그거지 뭐
하라번니문 어트개 하셔써요	할아버님은 어떻게 하셨어요
나도 가닝깨 실랑을 다룬다구 구라대	아 나도 가니까 신랑을 달구친다고 그러대
그 니들 다라바라	그 너희들 달아 봐라
동내가 그르키 앙 큰 동내여써써	동네가 그렇게 안 큰 동네였였어
머 호쑤도 만틀라고	뭐 호수도 많질 않고
청년들도 한 여나문빼깨 안 대드라고	청년들도 한 여남은밖에 안 되더라고
고 동내는	그 동네는
이런 동내는 옌나래 사라미 마늘 때니까 삼심 명도 더 대 여기는	이런 동네는옛날에 사람이 많을 때니까 삼십 명도 더 돼 여기는
또래 청년만 해도	어 또래 청년만 해도
그런디 건 동내가 쪼마내 가주 한 열 명 안쪼기드라고	그런데 거긴 동네가 조그만해 가지고 한 열 명 안쪽이더라고
그 아이 신사저그로 하자구 그 머	그 아이 신사적으로 하자고 그 뭐
다라 매고 머 패대고	어 달아 매고 뭐 패대고
그 말로만 하구 그래	그 말로만 하고 그래
수리나 한 잔 먹짜고라고 난 그래	술이나 한 잔 먹자고 그러고 난 그래
그라고 끈나써찌요	그리고 끝났었지요
허허	허허
그래 쪼미따 술 가주 오지 머	그래 좀 있다 술 가져 오지 뭐
그라고 연정 연방 대번 수럴 가따 가치 노나 머꼬 그래	그리고 연신 연신 대번 술을 가져다 같이 나눠 먹고 그래
그라고 마라찌요	그리고 말았지요
아이 패대는 댄 아주 막사래미 그 다음날 거러 가두 모타개 패대는 동내도이써따능 기여	패대는 데는 아주 막 에 사람이 그 다음날 걸어 가지도 못하게패대는 동네도 있었다는 거야
여기 이 동내는 그러카든 아내써	여기 이 동네는 그렇게 하지는 않았어
그렁 거 보셔써요	그런 거 보셨어요
혹씨 그르캐 시마개 하능 거	혹시 그렇게 심하게 하는 거
시마개 하능 거 우리두 바찌유	심하게 하는 거 우리도 봤지요
바따고	봤다고
어트개 해요 그러면요	어떻게 해요 그러면요
글쌔 그 지개꼬랭이나 이렁 걸 가따 이 발모글 다라 매 가주	글쎄 그 지게 고삐나 이런 걸 갖다 이 발목을 달아 매어 가지고
으 어깨애 미고 뚜디리 패는 대두 이꼬	어깨에 메고 두드려 패는 데도 있고
저 실랑까래는 씰 저 여기 인저 옌나랜	저 시렁에는 시 저 여기 이제 옛날에는
그 옌날 찌번 그런대 저런 씰겅이라고 이써 실겅까래	그 옛날 집은 그런데 저런 시렁이라고 있어 시렁
실겅까래	시렁
두개 이러캐	두 개 이렇게
두 개이래	에 두개 이렇게
멀 물견 언넝 거	무엇을 물건 얹는 거
거기다 가따 막 올가매 노코서 뚜디리 패고 머	거기다 갖다 막 옭아매어 놓고서두드려 패고 뭐
그라는 동내도 이꼬	그러는 동네도 있고
그래 다치머따카는 사람두 마니 드러바꼬	그래서 다쳤다고 하는 사람도 많이 들어 봤고
그 시마개 하는 동내는 그러캐두 함니다	그 심하게 하는 동네는 그렇게도 합니다
잘모타먼 다치자나요	잘 못하면 다치잖아요
그릉깨 글쌔 그이튼날 잘 거러 댕기도 모타개 하는 동내도 이꼬	그러니까 글쎄그 이튿날 잘 걸어 다니지도 못하게 하는 동네도 있고
그르니 동내마둥 다르지	그러니까 동네마다 다르지
하는 방버비	하는 방법이
또까찔 아나	똑같지가 않아
그걸 실랑 다러 멍는다 그래요	그걸 신랑 달구쳐 먹는다 그래요
실랑 다러 멍는다고 그라넝기여	어 신랑 달구쳐 먹는다고 그러는 거야
흐흐	흐흐
다러 멍는다	달구쳐 먹는다
맨 처매 겨론 처매 하셔쓸 때에 시논살림 하자나요	맨 처음에 결혼 처음에하셨을 때 신혼살림 하잖아요
그 처매 겨로나면 인재 살림 해야 대자나요	그 처음에 결혼하면 이제 살림을 해야 되잖아요
그럴 때 멀 준비해 가주구 멀 어떠캐 시작해써요	그럴 때 무엇을 준비해 가지고 무엇을 어떻게 시작했어요
이재 나와 가튼 경우는나도 넝너카지 모타개 살고	이제 나 같은 경우는 어나도 넉넉하지 못하게 살고
여기 우리 안 내자가 넝너칸 지바니 아니여써써요	여기 우리 안 내자가 넉넉한집안이 아니었었어요
그라고 그 아부지가 일찌기 도라가시 가지고머 여덜 쌀 때 도라가시따니까아주 일찌기 도라가셔써	그리고 그 아버지가 일찍이 돌아가셔 가지고 에 뭐 여덟 살 때 돌아가셨다니까 아주 일찍이 돌아가셨어
그래 삼초하고살다가살리물 참 저 시지불 와끼 때미내기냥우린 실 우리 지배 와서 나 살든 그대루 그냥 가치 이래 사라찌 머	그래 삼촌하고 에 살다가살림을 참 저 시집을 왔기 때문에 에 그냥우리는 실 우리집에 와서 나 살던 그대로 그냥 같이 이렇게 살았지 뭐
특뼈랑 거 장마내 가주 살거나 이러친 아나써	특별한 거 장만해 가지고 살거나이렇지는 않았어
그냥 그래	그냥 그래
농사 지 가밍 요러캐 가주 그냥 사릉 거	농사 지어 가면서 이렇게 가지고 그냥산 거
특뼈랑 건 웁써요	특별한 건 없어요
그때 인재 대개 시집까고 그러면 그 혼수루 마려내 가능 거뜨리 필쑤저그루 가저 가능 거가 이썬나요	에 그때 이제 대개 시집 가고 그러면 그 혼수로마련해 가는 것들이 필수적으로 가져 가는 거 있었나요
꼭 까저 가능 거	꼭 가져 가는 거
그쌔 이 꼭 까주 가능 건 이 이불롱얼 해 가주 오기 대 인능 거여	글쎄 이 꼭가져 가는 건 이 이불 농을 해 가지고 오게 돼 있는 거야
이불롱	이불 농
그린대 인재 그기 형펴니 안다먼 그거뚜 인재 그럼 인재 실랑 츠개서 기냥 어사 가주 와서 지낼 쑤두 이꼬	어 그런데 이제 그게 형편이 안 닿으면 그것도이제 그럼 신랑측에서 그냥 싸가지고 가서 지낼 수도 있고
앙 그라먼 그검마넌 필쑤저그로 와 해 가주 오넝 거지	안 그러면 그것만은 필수적으로 와 해 가지고 오는 거지
이부라고 농 하나	이불하고 농 하나
응 고 더코인재 이봉 는넝 거니까 고곤마넌 필쑤저깅 걸로 알고 이써찌요옌나랜	응 그 덥고 에 의복 넣는 거니까 그것만은 필수적인 걸로 알고 있었지요 옛날에는
고기 중요항 기지	그게 중요한 거지
그 옌날 어른들 말쓰미 농은 오동나무루 만드능 개 잴 조타고	그 옛날 어른들 말씀이 농은 오동나무로 만드는 게 제일 좋다고
그러치요	그렇지요
오동나무 농얼 치능 거지요	오동나무 농을 치는 거지요
옌날랜	옛날에는
그기 왜	그게 왜
그 오동나무는 그 부래 자란탄다능 기요	그 오동나무는 그 불에 잘 안 탄다는거요
부래	불에
그라고 개구꾸	그리고 가볍고
그 왜 부래 자란타	그 왜 불에 잘 안 타
그 으냉애서두 마이 쓰능 거 아니유	그 은행에서도 많이 쓰는 거 아니요
으냉	은행
그기 나문 나문대 자란탐니다	그게 나무는 나무인데 잘 안 탑니다
부리 자람부터요	불이 잘 안 붙어요
불따미 웁써 그라고 그건	불땀이 없어 그리고 그건
그래서 화모그로넌 안 써	그래서 화목으로는 안 써
화모건	화목은
그런 특찡이 이찌요	그런 특징이 있지요
불따미 업따구요	불땀이 없다고요
멀 불따미라 그래요	무엇을 불땀이라고 그래요
부리 탐	불이 타는
이 부래다 느먼	이 불에다 넣으면
활활 타능 기 이꼬	활활 타는 게 있고
밍기하니 안 잘 안 타능 걸 그 인재 불땀 웁따카능 거여	밍기하니 안 잘 안타는 걸 그 이제 불땀이 없다고 하는 거야
밍기하니	밍기하니
그 부리 일방 부뚜 아난다고 그렁 거넌	그 불이 금방 붙지도 안 한다고 그런거는
말르긴 말라써도	마르긴 말랐어요
그걸 불따미 업따 그래	그걸 불땀이 없다 그래
이 이 말두 저 첨 드러보는 마래요	이 이 말도 저 처음 들어 보는 말이에요
허허허	허허허
그 인재 오동나무넌 그런 특찡얼 가주구 인넝거 가터 특찡얼 가주고 이따고	그 이제 오동나무는 그런 특징을 가지고 있는 거 같아 특징을 가지고 있다고
아이 그래니 하라번님두 이르캐 뵙꾸 자꾸 이걷쩌걷 재가 배우자나요	아이 그러니 할아버님도 이렇게 뵙고 자꾸 이것저것 제가 배우잖아요
여 대학꾜 교순니미여 거 나안태 좀 무러 볼 끼 이써서	여기 대학교 교수님이야 거 나한테 좀 물어 볼 게 있어서
아이고 안녕하세요	아이고 안녕하세요
또 이르캐 그리구 나서 인재 에 애 생기자나요	또 이렇게 그리고 나서 에 애가 생기잖아요
그러면 인재 그때는 어트개 해써요	그러면 그때는 어떻게 했어요
팔 팔람매 두셔따 그래쓰니까 인재	팔 팔 남매를 두셨다 그랬으니까 이제
그래닝까 머 그때야 머	그러니까 뭐 그때야 뭐
아이 왜 이르캐 더워	아이 왜 이렇게 더워
그땐 이 병원도 마땅차나찌요	그때는 이 병원도 마땅치 않았지요
여기 아주	여기 아주
그래두 인재 다 기양 자연사느로  하능 거 키와찌요	그래도 이제 다 그냥 자연산으로  하는 거 키웠지요
여기 여기 이써요	여기 여기 있어요
허허	허허
무순 말쓰믈	무슨 말씀을
하라버지 그동안 이르캐 쭉 사라오신 얘기	할아버지 그동안 이렇게 죽 살아오신 얘기
그렁 거럴 저기 채크를 가주 가셔여	그런 거를 저기 체크해 가지고 가세요
그래서 나중애 챙 만드러서	그래서 나중에 책 만들어서
보존도 하고	보존도 하고
어디서 오션는대	어디서 오셨는데
청주애서 와써요	청주에서 왔어요
청주	청주
청주 어디서 오신는대	청주 어디서 오셨는데
처으매 저기 팔람매라고 하셔짜나요	처음에 저기 팔 남매라고 하셨잖아요
그때 처매 인재 애가 생겨쓸 때	그때 처음에 이제 애가 생겼을 때
제일 그 맘두 설래고 막 그르자나요	제일 그 마음도 설레고 막 그렇잖아요
그땐 느끼미 어뜨셔써요	그땐 느낌이 어떠셨어요
으흐흐흐	으흐흐흐
그쌔 머 그때야그래도	글쎄 뭐 그때야 에 그래도 에
장모님도 여와 게시구	장모님도 여기 와 계시고
그래서 머모등 거럴 잘 저살 해 주기 때미내	그래서 뭐 에 모든 것을 잘 해 주기 때문에
머 기냥 그래 너머 가찌요 머	뭐 그냥 그래 넘어갔지요 뭐
허허	허허
그러며는 처째	그러면 첫째
처째가	첫째가
따를 하라버님 며쌀 때 나셔써요	딸을 할아버님 몇 살 때 나셨어요
따리	딸이
수물려더래	스물여덟에
수 수 수물 수물 세새 아니여	스 스 스물 스물 셋에 아니야
수물래시라내	스물넷이라네
수무릴고배	스물일곱에
수무릴곱	스물일곱
하라버지 수무릴고배	할아버지 스물일곱에
그러면 군대 군대 가따 오고 나서 한참 이따가 나션내요	그러면 군대 갔다 오고 나서 한참 있다가 낳으셨네요  군대 가따 와서 나찌 군대 갔다 와서 낳았지
좀 이따 나찌요	좀 있다 낳았지요
그때 저기 할 할머니 입떠타고 그르시지 아나써요	그때 저기 할머니 입덧하고 그러시지 않았어요
입떠선 벨루 아나능 거 가티유	입덧은 별로 안 하는 같아요
그 시만 사람드른 아주 애멍능 거 가뜬대	그 심한 사람들은 아주 애 먹는 거같던데
쪼구문 해깨찌요	조금은 했겠지요
아주 아주 아나든 아나찌	아주 아주 안 하진 않았지
아니 어트개 그렁 거꺼지 시마개 그르캐	아니 어떻게 그런 것까지 심하게 그렇게
별거 다 무러 보지요 머	별거 다 물어 보지요 뭐
옌날 산 상 거 요새 요새하고 달라서	옛날 사는 거 요새하고 달라서
허허허	허허허
쩌기 애 나면 처매 처매 나면 바까태도 몬 나가개 하고 그러자나요	저기 애낳으면 처음에 처음에 낳으면 바깥에도 못 나가게 하고 그러잖아요
음식뚜 또 가려서 먹꼬	음식도 또 가려서 먹꼬
그기 옌나래 그기 아니요	그게 옛날에 그게 아니요
아주 한 한 일쭈이른 머 별루 안 나가도 일쭈일만 너무먼 다 나가서 할똥하고 바패머꼬 다 해야 대 옌나랜	아주 한 한 일 주일은 뭐 별로 안 나가도 일주일만넘으면 다 나가서 활동하고 밥 해 먹고 다 해야 돼 옛날엔
그 그기 따캉 거지요 사실 옌날싸람들	그게 딱한 거지요 사실 옛날사람들은
그래서 병 생긴 분들도 만차나요	그래서 병 생긴 분들도 많잖아요
그러치요	그렇지요
옌날엔 그런 실쩡이지요	옛날에는 그런 실정이지요
그름 아이 나쓸 나쓸 때 맨처매는 머 머거요	그럼 아이 낳았을 낳았을 때 맨처음에는 뭐 먹어요
미역꾹빼끼 아내조	미역국밖에 안 해줘
미역꾹	미역국
미역꾹	미역국
미역꾹	미역국
지그먼 별걸 다 해 먹찌만	지금은 별걸 다 해 먹지만
그거 옌나랜 미역꾹뚜 다 제대루 모끄리 주넝 거여	그거 옛날에는 미역국도다 제대로 못 끓여 주는 거야
그건 미여꾸카고 이재 쌀바파고 이르캐 멍능 겅가요	그건 미역국하고 이제쌀밥하고 이렇게 먹는 건가요
그르초	그렇지요
그걸 머라 그래요	그걸 뭐라 그래요
그걸 첟	그걸 첫
척 처꾹빱	첫 첫국밥
처꾸빱	첫국밥
그리구 며칠 똥아는 머 바깨 몬 나가개 한다 그러자나요	그리고 며칠 동안은뭐 밖에 못 나가게 한다 그러잖아요
그개	그게
그리 일주일 간 그래 겅기쭈럴 치능 처농능 거 아니요	그래 일주일 간 그래 금기줄을 치는 쳐 놓는 거 아니요
겅기쭐	금기줄
사람두 모도개 하고	사람도 못 오게 하고
그건 어트개 처요	그건 어떻게 쳐요
겅기쭈런 인재 에 그기 새끼럴 이래 꽈 가주고	금기줄은 이제 에 그게 새끼를이렇게 꼬아 가지고
왠새끼로 꽈 왠새끼	왼새끼로 꽈 왼새끼
왠새끼로	왼새끼로
오른새끼는 이래이래 꼬능 기여겨	오른새끼는 이래 꼬는 거야
왠새끼는 이래 이래 꼰능 기여	왼새끼는 이렇게 이렇게 꼬는 거야
그래 꺼 가주고 거기다 인재 꼬치 거멍 이르캐 다능 기여	그래 꼬아 가지고 거기다 이제 고추 숯검정 이렇게 다는 거야
솔립	솔잎
머 이르캐도 꼬꼬	뭐 이렇게도 꽂고
그거 저기	그거 저기
아더런 꼬치를 꼰넌대 딸만 나먼 수꺼멍하고 솔리파고배깨 아내요	아들은 고추를 꽂는데 딸만 나면 숯하고 솔잎하고밖에 안 해요
허허	허허
제가 지금 그거 여쭤 볼라구	제가 지금 그거 여쭤 보려고
아들하구 따하구 다릉가 해가주구	아들하고 딸하고 다른가 해 가지고
아드른	아들은
아드른	아들은
아드른 다 꼬바요	아들은 다 꼽아요
세 가지	세 가지
솔립	솔잎
그다매 꼬추	그 다음에 고추
꼬추	고추
거멍	숯
거멍	숯
따른 꼬추만 빼구	딸은 고추만 빼고
꼬추만 빼고 인재 두 가지만 해	고추만 빼고 이제 두 가지만 해
그리구서 인재 일쭈일 몬 나가개 하자나요	그리고서 이제 일주일 못 나가게하잖아요
그러면 그 삼치리리라 그래능 거요	그러면 그 삼칠일이라 그러는 거예요
삼치리라 구라넝 거지	삼칠일이라고 그러는 거지
왜 삼치리리라 그래요	왜 삼칠일이라고 그래요
그 그파면 사밀랄 사밀마내도 나가야 대고	아 그 급하면 삼일날 삼일만에도 나가야 되고
머 이링 기여 따지구 보먼	뭐 이런 거야 따지고 보면
옌나래	옛날에
삼치릴 그러문 쓰 한 이시비릴 꺼 까튼대	삼칠일 그러면 한 이십일일 거 같은데
삼치른 이시빌	삼칠은 이십일
이시빌쯤	이십일쯤
에이	에이
삼치리먼뇨 저 삼 주거던뇨	삼칠일이면요 저 삼 주거든요
삼준대 삼 주럴 모디써요	삼 주인데 삼 주를 못 있어요
옌나랜 그냥 한 니빈대 한	옛날엔 그냥 한 입안데 한
한 주일만 이쓰먼 인재 가야 나가야 대요	한 주일만 있으면 이제 가야 나가야 돼요
이리 마나서	일이 많아서
그라닝깨 이르캐 제가 아들 마니 나서 아푼 대가 마나요	그러니까 이렇게 제가 아이들 많이 낳아서 아픈 데가 많아요
대 대기 바뿐 사라먼 그쌔 사밀마내도 나가야 디야	되 되게 바쁜 사람은 글쎄삼일만에도 나가야 돼
사밀마내도	삼일만에도
막 재 이 저 관절로 그냥 아푼 대가 마너요	막 이 저 관절로 그냥 아픈 데가많아요
대개 바뿐 사라먼 사밀마내도 나가야 댄다능 기여	되게 바쁜 사람은 삼일만에도 나가야 된다는 거야
옌나랜	옛날에는
그 일쭈일두  망 나가야 대고 이리여	그 일주일도  막 나가야 되고 이래
할머님두 지금 머 불펴난 대가 마느세요	할머니도 지금 뭐 불편한 데가 많으세요
할머니	할머니
병워내 가 치료도 하고	병원에 가 치료도 하고
이 다리가 간절로 아푸지	이 다리가 관절로 아프지
아나푼 대가 웁써요	안 아픈 데가 없어요
절므셔쓸 때 일 마니 하셔서 다 그렁 거지요	젊으셨을 때 일 많이 하셔서 다그런 거지요
아주 기냥 머 한 이레도 간시니 인재 일쭈일도 간시니 이따가 나가서 인재 내가 다 해야지	아주 그냥 뭐 한 이레도 간신히 이제 일주일도 간신히 있다가 나가서 이제 내가 다 해야지
그르니까 그냥 이 관저리 생겨 가주구 아푼델	그러니까 그냥 이 관절이 생겨가지고 아픈데를
바 저러지 내 얘기가 마자	봐 저러지 내 얘기가 맞아
사밀마내도 나가야 댄다닝깨 글쌔 사밀마내	삼 일만에도 나가야 된다니까 글쎄삼일만에
글쌔요	글쎄요 예
그기 삼치리리유	그게 삼칠일이요
사밀마내도 나간다 쏘리지	삼 일만에도 나간다는 소리지
근대 선생님 생가캐봐유	아 근데 선생님 생각해봐요
팔람매를 나 노쿠 지가 먼대 이르캐 아나푸거써유	팔 남매를 낳아 놓고 제가뭔데 이렇게 안 아프겠어요
그르개유	그러게요
옌나리라 그르캐 마이 나 가주구	옛날이라 그렇게 많이 낳아 가지고
지그문 그르캐 안 나차나요	지금은 그렇게 안 낳잖아요
세장 쫄로리	세상 줄줄이
요새는 머 두리나 머 마니 나야 세시구 그르치요	요새는 뭐 둘이나 뭐 많이낳아야 셋이고 그렇지요
아푼 대만 망코	아픈 데만 많고
기냥 이래 교회를 댕기니깨	그냥 이렇게 교회를 다니니까
하나니미 겅강 주시서 이르캐 그냥 부짜꼬 사라요	하나님이 건강 주셔서 이렇게 붙잡고 살아요
또 막 맘두 좀 펴난해야지요머	또 막 마음도 좀 편안해야지요 뭐
허허허	허허허
애들 배길 하고 돌 하자나요	애들 백일 하고 돌 하잖아요
배길도 하고	예 백일도 하고
그린대 우리는 원청 옌나래 모싸라 가주	그런데 우리는 옛날에 못 살아가지고
배길 돌도 제대로 모태조따고	백일 돌도 제대로 못해 줬다고
지금 싸람더런 머 호화로깨 하지만	지금 사람들은 뭐 호화롭게 하지만
그 머 어트개 바뿌고	그 뭐 어떻게 바쁘고
사라가는대 바쁘고 해	살아가는 데 바쁘고 해
배길 돌 이렁 거 제대로 모태조	백일 돌 이런 거 제대로 못 해줘
어트개 해요	어떻게 해요
예저내는 그래도	예전에는 그래도
그 도라오먼	그 돌아오면
그래도동내싸람덜 떠캐 가주 노나 머꼬	그래도동네사람들 떡해 가지고 나눠 먹고
술 거틍 거 바다다 노나 머꼬	술 같은 거 받아다가 나눠 먹고
배기래는뇨	백일에는요
선생님	선생님
배기래는뇨	백일에는요
그래두 머	그래도 뭐
백썰구 마니 해요	백설기 많이 해요
백썰구	백설기
백썰	백설기
배썰구 아시지요	백설기 아시지요
하얀 백썰구	하얀 백설기
흐흐	흐흐
고고만 해요	그거만 해요
떠캐 가주	떡해 가지고
하하 노나 머꼬	하하 나눠 먹고
고고만 하고	그거만 하고
인재 도래넌 인재 돌떠기래두 하지요	이제 돌에는 돌떡이라도 하지요
애 애 애기한태 떡뚜 돌리라 그런다면서요	애 애 애기한테 떡도 돌리라고 그런다면서요
흐흐흐	흐흐흐
흐흐흐	흐흐흐
인재 모인 사람드란탠 그래 해 보기도 하능 거요	이제 모인 사람들한테는 그렇게 해 보기도 하는 거요
상은 어트개 차려요	상은 어떻게 차려요
돌쌍	돌상
돌쌍은 그쌔 인재 백썰구 그틍 거 하먼	돌상은 글쎄 백설기 같은 거 하면
이래 이우싸람덜 오라캐서두 좀 주고	에 이웃사람들 오라고 해서도 좀주고
노나 주고 머 그르캐 하능 거지	나눠 주고 뭐 그렇게 하는 거지
인재 미여꾹 끄리구	이제 미역국 끓이고
인재 바패 가주구 인재 이르키 나너 머꼬	이제 밥 해가지고 이제 이렇게 나눠먹고
오라캐서 인재	오라고 해서 이제
인재 가까운 인재 자기 형재나 가까운 형재드리나	이제 가까운 이제 자기 형제나 가까운 형제들이나
술 멍는 사람 이쓰문 술두 한 잔 사다 노나 머꼬	술 먹는 사람 있으면 술도 한잔 사다가 나눠 먹고
그 저기	그 저기
수수파떡 카지 안나요	수수팥떡 하지 않아요
쑤수파떠근 돌 돌 때 하지 아매	수수팥떡은 돌 때 하지 아마
돌 때	돌 때
돌 때	돌 때
돌 때	돌 때
돌 때	돌 때
돌 때요	돌 때요
저 자라는 사라문요	저 잘하는 사람은요
무지개떠기라고 이찌요	무지개떡이라고 있지요
백썰구로 해 가주 체루 놔 가주구	백설기로 해 가지고 켜로 놓아 가지고
예예	아 예예
자란 사람 거 무지개떠기라고 체를 롸 가주구	잘한 사람 그 무지개떡이라고켜를 놓아 가지고
체체로 물디리능 거 보기 조라고	켜켜로 물들이는 거 보기 좋으라고
파랑 거 빨강 거 노랑 거 이르캐 해 가주구	파란 거 빨간 거 노란 거 이렇게해 가지고
인재 이르캐 해서 그래 인재 하고	이제 이렇게 해서 그래 이제 하고
인재 수수파떠카고	이제 수수팥떡 하고
예저내 그르캐 해써요	예전에 그렇게 했어요
그래 지그먼 고렁 거또 하고 망 머 인 인절미도 하고 막 부치고 그라자나요	그래 지금은 그런 것도 하고 막 뭐 인 인절미도 하고 막 부치고 그러잖아요
예저낸 그르캐배끼 아내써요	예전엔 그렇게밖에 안 했어요
지끄미나 호화롭깨 하지머	지금이나 호화롭게 하지 뭐
자라는 사라문 더러 그르캐 해꼬	잘 하는 사람은 더러 그렇게 했고
살기가 조아저쓰니까	살기가 좋아졌으니까
애들 키울 때에	애들 키울 때
애 키울 때요	애 키울 때요
제일 기어개 남는 이리 이써요	제일 기억에 남는 일이 있어요
머 애가 아퍼따거나 아니먼 애가 머 조아서 자래서 그래따거나 하여튼	뭐 애가 아팠다거나 아니면 뭐 좋아서 잘해서 그랬다거나 하여튼
인저 그렁 건 더러 이써써요	이제 그런 건 더러 있었어요
애가 머 기애 벌거지가 드러가 가주고	애가 뭐 귀에 벌레가 들어가 가지고
막 날릴 치구 이런 수도 이써꼬	막 난리를 치고 이런 수도 있었고
그라고 인재 또 디기도 하는 수가 쪼꼼 이써꼬	그리고 또 데기도 하는 수가조금 있었고
인재 고런 때가 좀 낭감해찌요	에 그런 때가 난감했지요
어트가다가 귀애	어떻게 하다가 귀에
기개 글쌔 이 옌날 찌번	그게 글쎄 이 옛날 집은
그 지금집보담 다르자나요	에 지금 집과는 다르잖아요
이 기냥 머 벌거지드리 드러갈 공가니 마느니까	이 그냥 뭐 벌레들이 들어갈공간이 많으니까
그릉 기 드러와 가주 귀애 어트개 드러가 가주	그런 게 들어와 가지고 귀에 어떻게 들어가 가지고
바매 날리럴 주길 때가 참 어려워찌요	밤에 난리를 칠 때가 참 어려웠지요
그래서 귀는 안 상해써요	그래서 귀는 안 상했어요
안 상해써요	예 안 상했어요
아유 다행이내요	아유 다행이네요
그거시 빼내 와써	그것이 빼내 왔어
아니 제가 젤 기엉 남능 거럴 항 가지 해 디릴까요	아니 제가 제일 기억남는 거를 한 가지 해드릴까요
할 할머니깨 할머니깨두 따루 또 여쭤 불깨요	할 할머니께 할머니께도 또 여쭤 볼게요
우리 큰따리요	우리 큰딸이요
잴 마지가그때 당시는 머든지 구해짜나요	제일 맏이가 에 그때 당시는 뭐든지 귀했잖아요
그래 가주구서 해 달라능 거뚜 모태 주고	그래 가지고서 해 달라는 것도 못해 주고
또 머 그렁 기 마니 이찌요	또 뭐 그런 게 많이 있지요
근대 기엉남능기 이 시장이 요기가 그저내 쪼꼼 이써써요	근데 기억 남는 게이 시장이 요기가 그전에 조금 있었어요
근대 점빵이 하나 인는대	근데 가게가 하나 있는데
우리 큰딸 그 키우는대 점빵애다 제가 인재 도니 업쓰니깨 모 싸주자나요	우리 큰딸 그 키우는데 점방에다 제가 이제 돈이 없으니까 못 사주잖아요
따라 완는대	따라 왔는데
그래서 인재 모 싸주니까	그래서 못 사주니까
야가 해 달라능 걸 아내주니까요	얘가 해 달라는 걸 안 해주니까요
지 지가 울다가 막 이르캐 까무러치드라고요	지 지가 울다가 막 이렇게 까무라치더라고요
그래 까물르쳐 가주 기저를 해 가주구서넌	그래 까무라쳐 가지고 기절을 해가지고는
이거 기냥 어트가까 시꾸 막	이거 그냥 어떻게 될까 싶고 막
지금 병원도 만차나요	지금 병원도 많잖아요
인재 그때 당시애는 여기 저기	이제 그때 당시에는 여기 저기
인재 이 양바니 알지요	이제 이 양반이 알지요
그 대천약쑤라구 그 그 병워니 하나 이써써요	그 대천약수라고 그 병원이 하  나 있었어요
고 하나만 딱 이써써요	그 하나만 딱 있었어요
거기럴 데리고 인재 가찌요	거기를 데리고 이제 갔지요
가떠니마넌 인재 주사도 노코 어트개 가주 깨 나찌요	갔더니만 이제 주사도놓고 어떻게 해 가지고 깨어 났지요
지가 그때 당시애 얼매나 놀랜는지 몰라요	제가 그때 당시에 얼마나 놀랬는지 몰라요
그 기어기 지금두 이써요	그 기억이 지금도 있어요
그걸 모태줘 가지고 마미 아푸고	그걸 못 해줘 가지고 마음이 아프고
놀래기도 하고	놀라기도 하고
맘도 아푸고	마음도 아프고
속또 상하고 그르차나요	속도 상하고 그렇잖아요
마미 말두 모타개 아파찌요 머	마음이 말도 못하게 아팠지요 뭐
보모 부모드리 참 그 애들한태 잘 모태중 거 그렁 검만 남짜너요	부모 부모들이 참 그 애들한테 잘 못해준 거 그런 것만 남잖아요
허허	허허
허허	허허
그거 옌날싸람더런 어짤 쑤가 움넝 거여	그거 옛날사람들은 어쩔 수가 없는거야
이쓸 쑤 인능 기지	있을 수 있는 거지
마를 하문 말도 모타지요	말을 하면 말도 못하지요
팔람매 키웅 걸 다 얘기 하자먼	팔 남매 키운 걸 다 얘기 하자면
그린대 인재 처따리니까 기냥 고고 항 가지만 얘기해 드리능 거지	그런데 첫딸이니까 그냥 그거 한 가지만 얘기해 드리는 거지
머 옌나랜 그리차나요	뭐 옛날엔 그렇잖아요
웁써 가주구	없어 가지고
이재 또 나이가 게속 들먼 황가파자나요	또 나이가 계속 들면 환갑하잖아요
항가파지요	환갑하지요
항가분 해써요	환갑은 했어요
이 짐 냥바는	이 집 양반은
에휴 인재 줌 아들두 크구	에휴 이제 좀 아이들도 크고
인재 이래 나 살기가 쪼꿈 그냥 저기하고 하니까	이제 이래 나 살기가 조금그냥 저기하고 하니까
애드리 커서 즈더리	애들이 커서 저희들이
할머니는 이르미 어트개 되요	할머니는 이름이 어떻게 돼요
김수니미요	김순임이요
김순임	김순임
순임	순임
이른 일곱싸리고	일흔일곱 살이고
그러면 무슨 띠지요	그러면 무슨 띠지요
돼지띠	돼지띠
돼지띠	돼지띠
학꾜는 어트개 다니셔써요	학교는 어떻게 다니셨어요
저넌 학꾜도 안 댕기써요	저는 학교도 안 다녔어요
학꾜 안 다니시고	학교 안 다니시고
학꾜럴 나럴 댕기개꿈 대 해도 되넌대 우리 어머이가 옌나리라 그라넝가	학교를 나를 다니게끔 해도 되는데 우리 어머니가 옛날이라고 그랬는지
여자가 머 그르캐 그렁 거 해서 머 하냐고	여자가 뭐 그렇게 그런 거 해서 뭐하냐고
안 학 해꾜를 암 보내 주드라구요	안 학 학교를 안 보내 주더라고요
그래서 전 머 안 댕기써요	그래서 전 뭐 안 다녔어요
학꾜럴	학교를
옌나랜 그럴 때여	옛날엔 그럴 때야
댕기넌 사라먼 댕기찌마넌	예 다니는 사람은 다녔지만
저넌 학꾜애도 안 댕기써요	예 저는 학교에도 안 다녔어요
저 하꾜갈 때두 여자애드른 잘 암 보낸는대요 머	저 학교 갈 때도 여자애들은잘 안 보냈는데요 뭐
으 그기 잘 안보내주드라고	응 그게 잘 안 보내 주더라고
그저낸여자더런 어짜다 댕기요	그전에는 여자들은 어쩌다 다녀요
돈 줌 인는 사람드른 보내고	돈 좀 있는 사람들은 보내고
그 등녹끔두 내고	그 등록금도 내고
그래야 되니까	그래야 되니까
수엄뇨 내야 되고	수업료 내야 되고
그래 가주 여가내 암 보내써	그래가지고 여간해 안 보냈어
해해해	해해해
할머니 맨 처매 겨로내쓸 때	할머니 맨 처음에 결혼했을 때
시댁씩구 누구누구 이써써요	시댁 식구 누구누구 있었어요
시댁쓰꾸애 인재 시 저기 우리 시어머니 시아버지 게시고요	시댁식구에 이제 저기 우리 시어머니 시아버지 계시고요
저 냥바나고 인재 저우리 시동상아고 고르캐 니씨꾸드라고요 오닝깨	저 양반하고 우리 시동생하고 그렇게 네 식구더라고요 오니까
니씨꾸 사시는대 우리 아번니미 시아번니미 애 오니깨 아주 마니 아푸시드라고요	네 식구 사시는데 우리 아버님이 오니까 아주 많이 아프시더라고요
마니 아푸시 가주구 저 온 두 달마내 도라가셔써요	많이 아프셔가지고 제가온 두 달만에 돌아가셨어요
인재 사변나는 고이드매 제가 와꺼던요	이제 사변나던 그 이듬해 제가 왔거든요
저 열려서 쌀 머거서 사벼니 나써요	저 열여섯 살 먹어서 사변이 났어요
사벼니 열려서 쌀 머거서 사변 난는대	사변이 열여섯 살 먹어서 사변이 났는데
인재 그 이 지비 폭파내 인재 이기 다 막꼬	이제 그 이 집이 폭탄에 이제 이게 다 맞고
인재 기냥 임시루 흑짱으루 이르캐 지불 지 가주구서	그냥 임시로 흙장으로이렇게 집을 지어 가지고
그래 사시더라고요	그렇게 사시더라고요
인재 아번니미 편차나 가주 두러누시써꼬	이제 아버님이 편찮아 가지고 드러누우셨었고
그래서 인재 그냥 그르키 사라찌요 머	그래서 그냥 그렇게 살았지요 뭐
허허허	허허허
처매요	처음에요
그 와 가주구 인재 그르캐 사는대 폭타내 마자 가주 사닝깨	그 와 가지고 그렇게 사는데 폭탄에 맞아 가지고 사니까
온 오니깨루 머 머가 머가 이써요	오니까 뭐 뭐가 뭐가 있어요
폭탄 마꾸	폭탄 맞고
그냥 식꾸덜만 사라 가주 인는대	그냥 식구들만 살아 가지고 있는데
그래니깨 인재 요래 이런 상이 옌날 상 뚱그렁 거 이짜나요	그러니까 이제 이래 이런 상 옛날 상 동그란 거 있잖아요
쪼마난 뚱그란 상이 인는대	조그마한 동그란 상이 있는데
고기다가 인재 이르캐 또 내 홀목꺼치 요로캐 가농 걸로	고기다가 이제 이렇게 또 내 손목같이 이렇게 가는 것으로
인재 요로캐 네 네구딩이다가 네꾸딩이애다가 요로캐 인재 요로캐 지동얼 해가주구	이제 요렇게 네 네구더이다가 네 구덩이에다가 요렇게 이제 요렇게 기둥을 해 가지고
요로캐 마라자먼 고 상얼 고로캐 쪼마난 상애다가 고로캐 해 가주구 잡쑫떠라고요	요렇게 말하자면 그 상얼 고렇게 조그마한 상에다가 고렇케 해 가지고 잡수시더라고요
사변 나고 인재 고 이듬 와쓰이 머가 이써요	사변 나고 그 이듬해 왔으니 뭐가 있어요
그래서 장도 인재 거 폭탄 마즌 장인대	그래서 장도 이제 그 폭탄 맞은 장인데
재장이더라고요	재장이더라고요
장이	장이
재가 막 그이	재가 막 거기
이 지비 옌날 인재 초가찌비라서 그기 타짜나요	이 집이 옛날 초가집이라서그게 탔잖아요
그라니깨 인재 그 장꽝이 인재	그러니까 이제 그 장독대가 이제
막 이기 지비 폭탄 마자 타쓰닝깨	막 이게 집이 폭탄 맞아 탔으니까
장꽝애 인재 모도 어트개 뿌서전는지	장독대에 이제 모두 어떻게 부서졌는지
어트개 핸는지	어떻게 했는지
그냥 그기 그 이르캐 거더내 재럴 거더내써두 그 장애 소개 재장이 좀 드러가주 이써요	그냥 그게 여기 이렇게 걷어내 재를 걷어냈어도 그 장에 속에 재장이 좀 들어 가지고 있어요
근도 엄쓰닝깨 인재 그거래도 머거야지 어트가거써요	그런데 없으니까 이제그거라도 먹어야지 어떻게 하겠어요
개서 인재 그래 그 재장얼 이재 머꾸	그래서 이제 그래 그 재장을 이제 먹고
머 캐 피란내 그런 재 이르캐 와 가주구 이르캐 사닝깨 모등 기 다 부조캉개 만치요 이재	뭐 이렇게 피란에 그런 이제 이렇게 와 가지고 사니까 모든 게다 부족한 게 많지요
살자먼	살자면
인재 그르캐 기양 사능 게	이제 그렇게 그냥 사는 게
헤헤	헤헤
그르캐 사라써요	그렇게 살았어요
고래 살다 보닝깨 인재	그렇게 살다 보니까 이제
참 쪼꼼썩 이래 나사저 가주구 이르캐 기냥 사라써요	참 조금씩 이렇게 나아져 가지고 이렇게 그냥 살았어요
사는대 그르캐 예저내 이르캐 멍넝 기 그쌔 그러는재	사는데 그렇게 예전에  이렇게 먹는 게 글쎄 그러는지
버리 그렁 버리꼬개라구 이써 가주구서	보리 그런 보릿고개라고 있어 가지고
인재 그 버리가 엉가니 인재 이르캐 이그먼	이제 그 보리가 웬간히 이제 이렇게 익으면
고거럴 뜨더다가 인재 쪼꿈 살살 보까요	그거를 뜯어다가 이제 조금 살살 볶아요
소태다가	솥에다가
소태다가 인재 보꾸만 그게 인재 점 요러캐 어느 정도 저기 말를 정도가 대지요	솥에다가 이제 볶으면 그게 좀 이렇게 어느 정도 저기 마를 정도가 되지요
그라문 고거럴 도구통애다 쾅쾅 안 찌쿠 살짝살짝살짝 찌어요	그러면 그것을절구에다 쾅쾅 안 찧고 살짝살짝살짝 찧어요
그라문 꺼푸리 쪼꼼 버꺼저만	그러면 껍질이 조금 벗겨지면
그걸로 인재 이르캐 밥또 해 머꼬	그걸로 이제 이렇게 밥도 해 먹고
인재 걸 또 매찌 가주고서루 버리떠기라구 또 인재 그거럴	이제 그걸 또 매찧어 가지고서 보리떡이라고 또 이제 그것을
그 찌먼 차지자나요	그 찌으면 차지잖아요
그래서 그걸 버리떠기라고 그거뚜 해 머꼬	그래서 그걸 보리떡이라고 그것도해 먹고
밀도 인재 이르캐 그거뚜 밀도 인재 또 마니 이겅 거 아나고 어지가니 이긍거럴 인재 뜨더다가 인재 그거뚜 버리처럼 그르캐 인재 살살살 보꺼 가주구선 인재 그래 그걸루 이르캐 이 찌먼 그게 인재 그개 밀떠기 대지요 인재	밀도 이제 이렇게 그것도 밀도 이제 또 많이 익은 거 안 하고 어지간히 익은 것을 이제뜯어다가 이제 그것도 보리처럼 그렇게 살살 볶아가지고 그래 그걸로 이렇게 찧으면 그게 이제 그게 밀떡이 되지요 이제
그래 가주구 인재 그걸루 그래 머꼬	그래 가지고 이제 그걸로 그래 먹고
그 피라내 와 가주 그르캐 살라구 하니깨 그키 마니 힘들더라고요	그 피란에와 가지고 그렇게 살려고 하니까 그렇게 많이 힘들더라고요
아주 기냥	아주 그냥
머 아무 거뚜 엄는대 그개 얼마나 힘들개써요	뭐 아무것도 없는데 그게 얼마나힘들겠어요
머 다 타 가주구유	예 뭐 다 타 가지고요
아무 거뚜 웅꾸 그캐 힘들더라가요	아무 것도 없고 그렇게 힘들더라고요
그 힘드르개 사란는대	그렇게 힘들게 살았는데
그기 인재 그 쑥또 인재 이르캐 뜨더다가	그 이제 그 쑥도 이제 이렇게 뜯어다가
인재 가루하고 찌 가주구서 콩얼 인재 당과서 인재 그걸 끄리개 인재 매이다타요	이제 가루하고 찧어 가지고서 콩을 담궈서 이제 그걸 끓이게 이제 맷돌에다가 타요
이르캐 그 맫또리 이짜나요	이렇게 그 맷돌이 있잖아요
거기다가 인재 그걸 가러다가 인재 거기다 콩 주걸 끄리먼	거기다가 이제 그  걸 갈아다가 이제 거기다 콩 죽을 끓이면
밀까루하고 인재 쑤파고 찌 가주구서	밀가루하고 이제 쑥하고 찧어 가지고서
그래 요래요래 수지비럴 인재 콩주개다가 인재 그래 느요	그렇게 요래요래 수제비를 콩죽에다가 이제 그렇게 넣어요
그래 가주구 그거럴 인재 쌀 쪼꿈 느쿠	그래 가지고 그거를 이제 쌀 조금넣고
그래 해 가주구 그걸 인재 수제비	그렇게 해 가지고 그걸 이제 수제비
콩죽수제비라구 그래 해 가주구 그래두 머꾸	콩죽수제비라고 그래 해가 지고그래도 먹고
인재 그라다가 살다 보닝깨 인재 이런 가미 나자나요	그러다가 살다가 보니까 이제 이런 감이 나잖아요
또 가미	또 감이
이런 감나무애 가미 나만	이런 감나무에 감이 나면
가문 인재 이르캐 새파랄 때는 몸 머꾸	감은 이렇게 새파랄 때는 못 먹고
어지가니 이그만	어지간히 익으면
그 버리농사럴 지 가주구서 인재	그 보리농사를 지어 가지고서 이제
저 방애까내 가서 인재 그거럴 찌먼	저 방앗간에 가서 그거를 찧으면
인재 엉가니 씨쿠	이제 어지간히 이제 씻고
인재 고기 낼 쩡도가 대먼	이제 그게 낼 정도가 되면
그 인재 가루가 나와요	그 이제 가루가 나와요
고거 엉가니 낼 쩡도 댈 때	그거 어지간히 낼 정도 될 떄
그래 인재 버리까루럴 으 그 버리쌀 가루럴 그거럴 내 가주구	그래 보릿가루를그 보리쌀 가루를 그거를 내 가지고
가멍가니 이긍 거하구	감 어지간히 익은 거하고
인재 이르캐 가멀 찌 가주구서	에 이제 이렇게 감을 찧어 가지고서
그 또 인재 가루럴 쪼꼼 인재 써꺼 가주구 그래 인재 그거하구 인재 이래 주구	그 또 이제 가루를 조금 이제 섞어 가지고 그래 이제 그거하고 이제 이렇게 주고
밀까루두 인재 그 밀까루럴 인재	밀가루도 이제 그 밀가루를 이제
또 좀 고웅거넌 인재 또 따루 해 노코	또 좀 고운 것은 이제 또 따로 해놓고
이재 또 좀 이르캐 세 섿 세찔로 빼요	이제 또 좀 이렇게 세 세 세 가지로빼요
밀까루를 멘지 농사징거럴 빼먼	밀가루를  농사 지은 것을 빼면
그람 세낄로 하만	그러면 세 가지로 하면
그때두 인재 예저내넌 그리트라고요	그때도 이제 예전에는 그렇더라고요
인재 이르캐 남자더른 좀 인재 쪼꿈 인재 종 걸루 주고	이제 이렇게 남자들은 좀 이제 조금 이제 좋은 걸로 주고
우리 여자더런 인재 좀 그 인재 훔물까루 이렁 걸루 또 국쑤 해 가주구	우리여자들은 이제 좀 그 후물가루 이런 걸로 또 국수 해 가지고
그래서도 머꼬	그래서도 먹고
그 사능 개 그르캐 예저낸 그르캐 사라써요	그 사는 게 그렇게 예전에 그렇게 살았어요
그라고 꼬추농사두 어디 지금거치 그르캐 마능가요	그리고 고추농사도 어디지금같이 그렇게 많은가요
어디	어디
그람 꼬추농사 그르캐 만치 아느만	그러면 고추농사 그렇게 많지 않으면
인재 쪼꿈 인재 꼬추 거틍 거 이르캐 인재 농사지서 인재 하먼	이제 조금 이제 고추 같은 거 이렇게 농사 지어서 하면
꼬치장두 두 가지로 다마 가주구서 인재 그래	고추장도 두 가지로 담궈 가지고 그래
인재 좀 손니미나 오고	이제 좀 손님이나 오고
인재 이르캐 좀 남자덜 오쭘 이르캐 줌 두 아지루 다마 가주구 인재	이제 이렇게 좀 남자들 옷좀 이렇게 좀 두 가지로 담궈 가지고
헤헤헤	헤헤헤
그래 가주구 인재 남자드라고 손니몰 땐 조웅 걸루 노쿠	그래 가지고 이제 남들하고 손님 올 때는 좋은 걸로 놓고
인재 우리드른 그냥 이르캐 머꼬	우리들은 그냥 이렇게 먹고
그 예지 그르캐 사라찌요	그 예전에 그렇게 살았지요
그저내는	그전에는
아까 저 후물까루라 하능개	아까 저 후물가루라 하는 게
밀까루를 찌어서	밀가루를 찧어서
가루가 가루를 조은 고운 가루를 빼구 뒤애 나오는 거 그걸 후물까루라 그러능거애요	가루가 가루를 좋은 고운 가루를 빼고 뒤에 나오는 거 그걸 후물가루라고 그러는 거예요
디애 꺼요	예 뒤에 거요
거기는 밀찌우리라구 또 이써요	거기는 밀기울이라고 또 있어요
뻘겅 거	붉은 거
그 잴 훔물 세 가지거덩요	예 제일 후물 세 가지거든요
인재 처매 빼먼 좀 이개 그 밀껍띠기가 나오기 때매 좀 뿔궁 개 나오거덩뇨	처음에 빼면 좀 이게 그 밀껍데기가 나오기 때문에 좀 붉은 게 나오거든요
그럼 뿔구르망 그거넌 인재 이르캐 또 막	그러면 붉으스름한 그거는 이제 이렇게 또 막
그 왜 밀 그르캐 이르캐 밀 빠수넝 개 이짜너요	그 왜 밀 그렇개 이렇게 밀빻는 게 있잖아요
그람 거 가서 인재 밀개가 이써요	그러면 거기 가서 이제 고무래가 있어요
그라먼 그걸루 끌거내요	그러면 그걸로 긁어내요
얼렁	얼른
슬쩍 빠스러질 때 그걸 끌거내고	슬쩍 부서질 때 그걸 긁어내고
그 인재 빠스먼 그르내 그기 조웅 가루가 나와요	그 이제 빻으면 그런데 그게 좋은 가루가 나와요
뽀양 개	보얀 게
고고 인재 따루 하고	고고 이제 따로 하고
또 인재 또 또 쪼꿈 인재 더 빠수먼	또 이제 또 또 조금 더 빻으면
인재 고 두멀까루가 좀 뿔궁 개 나오지오	이제 그 두물가루가 좀 붉은 게 나오지요
인재 뼈 뿔구루망 그거 인재 또 따루 하고	이제 붉 붉으스름한 그것은 이제또 따로 하고
그 밀찌우리라고 이써요	그 밀기울이라고 있어요
건대 밀찌우리라고 인는대 그건 밀찌 그 인재 찌끄리넌 밀찌우린대 그거럴 인재저 가멀 저런 감 뿔그루말 때 고고럴 그렁 거 인재 따든지 줃 이르캐 떠러징 걸줍떤지 해 가주구 밀찌우래다가 인재 고 가멀 콕콕 찌 가주구서 그래 인재 이르캐 해 가주구 애덜 주구	그런데 밀기울이라고 있는데 그건 밀기 그 찌끄러기는 밀기울인데 그거를 이제 저 감을 저런 감 붉으스름할 때 고것을 그런 거 이제 따든지 줍던지 이렇게 떨어진 것을 줍던지 해 가지고 밀기울에다가 그 감을콕콕 찧어가지고서 그래 이렇게 해가지고 애들 주고
그거 이르미 따로 이써요 그거	그거 이름이 따로 있어요 그
그기 인재 거시기 저 인재 감 감떠기라 구러지	그게 이제 거시기 저 이제감 감떡이라 그러지
감떡	감떡
허허	허허
감떠기라구 해 가주구 그르캐 해 머거떠요	감떡이라 해 가지고 그렇게 해 먹었어요
그 그르캐 여러 가지럴 해서 먹따 보닝깨 그르캐 머깨 대더라고요	그 그렇게 여러 가지를 해서 먹다가 보니까 그렇게 먹게 되더라고요
여기가 가미 마니 나오는 대니까 인재 그르캐	여기가 감이 많이 나오는 데니까이제 그렇게
그러면 그 그 감 떠 떠 뜰붕 건 업써저요	그러면 그 그 감 떫 떫 떫은 건 없어져요
쯔먼 업써저요	예 찌면 없어져요
왜 예저내 삭까루 이짜나요	왜 예전에 사카린 있잖아요
삭까루럴 인재 무래다 타 가주구 쪼꿈 써꺼 가주 버무리지요 인재	사카린을이제 물에다 타 가지고 조금 섞어 가지고 버무리지요 이제
그 밀찌우래다가	그 밀기울에다가
그래서 써꺼 가주구서 그래서 쩌먼	그래서 섞어 가지고 그래서 찌면
인재 그거를 이르캐 뭉치 가주구 애덜 주먼 그 잘 머거요	그거를 이렇게 뭉쳐가지고 애들 주면 그렇게 잘 먹어요
애더리	애들이
떠기라고 허허	떡이라고 허허
그르캐 머꾸	예 그렇게 먹고
인재 그기 이르캐 해 가주 사능 거넌 그기 일리리 다 말 모태요	그게 이렇게 해 가지고 사는 것은 그것은 일일이 다 말 못해요
예저내 그르키 산 생가글 해 보먼	예전에 그렇게 산 생각을 해 보면
이거 머 제 제처래 머끼 어려우니까 그냥 미리두 줌 이끼두 저내 뜨더다 머꾸 머이러자나요	이거 뭐 제철에 먹기 어려우니까 그냥 미리도 좀 익기도 전에 뜯어다 먹고 뭐 이러잖아요
그러묘	그럼요 예
아까 저 저기 머야	아까 저 저기 뭐야
수 수수	수 수수
쑤수때 그거	수수깡 그거
쑤쑤때	수수깡 예
그걷	그거
부지러 가주구	부러뜨려 가지고
부지러 가주구 이르캐 저기 훌틍 거뚜 결구근	부러뜨려 가지고 이렇게 저기 훑은 것도 결국은
그건 나라그루 인재	그런 나락을 이제
쌀라라 쌀라오는 나라글 그걸루 훌터 가주구	예 쌀나락 쌀 나오는 나락을 그걸로 훑어 가지고
인재 방애애다 찌서 얼렁 얼렁 머걸라거	이제 방아에다 찧어서 얼른 얼른 먹으려고
인재 그릭 그리캐	이제 그렇 그렇게
머라구요	뭐라고요
초련 멍는다 그래	초련 먹는다고 그래
초련	초련
초련	예 초련
초련	초련
초련	초련
저 그말두 지금 첨 드러보능 건대요	저 그 말도 지금 처음 들어보는 건데요
초려는 인재	초련은 이제
초 초려내	초련에
잴 츠매 할찌개	제일 처음에 할 적에
초려내 멍넌 거럴 인재 업씨 살다 보니까	초련해 먹는 거를 이제 없이 살다가 보니까
초련 멍는 방애럴 인재 그르캐 가주 찌서 먹찌요	초련 먹는 방아를 이제 그렇게 해 가지고 찧어서 먹지요
방애까내 가서	방앗간에 가서
초려니라 고란다고	초련이라고 그런다고
츠매 그래 훌터 가주구 해문	처음에 그렇게 훑어 가지고 하면
그걸 초련 멍는다 그래요	그걸 초련 먹는다 그래요
초련 머걸 때 그리캐 해 가주 먹지요	예 초련 먹을 때 그렇게 해 가지고먹지요
그거 얼렁 머 얼렁 익찔 모타자나요	그거 얼른 뭐 얼른 익지를 못하잖아요
배가 고푸고 하니깨	배가 고프고 하니까
그걸 인재 훌터다가 이거 홀찌깨라구 그래요	그걸 이제 훑어다가 이것을 벼훑이라고 그래요
그 홀찌깨 인재 쑤수때로 맨드릉 기 그기 홀찌깨요	예 벼훑이 수수깡로만든 게 그게 벼훑이요
홀찍깨	예 벼훑이
훌트 훌룬다고 훌찍깨라구 구라대요	예 훑는다고 벼훑이라고 그러데요
이르캐 하고	예 이렇게 하고
인재 그 방애두 인재 찌먼 그거 인재 그거두 버리쌀 다 나올 때 그거 나옹거 인재 그 버리쌀 내고	이제 그 방아도 이제 찧으면 그거 인제 그것도 보리쌀다 나올 때 그거 나온 거 이제 그 보리쌀 내고
이랄 때 나오능 거 그걸루 인재 애덜 사까루 느 가주구	이럴 때 나오는 거그걸로 애들 사카린 넣어 가지고
이래 또 그걸루 또 이르캐 개떠글 또 만드러 가주구	이제 또 그걸로 또 이렇게 개떡을 또 만들어 가지고
그래두 주구	그래도 주고
그르캐 사라써요	그렇게 살았어요
사능 기	사는 게
흐흐흐	흐흐흐
그라다가 내덜두 크구	그러다가 애들도 크고
인재 모두 인재 공부두 이래 갈치구 하니깨 즈더리 다 나가서 살구	이제 모두이제 공부도 이렇게 가르치고 하니까 자기들이 다 나가서 살고
인재 이래 사니깨 애더리 돈 조 가주 인잰 이르캐 사라요	이제 이렇게 사니까 애들이 돈 줘 가지고 이제 이렇게 살아요
허허허	허허허
할머니 절머쓸 때 고생하셔쓰니	할머니 젊었을 때 고생하셨으니
인잰 머 노녀내는 쪼꼼 그래두 맘 펴나개 이쓰셔야지	이제 뭐 노년에는 조금 그래도 마음 편하게 있으셔야지
아이 피라내 머	아이 피란에 뭐
장녀내 인재 사	작년에 이제 사
저기 피라 머 다 타뻐리고 아무 거뚜 움넌대	저기 피란 뭐 다 타버리고 아무 것도 없는데
오니깨 글쌔 그냥 흐그루 지벌 만드러 가주	오니까 글쎄 그냥 흙으로 집을 만들어 가지고
흑짱지불 지코	흙장집을 짓고
요 아내만 요래 발라 가주 살더라고요	요 안에만 이렇게 발라 가지고 살더라고요
요래 아내만	이렇게 안에만
아내만 인재 발라 가주 그래 살구	안에만 발라 가지고 그렇게 살고
우리 인재 아번니먼 그르캐 펜차느시 가주구 인재 게시는대	우리 이제 아버님은 그렇게 편찮으셔 가지고 이제 계시는데
머 우리 사춘 시아즈바이가 야꾸걸 하는대	뭐 우리 사촌 시아주버니가 약국을 하는데
그 야글 암만 지다 써도 안 드시고	그 약을 아무리 지어다 써도 안 듣고
그래 들떨 아나드라고요	그래  듣지를 않더라고요
그래 가주구서 인재 저 온 두 달마내 도러가시써	그래 가지고서 저 온지 두달만에 돌아가셨어
워나개 머 그 예전 어르신드리 드시능 거뚜 만 만 모뜨시지	워낙에 그 예전 어르신들이 드시는 것도 많 많이 못 드시지
고생은 고생대로 하시지	고생은 고생대로 하시지
그런대다가 머 치료나 재대로 되깨써요	그런데다가 뭐 치료나 제대로 되었겠어요
그르니깐	그러니깐
사머 그전 저뿌니 아니라	사뭇 그전 저뿐만 아니라
제 또래나 저 우칭이나 이래 그 머 다 그르캐 고생하고 사라짜나요	제 또래나 저 위층에나 이렇게 그 뭐 다 그렇게 고생하고 살았잖아요
지금 우리 미태칭서부터먼	지금 우리 밑에층서부터는
인재 가마니 보먼 그런 경얼 안 재끼찌요	가만히 보면 그런 경우를 안 겪었지요
우리 우칭하구 저하구넌 그런 경령얼 지끼찌마는	우리 위층하고 저하고는 그런 경험을 겪었지만은
우리 미태 칭더런 그렁 걸 몰루구 사라찌요	우리 밑에 층들은 그런 걸 모르고살았지요
고 미태서부텀 차차차차 지끔까지 인재 그랭개 업찌요	그 밑에서부터 차차차차 지금까지 그런 게 없지요
조아저찌요	좋아졌지요
하라버지 그르신대 팔람매라 그르셔짜나요	할아버지가 그러셨는데 팔 남매라그러셨잖아요
아까 할머니두	아까 할머니도
예예	예예
팔람	팔 남
지금 다 어디 어디 가서 사라요	지금 다 어디어디 가서 살아요
지금 인재 저기 저 이천 이천 가서 이써요	지금 이제 저기 저 이천 이천가서 있어요
우리 네째 아더리	우리 넷째 아들이
이천 거기 가서 인재 그 현대자동차애 인재 거기 가서	이천 거기 가서 그현대자동차에 이제 거기 가서
기냥 밤 머꼬 살가요	그냥 밥 먹고 살아요
그라고 우리 큰따른 이 잴 큰따리 저 대구	그리고 우리 큰딸은 이 제일 큰딸이 저 대구
대구 살고	대구 살고
개 서저마고 사라요	게 서점하고 살아요
대전서	대전서
그라고 인재 우리 크나더리 인재 우리 딸미태가 인재 크나더린대	그리고 이제우리 큰아들이 이제 우리 딸 밑에가 큰아들인데
대전 사라요	대전 살아요
대전 그 으나수 아빠트애 가 살거던요	대전 그 은하수 아파트에 가 살거든요
거기 사는대	거기 사는데
거기서 인재 대전교도소라카능대 거기 이써요	거기서 이제 대전교도소라고 하는데 거기 있어요
교도관이싱가	교도관이신가
교도가내 거기 이꾸	예 교도관으로 거기 있고
우리 두째 딸도 인재 대저니꾸요	우리 둘째 딸도 이제 대전 있고요
근대 우리 세 우리 세째 아더런 대구인넌대	그런데 우리 세 셋째 아들은 대구있는데
대구 가 이써요	대구에 가 있어요
우리 세째 아들두	우리 셋째 아들도
대구 가 이꼬	대구 가 있고
인재 우리 망내따른 저 부여라는대 가서 이써요	우리 막내딸은 저 부여라는데 가서 있어요
충남	충남
그라고 인재 우 아덜로 해서 망내가 여기 유성기어배 취지캐 가주	예 그리고 아들로 해서 막내가 여기 유성기업에 취직해 가지고
그래 댕기구	그래 다니고
다 머 잘	다 뭐 잘
기냥	예 그냥
게시내요	계시네요
애더리기냥 그래	예 애들이그냥 그래
그저낸 그르캐 사느라고 가덜 갈치고 이랄 때넌 막 담배농사 해짜나요	그전에는 그렇게 사느라고 그애들 가르치고 이럴 때는 막 담배 농사 했잖아요
담배농사럴 한	담배농사를 한
그르캐 담배농사 해 가주구 우리 아덜 갈치구	그렇게 담배 농사를 해 가지고우리 아이들 가르치고
그때 당시는 또 이르캐 사내끼를 꽈 가주구서 지부루 이르캐 이르캐 여꺼써요	그때 당시는 또 이렇게 새끼를 꼬아 가지고서 짚으로 이렇게 이렇게 엮었어요
담배럴	담배를
하나씩 다 끼워짜나요	하나씩 다 끼웠잖아요
다 끼 가주고요	다 끼워 가지고요
그래 여꺼 가주구서 그걸 해 가주구	그래 엮어 가지고서 그걸 해 가지고
막창이라고 이써요	막창이라고 있어요
여 야지 다라 나오자나요	여기 야지리 달아 나오잖아요
인재 달때애다가 우애서부 야지야지 다라 나와 가주구	달대에다가 위에서부터야지야지 달아 나와 가지고
그거뚜 으디 저기 머 하 한 줄빼기두 두 아니구	그것도 어디 저기 뭐 한 한줄빼기도 또 아니고
그기 마나요	그게 많아요
아주 기냥 그래 가주 그 건조시리라는 대 꽉 차 가주구서	아주 그냥 그래가지고 그 건조실이라는 데 꽉 차 가지고
막창이라는디럴 라오먼 사라미 망 무래 탁 빠징 거 거터요	막창이라는 데를나오면 사람이 막 물에 탁 빠진 거 같아요
막창깨 나와서	막창께 나와서
맨 끄파내 인재 하구 이르캐 나올 때는	맨 끝판에 이제 하고 이렇게 나올 때는
인재 그 달때라능 개 인는대	그 달대라는 게 있는데
그걸 바꼬서 그러캐 하는대	그걸 밟고서 그렇게 하는데
그건 이르캐 얼마나 그기 힘드러요	그건 이렇게 얼마나 그게 힘들어요
산내끼루 꽈 가주구 하능 기 그르캐 핸는대	새끼로 꽈 가지고 하는 게 그렇게했는데
그라다 봉깨 우리는 그거럴 인재 하다가	그러다 보니까 우리는 그거를 하다가
인재 아덜두 크구 이라구 아내써요	이제 아이들도 크고 이러고 이제 안 했어요
인재 그냥 기냥 애덜두 이르캐 저기 하구 한다 그래먼	그냥 그냥 애들도 이렇게 저기 하고 한다고 그러면
나중애 하는 사람덜 보니깨 엄청 시워요	나중에 하는 사람들 보니까 엄청쉬워요
그냥 인재 막 다발채 이르캐 따다가요	그냥 이제 막 다발채 이렇게 따다가요
다발로이랜 저그 저기가 이때요	다발로 에 이런 저기 저기가 있대요
저 철짱으로 이르캐 해 농 기	저 철장으로 이렇게 해 놓은 게
한다 한다발썩 기냥 가따 그걸 탁 풀러 가주구서	한다 한다발씩 그냥 갖다 그  걸 탁 풀러 가지고
짝 까라 노쿠서넌 우애다가 인재	쫙 깔아 놓고서는 위에다가 이제
그거뚜 철짱 여 여 널비가 요고만 요마넌 하지요	그것도 철장 요 요 너비가요고만 요만은 하지요
근대 그걸루 탁 까따 노쿠서 인재 이르키 그	그런데 그걸로 탁 갖다 놓고서이제 이렇게 그
기기 저기 이캐 거기 짱구넝 개 이때요	그게 저기 이렇게 거기 잠그는 게 있더라고요
가따 꽝 눌러노먼 짝 양짜개 다 땡기거드뇨	갖다 꽉 눌러 놓으면 짝 양쪽에다 묶거든요
그람 가따 그걸루 기냥 하니깨 그르캐 십때요 오냥	그러면 갖다 그걸로 그냥하니까 그렇게 쉽데요 워낙
아이구 우리는 그르캐 힘들개 해 가주 사라써요	아이구 우리는 그렇게 힘들게 해 가지고 살았어요
그저내 기냥 산내끼 꽁 골루 점부 끼 가주구	그전에 그냥 새끼 꼰 걸로 전부끼워 가지고
그래서 그르캐 해 가주구 인재 애더럴 갈치 가주 이르캐 사란는대	예그래서 그렇게 해 가지고 이제 애들을 가르쳐 가지고 이렇게 살았는데
인재 바번 머꼬 사라요	이제 밥은 먹고 살아요
즈더리 인재 기냥 모두	자기들이 그냥 모두
가서 사니까 허허	가서 사니까 허허
손두 마니 가자나요	손도 많이 가잖아요
그 담배농사가	그 담배농사가
말도 모태요	말도 못 해요
그때넌 꼭찌 지짜나요	그때는 꼭찌 짓잖아요
지그문 지그문 시워요	지금은 지금은 쉬워요
조릴 아내요	조리를 안 해요
조릴 아나고 그냥 다발채로 가따 바치는대	조리를 안 하고 그냥 다발채로 갖다바치는데
그렇지요	그렇지요
그땐 조릴 일리리 해 가주 매드벌 지야 디야	그땐 조리를 일일이 해 가지고 매듭을 지어야 돼
새걸 다 가리써요	색을 다 가렸어요
종 거는 종 거대루	좋은 거는 좋은 거대로
노랑 건 노랑 거때루	노랑 거는 노랑 것대로
뿔궁 건 뿔궁 거	붉은 건 붉은 거
새카망 건 새카망 거대루	새까만 건 새까만 것대로
젤 새카망 건 또 젤 새카망 거대로 막	제일 새까만 건 또 제일 새까만 것대로 막
이르캐 해 가주구서넌 그걸 또 하꾸라구 바가써요	이렇게 해 가지고서는 그걸또 장사라고 박았어요
하꾸	상자
하꾸라고 이러는 인재 저기 그 나무루 짱기 이써요	상자라고 이러는 이제저기 그 나무로 짠 게 있어요
고래 거기다가 꽉꽉 느 가주구 인재 발바 가주구서루 그거 인재 빼 가주구 무꺼짜나요	그래 거기다가 꽉꽉 넣어 가지고 이제 밟아 가지고서 그걸 이제 빼 가지고 묶어잖아요
그거 저르캐 해 가주구	그거 저렇게 해 가지고
그르캐 무꺼 가주구서는 이래 해 가주 가따 바치서	그렇게 묶어 가지고서는이렇게 해 가지고 갖다 바쳐서
그걸 인재 돈 그래 해서 그걸루 아더럴 모두 이래 갈치고	그걸 돈 그래 해서그걸로 아이들을 모두 이렇게 가르치고
그르캐 사라찌요	그렇게 살았지요
지그먼 담배농살 진능 검 지그먼 또 아나는 사라문 아나자나요	지금은 담배농사를 짓는 건 지금은 또 안 하는 사람은 안 하잖아요
하는 사람 하드라고요	하는 사람은 하더라고요
또 그린대 우리가 안 하니 안 하고 한 이 녀닝가 삼녀닝가 댄는대	또 그런데 우리가 안 하니 안 하고 한 이 년인가 삼 년인가 됐는데
아이 그르캐 수워라개 농살 지뜨라구요	아이 그렇게 수월하게 농사를 짓더라고요
아이구 우린 그르캐 애럴 머꾸 나 농살 찌써요	아이고 우린 그렇게 애를 먹고 나 농사를 지었잖아요
고냥 애덜 갈 때	그냥 아이들 가르칠 때
그거 불 때는 거뚜 또 이리자나요	그거 불 때는 것도 또 일이잖아요
그거	그거
보일러 아낄라구	보일러 아끼려고
그래 가주구 그걸 또 부럴 때요	그래 가지고 그걸 또 불을 때요
그개 기수리라고	그게 기술이라고
거기 이르캐 해 가주 미태서 부럴 때먼	거기 이렇게 해 가지고 밑에서 불을때면
그거 쯔느라고 바매 잠두 모짜자나요 또	그거 찌느라고 밤에 잠도 못 자잖아요 또
밤짜물 모짜고 머 그냥 그르캐	밤잠을 못 자고 뭐 그냥 그렇게
해 가주 그거럴 일리리 그걸 또 꼭찌럴 지차나요	해가지고 그거를 일일이 그걸 또 꼭지를 짓잖아요
노랑 거 돠 꼭찌 지치	노랑 거 꼭지 짓지
또 그 다매 꺼 다매 꺼 인재 메찔루 이르캐 해 가주구	또 그 다음에 거 다음에 거 이제 몇 등급으로 이렇게 해 가지고
꼭찌를 지서 하꼴 박찌요	꼭지를 지어서 상자를 박지요
기냥이나 해요	그냥이나 해요
지그먼 다발루 막 이르캐 해 가주 하니까 얼마나 시워요	지금은 다발로 막 이렇게 해 가지고 하니까 얼마나 쉬워요
다 꼭찌를 지 가주구 그래 해 가주구 해써	다 꼭지를 지어 가지고 그렇게 해가지고 했어
아유 참 그때 옌날 재래르능 거 생가글 하구 살먼 일리리 마럴 모태요	아유참 그 때 옛날 는 거 생각을 하고 살면 일일이 말을 못 해요
그거 옌나래 건조시래서 꺼내먼 비오는나리든 날 조온 나리든 아주머니들 또어 처마 미태 안자 가주 그거 싹 이래	그거 옛날에 건조실에서 꺼내면 비 오는 날이든 날 좋은 날이든 아주머니들 또처마 밑에 앉아 가지고 그거 싹이렇게
그럼뇨 노벌 으더 가주 하지요	그럼요 놉을 얻어 가지고 하지요
담배조리꾸널 인재 머 열맹이고 인재 머 얼매 얼매고 인재 이르캐 으더 가주	담배조리꾼을 이제 뭐 열 명이고 이제 뭐 얼마 얼마고 이렇게 얻어 가지고
그거를 머 열탄 열땐 명 어떤지 어짜던지 해 가주구서	그거를 뭐 열 한 열댓명 얻든지 어쩌든지 해 가지고서
그거뚜 인재 졸 노벌 으더야 대요	그것도 조리 놉을 얻어야 돼요
고건 그래 노부더가주 인재 글 점부 새까리 가주구	그건 그래 놉을 얻어 가지고 그걸 전부 색을 가지고
꼭찌를 매 가주구서	꼭지를 매어 가지고서
그래 가주구서 하꼬 바가서 가따 바치자나요	그래가지고 상자 박아서 갖다 바치잖아요
그 꼭찌 매능 거 그거 하능 걸 조림 조리한다 그러능 거요	그 꼭지 매는 거그거 하는 걸 조림 조리한다 그러는 거에요
에 꼭찌 진능 거럴 인재 조리라 구라지요	예 꼭지 짓는 거를 이제 조리라그러지요
꼭찌를	꼭지를
조리를 한다	예 조리를 한다
아이구 그 담배조리라구 하지요	아이고 그 담배조리라고 하지요
인재 그르캐 수부카만 엄청 힘들개	그렇게 수북하면 엄청 힘들게
우리들 상거넌 얘기 모태요	우리들 산 거는 얘기 못 해요
허허허	허허허
저 저 학꾜다닐 때두 저히 어머니 그렁 거 하셔꺼든뇨	저 저 학교 다닐 때도저희 어머니 그런 거 하셨거든요
우리는 농사는 인재 그 안 해는대	우리는 농사는 이제 그 안 했는데
남 남들 그 담배쪼리한다 그러먼 가셔서 그렁 거 하시구	남 남들 그 담배조리한다 그러면 가셔서 그런 거 하시고
그렁 건 제가 바써요	그런 건 제가 봤어요
그르치유	그렇지요    그른대 지금 죄송하지만 선생니먼 지금 어트개 대시써요 그런데 지금 죄송하지만 선생님은 지금 어떻게 되셨어요
쉬운네시요	쉰넷이요
시은내시애요	쉰넷이에요
개띠	개띠
개띠	개띠
마느로	만으로
만 마느로	만으로
깨띠	개띠
우리 큰따리 개띠거든뇨	우리 큰딸이 개띠거든요
신느이요	쉰넷이요
우리 큰따리	우리 큰딸이
우리 큰따리 지금 신느이고	우리 큰딸이 지금 쉰넷이고
우리 크나더리 지금 스이여	우리 큰아들이 지금 셋이야
쉰스이	쉰셋
연연생얼 해 가주그서	연연생을 해 가지고
처다이 연연생얼 그래 인재  나쿠서 인재	예 첫 아이를 연연생을 그래 낳고서 이제
연연생얼 해 가주구	연연생을 해 가지고
언재부턴가 전 나이도 잘 모르개써요	언제부턴가 전 나이도 잘 모르겠어요
이개 따저 바야지 알지	이게 따져 봐야지 알지
하하하하	하하하
하하하하	하하하
그르치유	그렇지요
난 아덜 딸 이럼 전부 다 다 모르넌대 머	난 아들 딸 이름 전부 다 다 모르는데 뭐
며싸린지두	몇 살인지도
흐흐	흐흐
허허	허허
애기 손자들 생기면 손자 이름두 잘 몰르는대요	애기 손자들 생기면 손자 이름도 잘 모르는데요
헤헤헤	예 헤헤헤
허허	허허
아이구 옌나래넌 아주 고생한 사람덜 저기 드러보먼	아이고 옛날에는 아주 고생한 사람들 저기 들어보면
머 이캐 참 항 거 생가카먼	뭐 이렇게 참 한 거 생각하면
이 쩌기 쑥뚜 하두 뜨더다 머거싸 가주구 쑥뿌링이꺼지 캐다가	이 저기 쑥도하도 뜯어다가 먹어대서 쑥뿌리까지 캐다가
그그를 기냥 찌 가주구서 막 이르캐 해서 머꼬	그것을 그냥 찧어 가지고서 막이렇게 해서 먹고
막 그래 사라짜나요	막 그래 살았잖아요
우리보다 더 고생한 사람더런 그래써요 또	우리보다 더 고생한 사람들은 그랬어요 또
그르캐 사라써요	그렇게 살았어요
쑥뿌링이꺼지 다 캐다가	쑥뿌리까지 다 캐다가
머 드래 머글 꺼뚜 업써짜나요	뭐 들에 먹을 것도 없었잖아요
지그미니까 그거뚜	지금이니까 그것도
업써요	없어요 예
뜨드면 다 나무린대두 안 뜨찌만 옌나래는 머	뜯으면 다 나물인데도 안 뜯지만 옛날에는 뭐
그러묘	그럼요 예
하두 서루 뜨더다 머거싸두	하도 서로 뜯어다 먹어대서
쑥뚜 우꾸	쑥도 없고
나물두 별루 웁써요	나물도 별로 없어요
막 저런 큰 사느루 가야 이꾸	막 저런 큰 산으로 가야 있고
그르치 근대	그렇지 근데
지그먼 머 나무리구 머구 흔해빠지자나요	지금은 뭐 나물이고 뭐고 흔해빠지잖아요
다 머 그래쓰니깨	다 뭐 그랬으니까
사내 나물뜨르 뜨드더두 다녀 보셔써요	산에 나물 뜯으 뜯으러도 다녀 보셨어요
인재 사내 나물 뜨드루두 메 뻔 가써요	산에 나물 뜯으러도 몇 번 갔어요
저는 마닝 안 가써요	저는 많이는 안 갔어요
팔람매를 키울라카닝깨	팔 남매를 키우려니까
맨날 머 그 지배서머 인재 이끼도	매일 뭐 그 집에서 에 뭐 이제 있기도
지배서 일하기도 저기하고	집에서 이러기도 저기 하고
나물두 제대로 난 뜨더다 먹뚜 모태서요	나물도 제대로 난 뜯어다 먹지도 못했어요
나물 이르물 몰라서 저는 며깨빠깨 몰라요	나물 이름을 몰라서 저는 몇 개밖에몰라요
하하하하하	하하하하하
취나물 머 이렁 거 며깨바깨 모르고 근대	취나물 뭐 이런 거 몇 개밖에 모르고 그런데
그르치요	예 그렇지요
으르신들 얘기 드러보니까 나물 종뉴두 갱장이 만트라구요	어르신들 얘기 들어 보니까 나물 종류도 굉장히 많더라고요
에 에	예 예
저넌 나물 뜨드루 메 뻔 가보도 모태쌔요	저는 나물 뜯으러 몇 번 가보지도못 했어요
나무른 뜨드루	나물을 뜯으러
나물 뜨드러 갈 새도 업떠라고요	나물 뜯으러 갈 새도 없더라고요
사느라고	사느라고
어트개 살다보닝깨 헤헤	어떻게 살다보니까 헤헤
그래서 기냥	그래서 그냥
이 저기 여기 저기 지그먼 잘사라요	저기 여기 저기 지금은 잘 살아요
그 사람더리	그 사람들이
에 나경이 어머이라고 인넌대 그 사라미 가주 오먼	에 나경이 엄마라고 있는데 그 사람이 가지고 오면
저는 마니 사 머거써요	저는 많이 사 먹었어요
저는 갈 쌔는 우꾸	저는 갈 새도 없고
개서 그래 그 지배 지금 잘 사라요	예 그래서 그래 그 집은 지금 잘 살아요
그런 사람드리	그런 사람들이
에 지금 잘 살구 이써요 그집	에 지금 잘 살고 있어요 그집
맨처매 겨론 하셔 가주구 시논 살리말 때	맨 처음에 결혼 하셔 가지고 신혼살림할 때
여기 하라버지 말쓰무로는 이 집	여기 할아버지 말씀으로는 이 집
쩌기 여기 여기 여기요	저기 여기 여기 여기에요
예 예	예예
여기서 여기 오닝깨 기냥 피라내짐 초가찌배요	여기 오니까 그냥 피란에 지은초가집이예요
흑짱 바가	흙장 박아
이재 초가찌비 여 아내만 발르 배까태서 발르지두 앙쿠	초가집이 여기 안에만바르고 바깥에서 바르지도 않고
그래는대 진재 제가 와 가주구서	그랬는데 이제 제가 와 가지고
여 이는 발루구 나는 흑 떠 버주고 이래 가주 발러써요	이 이는 바르고 나는흙 떠 부어주고 이렇게 해 가지고 발랐어요
그래 가주구 살다가	그래 가지고 살다가
인재 또 머 새루 인재 초가지벌 작꾸 이구	이제 또 뭐 새로 이제 초가집을자꾸 이고
이르캐 살다가	이렇게 살다가
나중애는 이재 이기 에 모새로 인재	나중에는 이제 이게 모래로 이제
저 새며나고	저 시멘트하고
이래 저 여기 또랑까애 거기서루 인재 개와라구 박 개와 박떠라고요	이래저 여기 도랑가에 거기서 이제 기와라고 박 기와 박더라고요
모새럴 퍼다가	모래를 퍼다가
그걸루 인재 또 이 지벙얼 또 뜨더내구서	그걸로 이제 또 이 지붕을 또 뜯어내고
그걸루 새로부 또 함 번 이썯써요	그걸로 새로 또 한 번 이었었어요
그걸루 이다가 인재 그걸 이 인재 새루 여기서 인재	그걸로 이다가 이제 그걸이 이제 새로 여기서 이제
쩌 보조 해준다	저 보조 해준다
지벌 지먼	집을 지으면
그리 해 가주구서 인재 그래 그저 한 팔뱅마눤 바더 가주구서 이 거 징 거예요	그렇게 해 가지고 이제 그렇게 한 팔백만원 받아 가지고 이거 지은 거예요
그래 가주 지써요	그래 가지고 지었어요
지 가주 인재 지금 애덜두 저래 살구	지어 가지고 지금 애들도 저렇게 살고
기냥 이리캐 사닝깽 이기 만조기지요 머	그냥 이렇게 사니까 이게 만족이지요뭐
허허허	허허허
처매 시논살리말 때는 어떵 걸 까꾸 마련하셔써요	처음에 신혼살림할 때는 어떤 걸 가지고 마련하셨어요
그때 머 전쟁터라	그때 뭐 전쟁터라
전쟁 끈나고 나서라 머	전쟁 끝나고 나서라 뭐
아무거뚜 웁찌	아무것도 없지
아무거뚜 웁써찌요	아무것도 없었지요
그쌔에 기냥 머	글쎄 그냥 뭐
그럭또 우꼬오 머 살리미라고넌	그릇도 없고 뭐 살림이라고는
살리미라곤 아주 일쩔 움능 기여	살람이라고는 아주 일절 없는 거야
인재 논 마니 인재 그 쪼꿈 이써찌요	이제 논은 많이 이제 조금 있었지요
인재 그 논만 받 쪼꿈마구 이르캐 논만 쪼꿈 이썬넌대	이제 그 논만 밭 조금하고 이렇게 논만 조금 있었는데
그 얘기럴 다 모태요	그 얘기를 다 못해요
선생님 허허허허	선생님 허허허허
살림사리는 어떵 걸 처매 마려나셔써요 그러면	살림살이는 어떤 걸 처음에 마련하셨어요 그러면
츠매요 츠매 와	처음에요 처음 와
겨론 처매 하셔쓸 때	결혼 처음에 하셨을 때
겨론 츠매 인재 해 가주구넌 인재 아무거뚜 참 업짜나요	결혼 처음에 이제해 가지고는 이제 아무것도 참 없잖아요
다 태우구 아무거뚜 우꾸	다 태우고 아무것도 없고
여기서 인재 우리 아번님 저 아푸시니깨	여기서 우리 아버님 아프시니까
자꾸 인재 머 돈 이쓰먼 좀 그렁 거뚜 좀 이르캐 하다 봉깨	자꾸 이제 뭐 돈  이 있으면 좀 그런 것도 좀 이렇게 하다 보니까
돈도 엄능가 그르캐 근대	돈도 없는가 그렇게 그런데
제가딸만	제가딸만
우리 어머이 아부지가 사형재구요	우리 어머니 아버지가 사 형제고요
아더리 업써요	아들이 없어요
그래 가주 다 시집 뽀내고 인재 이랑깨 제가 제 혼자 나마 가주구 인재 살다가	그래 가지고 다 시집 보내고 이러니까 제가 저 혼자 남아 가지고 살다가
아부지가 열뚜살 잡싸서 도라가시 가주구	아버지가 열두 살 먹어서 돌아가셔가지고
인재 어머이 혼자 게시닝깨	어머니 혼자 계시니까
저 우리 아버지가 구 남매여	저 우리 아버지가 구 남매야
그래 구 남맨대	그래 구 남매인데
젤 쫑마리 자건아부지럴 인재 오시라캐	제일 끝에 작은아버지를 오시라고해서
옌나리 그리차나요	옛날이 그렇잖아요
여기 지그먼 여자드리 다 해머꼬 사는대	여기 지금은 여자들이 다 해 먹고 사는데
옌나래넌 모태 머거요	옛날에는 못 해 먹어요
인재 해먹떨 모타구 이랑깨 인재	이제 해 먹지를 못하고 이러니까
우리 어머이가 인재 시동상이 온다고 고라니깨 오라캐 가주구 한 때 사라써요	우리 어머니가 이제 시동생이 온다고 그러니까 오라고 해 가지고 한 데 살았어요
한 때 살다가 인재 저넌 인재 이르캐 와 가주구	한 데 살다가 저는 이렇게 와가지고
그거럴 인재 얘기럴 한다먼 이 양바니 인재 줌 저기 하지마넌	그것을 얘기한다면 이 양반이 이제 좀 저기 하지만
인재 저두 이르캐 시집 인재 와 가주구 살지마넌	이제 저도 이렇게 시집을 와가지고 살지만
우리 어머이가 인재 도널 좀 쪼꼼 이써써요	우리 어머니가 돈을 좀 조금 있었어요
쫌 이썬넌대	조금 있었는데
그때 도느루 한 한 오마넌이먼 큰도니써요	그때 돈으로 한 한 오만이면큰 돈이었어요
그러치요	그렇지요
오마너니먼 큰도닌대	예 오만 원이면 큰돈인데
인재 이마눠넌 내가 장내럴 놔써요	이제 이만 원은 내가 장례를 놨어요
이마눠는 인재 글 우리 어머이 매지루 이르캐 놔따가	이만 원은 이제 그것을우리 어머니 몫으로 이렇게 놓았다가
이 양바니 알지마넌	이 양반이 알지만
그거럴 고만 자꾸 이자 쪼꼼쪼꼼 주더라가 말다가 이라민성	그거를 그만 자꾸 조금 주다가 말다가 이러면서
그라다가 고만 다른 대루 이살 갇 두 찌비다 이살 가곤 이재 띠 뻐리써요 그거  넌	그러다가 그만 다른 데로 이사를 가 두 집이 다 이사를 가고 이제 떼어 버렸어요 그것은
그라고서 인재 고 돈 이마눠느루 제가 인재 아수웅 걸 사떠요	그리고 그 돈이만 원으로 제가 아쉬운 거를 샀어요
여기서	여기서
머 다 피라내 다 저기 하고나니깨 웁짜나요	뭐 다 피란에 다 저기 하고 나니까 없잖아요
그래 가주구 인재 머 여 강우리사고	그래가지고 뭐 광주리 사고
머 우지런 빨래 뚜디리능 거 그렁 거뚜 웁써요	뭐 이런 빨래 두드리는 거 그런 것도 없어요
빨래 인재 직	빨래
옌나랜 푸를 해짜나요	옛날에는 풀을 했잖아요
푸래가주 이런 재 그런 빨래 두드리러닝 기	예 풀 해가지고 이런 이제 그런 빨래 두드리는 거
이 돌맹이를 그때 또느로 그걸로 그때 삼처눠닝가 온 머 얼매가 그래 주고사써요	이 또 돌맹이를 그때 돈으로 그걸로 그때 삼천 원인가 원 뭐 얼마인가그렇게 주고 샀어요
그래 주구 사고	그렇게 주고 사고
이재 머 나 아수웅 거	뭐 나 아쉬운 거
그러기 인재 이렁 거 쪼꼼썩 인재 그냥 그렁 거 사 그냥 사고	그릇이 이제 이런 거 조금씩 이제 그냥 그런 거 사 그냥 사고
그래 고 도느루 고래고래 사써요	그래 그 돈으로 그그렇게 그렇게 샀어요
소곰도 사서 장도 당꼬 머	소금도 사서 장도 담고 뭐
어트개 이르캐 하다 보니깨	어떻게 이렇게 하다 보니까
인재 노니 좀 이쓰니깨 농사를 지차나요	논이 좀 있으니까 농사를 짓잖아요
인재 농사 지닝깨 기냥 그 농사 징 걸로 인재 그래캐 머꼬	농사 지니까 이제그냥 그 농사 지은 걸로 그렇게 먹고
그래 사라찌요	그래 살았지요
머 머가 이써요	뭐 뭐가 있어요
피라내 기냥 다 태우구 아무 거뚜 움쓰닝까	피란에 그냥 다 태우고 아무 것도없으니까
그냥 인재 도니 엄쓰닝깨	그냥 이제 돈이 없으니까
근대 이마눤 고골로 기냥 머 요고쪼고 사닝깨 줌 그래두 사거떠라구요 기냥	그런데 이만 원 그걸로 그냥 뭐 이것저것 사니까 좀 그래도 사겠더라고요 그냥
허허허	허허허 예
그래 가주구 그래 기냥 사라찌요	그래 가지고 그렇게 그냥 살았지요
그리고 나서는 처째 처다이는 느깨 난 세미니요 그럼	그리고 나서는 첫째첫 아이는 늦게 난 셈이네요 그러면
스물느이애 나 이 양반 구닌 가따 와 가주	스물넷에 나 이 양반 군인 갔다와 가지고
열려더래 와 가주구	열여덟에 와 가지고
이 양반 스물라나구 저넌 열려더래 와꺼더뇨	이 양반 스물하나고 저는 열여덟에 왔거든요
그린대 인재 이 양반 구닝 가따 와서 스물네새 나써요	그런데 이 양반 군인갔다 와서 스물넷에 낳았어요
스물네새 나코 두째넌 수물다 저넌 스물 다서시구	스물넷에 낳고 둘째는 스물다 저는 스물다섯이고
이 양바넌 인재 그때 처다럴 스물일고배 나찌요	이 양반은 이제 그때 첫 아이를 스물일곱에 낳았지요
세사럴 더 잡싸쓰닝깨	세 살을 더 잡쉈으니까
스무릴고배 나꼬	스물일곱에 낳고
스물 여더래 와서 나코	스물여덟에 와서 낳고
저넌 스물 다서새 나코 그래찌요	저는 스물다섯에 낳고 그랬지요
허허허	허허허
두째럴	둘째를
그때는 입떧 아나셔써요	그때는 입덧 안 하셨어요
왜 아내요	왜 안 해요
입떠시 해찌요	입덧을 했지요
고래 저 안진때기라구 저기 가능대 그그 지금두 생가기 나요	그래 저 앉은댁이라고 저기 가는데 그거 지금도 생각이 나요
거기럴 인재 우리 시어먼님마고	거기를 우리 시어머님하고
저 와서 두 달마내 시아번님 도라가시고	저 와서 두 달만에 시아버님 돌아가시고
이 양바나고 스이가	이 양반하고 셋이
지금두 기엉려기 나자나요	지금도 기억이 나잖아요
하두 고생얼 해 가주	너무 고생을 해가지고
입떠설 해찌마넌	이 입덧을 했지만
그슨 인재 그때 콩바또 매고 머 그렁 거 하루 인재 거길 드러가써써요	그것은이제 그때 콩밭도 매고 뭐 그런 거 하러 이제 거기를 들어갔었어요
근대 그 감자럴 어째 머거써요	그런데 그 감자를 어째 먹었어요
감자럴 이재 어찌 그기 좀	감자를 그게 좀
머럴	뭐를
아니여 지금 교순니마고 대화 햐	아니야 지금 교수님하고 대화 해
아이 여 교순니마고 대화한다니깨	아이 여 고수님하고 대화한다니까
허 경노당이여	허 경로당이야
얘기해두 대유	얘기해도 돼요
그래서 인재 우리가 인재 세시꾸 인재 거길 가써요	그래서 우리가 셋이 거길 갔어요
간넌대	갔는데
그때 멀 점 머거쓰먼 시푸드라고요	그때 뭘 좀 먹었으면 싶더라고요
머가 머글깨 웁써요	뭐가 먹을 게 없어요
밥 밥 쭘 머꼬 가쓰먼 시푼대두	밥 밥 좀 먹고 갔으면 싶은데도
우째 밥뚜 또 머꾸 또 그리코	어째 밥도 또 먹고 또 그렇고
그래가주구서루 간넌대 감자럴 머꼬 간넌대	그래가지고서 갔는데 감자를 먹고갔는데
감자가 도캐떵가	감자가 독했는가
아주 막 거서 토핸넌대	아주 막 거기서 토했는데
진짜 머 똥부까지 다 토해 가주구서루	진짜 뭐 똥물까지 다 토해 가지고서
마 기냥 사라미 히미 업써 가주구 막 쓰러질 찌경이더라고요	막 그냥 사람이힘이 없어 가지고 막 쓰러질 지경이더라고요
그래 가주구 그래 거기서	그래 가지고 그래서 거기서
그래 그르캐 하후 인재 와써요 그냥	그래 그렇게 하고 이제 왔어요 그냥
어트개 그르캐 인재 오루 머	어떻게 그렇게 이제 오고 뭐
그 머꾸 수웅 거야 마랄 쑤가 업써찌요 머	그 먹고 싶은 거야 뭐 말할 수가없었지요 뭐
그렁 거야	그런 거야
그대 그때 당신 암만 머꾸 시버두 웁써서두 몬머꾸	글쎄 그때 당시는 아무리먹고 싶어도 없어서도 못 먹고
쯛 그릳 그르캐 사라찌요	쯧 그렇 그렇게 살았지요
입떠타넌 대야 머	입덧하는 데야 뭐
허허허	허허허
재 다 머 그르치	이제 다 뭐 그렇지
줌 재 나중애 이르캐 살다 보닝깨	좀 이제 나중에 이렇게 살다 보니까
또 차차 쭘 나사지구 해서 인재 내가 저 사머끼도 하구 인재 그래찌요	또 차차 좀 나아지고 해서 이제 내가 저 사 먹기도 하고 그랬지요
쫌 허	좀 허
그때가 제일 애머거써요	그때가 제일 애먹었어요
귿 그때 젤 애럴 머꾸	그 그때 제일 애를 먹고
우리 인재 섿째 우리 세째 머수마 이써서는 가넌 어째 또 캐 고기가 머꼬숩때요	우리 이제 셋째 우리 셋째 머슴애 있어서는 걔는 어째 또 크렇게 고기가 먹고 싶대요
그래서 인재 옌나래 왜 이기 저 픽 피뿍 피꾹 장사라고 댕기써요	그래 이제 옛날에 왜 이렇게 저 피 핏국 핏국 장사라고 다녔어요
이래 깡 깡통얼 이르캐 찌다나개 만드러 가주구	이렇게 깡 깡통을 이렇게기다랗게 만들어 가지고
이래 가주구서	이래 가지고서
거기다 꽁지다 끼 가주구 이걷 쩌걷 인재 이르캐 끼 가주구서	거기에다 꼬리에다 끼어 가지고 이것 저것 이제 이렇게 끼어 가지고서
거기다 이르캐	거기다 이렇게
꽁지 끼서 고고 하나애다가 이르캐 싸럴 요마난대다가 하낙썩 바다써요	꼬리끼어서 그거 하나에다가 이렇게 쌀을 요만한 데다가 하나씩 받았어요
고 하나 꽁지 낑 거만 하나 하먼	그 하나 꼬리 끼운 것만 하나 하면
그래서 인재 고거럴 싸럴 인재 내가 우리 어먼님떠러	그래서 이제 그거를 쌀  을 이제 내가 우리 어머님더러
어먼님 저기 저 픽 픽꾹 끄리멍넌 장사 완넌대	어머님 저기 저 피 핏국 끓여 먹는 장사가 왔는데
어먼님 저거 쫌 사 가주 머그먼 조캐써요	어머님 저거 좀 사 가지고 먹으면좋겠어요
이라니깨	이러니까
그쌔 요런 싸럴 요마낭 종고래기다가 주구	글쎄 요런 쌀을 요만한 종그래기에다가 주고
우리 어먼니미 사떠요	우리 어머님이 샀어요
그라넌대 얼마나 머꾸 수운지 그냥 그 양은소태다가 인재	그랬는데 얼마나 먹고 싶은지 그냥 그 양은솥에다가 이제
양언소설 산넌대	양은솥을 샀는데
양언	양은
고기다 얼매라 얼매럴 머꾸 수버떤지	거기다 얼마나 얼마나 먹고 싶었던지
막 스르륵 끄능 거럴 그거럴 머거써요	막 스르르 끓는 것을 그것을 먹었어요
그냥 하두 머꾸 시버 가주구	그냥 하도 먹고 싶어 가지고
그래서 그걸 머거떠니마넌 다시넌 몬머꺼떠요	그래서 그걸 먹었더니만 다시는 못 먹겠어요
막 고거 물리 가주구	막 그거 물려 가지고
아이구 그래 인재 울 그르캐 두 버널 앨 머꾸	아이구 그래 이제 그렇게 두번을 애를 먹고
그 디루넌 머 별로 그르캐 애암머꼬 그냥 애더럴 그래 키워써요	그 뒤로는 뭐별로 그렇게 애 안 먹고 그냥 애들을 그렇게 키웠어요
허허	허허
재 그 입떠시라능 개 아무래도 다 이찌요	이제 그 입덧이라는 게 아무래도다 있지요
그거넌 이찌만 그래두 아덜 두럴 그르캐 애럴 머거써요	그것은 있지만 그래도애들 둘을 그렇게 애를 먹었어요
그라고 그냥 쯛 이떠서넌 다 하고 살지요	그리고 그냥 쯧 입덧은 다 하고 살지요
그리구 나서 인재 애를 나차나요	그리고 애를 낳잖아요
요샌 다 병워내 가서 난는대	요새는 다 병원네 가서 낳는데
옌나래는 지배서 나짜나요	옛날에는 집에서 낳았잖아요
지배서 나찌요	집에서 낳았지요
금 누가 도와 주셔써요	그럼 누가 도와 주셨어요
우리 할머니가	우리 할머니까
우리 시어머니	우리 시어머니
처다 날 때넌 말도 모타개 애머거찌요	첫 아이 낳을 때는 말도 못하게 애를먹었지요
아주 그쌔	아주 글쎄
긍개 스물느이애 그래 난는대	그러니까 스물넷에 그래 낳았는데
처다 날 때너 진짜 머 마리라고 하먼 말도 모타지요 기냥	첫 아이를 낳을때는 진짜 뭐 말이라고 하면 말도 못 하지요 그냥
이긷 피라니닝깨 인재 돌맹이 따듬또기 어딛써요	피란이니까 이제 돌맹이 다듬잇돌이 어디 있어요
요마난 삐따칸 요론 납짜칸 따듬도기다가 거기다가 뚜디리 이번넌대	요만한 삐딱뚜름한 요런 납작한 다듬잇돌에다가 거기에다가 두드려 입었는데
그거럴 부짜꼬 하글 쓰구 아글 쓰구 해 가주구는	그것을 붙잡고 악을 쓰고악을 쓰고 해 가지고는
우리 어먼니미 이 양반떠러 니가 줌 디 끄러나라 디애서	우리 어머님이 이양반더러 네가 좀 이렇게 끌어 안아라 뒤에서
이라드라고요	이러더라고요
그래서 인재 그라 끄라아나썬넌대	그래서 이제 끌어 끌어안았었는데
그거뚜 실쿠 아무거뚜 시러요	그것도 싫고 아무 것도 싫어요
내가 주꺼쓰닝깨 머 다 그냥	내가 죽겠으니까 뭐 다 그냥
개 그건만 막 이래 디루 부짜꾸 주거라구 히	그래 그것만 막 이렇게 뒤로 붙잡고 죽어라 하고 히
아이구 그 생가걸 하먼 지금두 그냥 머 그 일리리 다 모타지요	아이고 그 생각을 하면 지금도 그냥 뭐 그 일일이 다 못하지요
그냥 처다넌 그르캐 애럴 머꾸 나떠요 그	그냥 첫 아이는 그렇게 애를 먹고낳았어요 그
아유 생가캐보먼 머 피라내 머 이써요	아유 생각해 보면 뭐 피란에 뭐 있어요
따듬독뚜 웁찌 아무거뚜 움쓰닝까	다듬잇돌도 없지 아무 것도 없으니까
돌매이가 요마난 그 납쪼캉 기 요마항 기 이떠라고요	돌맹이가 요만한 납작한 게 요만한 게 있더라고요
고골 노코서 그냥 빨래럴 인재 푸래 가주구 뚜디리가주	그걸 놓고서 그냥 빨래를 풀 해 가지고 두드려 가지고
그러면	그러면
아휴 그래 제가 와 가주구 인재 그르캐 사느닝깨	아휴 그래 제가 와 가지고 그렇게 사니까
인재 돈 이마눠느로 따듬똑뚜 사개꾸	돈 이만 원으로 다듬잇돌도 사겠고
강우리두 사개꼬 머	광주리도 사겠고 뭐
이 숙깔도 인재 좀 사개꼬 머	이 숟가락도 이제 좀 사겠고 뭐
저르캐 장 담는대 소굼도 쭘 사 가주구 인재 줌 구거렁 거뚜 하거꾸	저렇게장 담그는데 소금도 좀 사 가지고 이제 좀 그런 것도 하겠고
이마느로 이걷 쩌걷 쪼꼼 하거떠라고요	이만 원으로 이것 저것 조금 하겠더라고요
개선 이르캐 해 가주구 인재 살구	그래서 이렇게 해 가지고 살고
인재 머 농살 지닝깨 인재 머 아수웅 거넌 별루 우꼬	이제 뭐 농사를 지니까 이제 뭐 아쉬운 것은 별로 없고
그래 인재 이 양바니 또 인재 가 가주구	그래 이제 이 양반이 또 이제 가 가지고
피라내 깨진 이 소시 깨저뜨라고요	피란에 깨진 이 솥이 깨졌더라고요
폭타내 마자 가주	폭탄에 맞아 가지고
게 그거럴 밀까루루 이르캐 아주까리라구 이짜나요	그래 그것을 밀가루로 이렇게 아주까리라고 있잖아요
아주까리 그거럴	아주까리 그것을
명 씨 명 요래 발라 가주 명씨하고요	목화 씨 목화 이렇게 발라 가지고 목화씨하고요
고 명하구 아주까리하고 가루 좀 쪼꼼썩 꼭꼭 찌 가주구서	그 목화하고 아주까리하고 가루 좀 조금씩 콕콕 찧어 가지고서
그걸루 솓 깨진댈 발르머뇨 한 여르른 가요	그걸로 솥 깨진 데를 바르면요 한열흘은 가요
여를써건	열흘씩은
근대 인재 고래 가주구 바다 먹따가	근데 그래 가지고 받아 먹다가
나중애 그 소때우는 사라미 와 가주구 그래 그걸루 때와 가주구	나중에 그 솥때우는 사람이 와 가지고 그래 그걸로 대워 가지고
그르캐 살다가	예 그렇게 살다가
우리 세째 성이 일번 사라써요	우리 셋째 형님이 일본에서 살았어요
일본서 사라썬는대	일본에서 살았었는데
그래 인재 일번 인넌 성이 나와 가주구	그래 이제 일본에 있는 형님이 나와가지고
쯛 좀 오설 좀 가저와 가주구	쯧 좀 옷을 좀 가져 와 가지고
애들 오뚜 좀 인재 이캐 이피닝깨 좀 좀 그걸로 쪼꿈 나뜨라고요 좀	애들 옷도 좀 이제 입히니까 좀 좀 그걸로 조금 낫더라고요 좀
그래서 인재 아들 오뚜 그걸루 좀 이피고	그래서 이제 아이들 옷도 그걸로 좀입히고
돈도 쪼꿈 줘서 그냥 이거 쪼꿈 좀 사구	돈도 조금 줘서 그냥 이것 조금 좀사고
솓또 가마소설	솥도 가마솥을
세죽 끄리넌 가마솓	쇠죽 끓이는 가마솥
그거럴 인재 또 하나 사 주더라고요	그거를 이제 또 하나 사 주더라고요
그래 그걸루 또 사고	그래 그걸로 또 사고
인재 소선 인재 양은소선 이 양바니 인재 또 저기 인재 영동 왜 장인대	이제솥은 이제 양은솥은 이 양반이 이제 또 저기 이제 영동 왜 장인데
장애 가 가주 꼬추 말룽 거 쪼꿈 농사징 거 내 가주 그거 내 가주구 가서 사오구	장에 가 가지고 고추 말린 거 조금 농사 진 거 내어 가지고 그거 내어 가지고 가서 사 오고
그 일리리 모태요	그 일일이 못 해요
얘기	예기
허허 아주 머 마랄 꺼도 업찌요	허허 아주 뭐 말할 것도 없지요
근대 그 솓 깨징 걸 아까 명씨하고 밀까루하고	그런데 솥 깨진 것을 아까목화씨하고 밀가루하고
명씨 이캐 빼먼 이짜나요	목화씨 이렇게 빼면 있잖아요
그거 명이 이짜나요	그 목화가 있잖아요
거 명	그 목화
머여써 이르캐 명	뭐였어 이렇게 목화
마라 그 명 나무애 다래라구 이찌요	말하면 그 목화 나무에 다래라고 있지요
다래애서 명 이러캐 송아리 나오자나요	다래에서 목화 이렇게 송이가 나오잖아요
고걸 빼 가주구서 인재 아주까리하고 그거 하고 밀까루 줌 느 가주 짜꾸 찌여	그걸 빼 가지고 이제 아주까리하고 그거하고 밀가루 좀 넣어 가지고 자꾸 찧어요
자꾸 찌먼 그거시 인재 아주 그르캐	자꾸 찌면 그것이 이제 아주 그렇게
저 콩 이짜나요	저 콩 있잖아요
또 콩도 쪼꼼 느코	또 콩도 조금 넣고
콩얼 쪼꿈 느쿠	콩을 조금 넣고
그래 가주구서 인재 그래 그걸 찌마뇨	그래 가지고 이제 그래 그걸 찧으면요
그기 차지요	그게 차져요
그 그걸루 인재 고 떠러 여그 요 깨진 대럴 인재 골 느가주구	그걸로 이제그 떨어 여기 요기 깨진 데에 그걸 넣어 가지고
요래 요래 인재 발라요	요렇게 요렇게 이제 발라요
고 깨진 대럴	고 깨진 데를
꼭꼭 눌러 가주구	꼭꼭 눌러 가지고
눌러 가미 발르만 게 오래 가요	눌러 가면서 바르면 그게 오래 가요
그기	그게
그래도 그개 불때구	아 그래도 그게 불 때고
한 시보일 리시빌꺼지 가요	예 한 십오 일 이십 일까지 가요
불때구 그래두 그개 갱장이 차 차져서	불 때고 그래도 그게 굉장히 차차져서
예거기다 소주걸 소주걸 끄리두 한 이시빌썩 가요	예 에 거기에다 소죽을 소죽을 끓여도 한 이십 일씩 가요
근대 그르캐 가주 바다 멍는대 인재	그런데 그렇게 해 가지고 받아 먹는데 이제
그 우리 우리 그 세째 성이 그쌔 일버느루 드러가 가주구서넌	그 우리 우리그 셋째 형이 글쎄 일본으로 들어가 가지고는
그래서 도널 쫌 줘서 그걸루 콩두 파라서 메주두 끄리구	그래서 돈을 좀 줘서 그걸로 콩도 팔아서 메주도 끓이고
저 소뚜 사서 주구 머	저 솥도 사서 주고 뭐
그냥 그래 그래 해 가주구 살다 사라써요 그냥	그냥 그렇게 그렇게 해 가지고 살다가 살았어요 그냥
게 살다 보닝깨 기냥	그래 살다 보니까 그냥
인재 그래두 노니 땅이 좀 이쓰닝깨 기냥 고걸루 인재 농사지서 기냥 이래머꾸	이제 그래도 논이 땅이 좀 있으니까 그냥 그걸로 농사 지어서 그냥 이래먹고
그러면 인재 애 나자나요	그러면 이제 애 낳잖아요
그러면 애 나코 나서 그 삼 가른다 그러자나요	그러면 애 낳고 나서 그 삼 가른다 그러잖아요
그 태쭐두 짤라야 대고 이렁 건 다 어트개 해야 되요	그 탯줄도 잘라야 되고이런 건 다 어떻게 해야 돼요
태쭐 짤르넝 거넌 우리 시어먼니미	탯줄 자르는 거는 우리 시어머님이
그르캐 애럴 머꼬 나 하닝깨	그렇게 애를 먹고 하니까
처다넌 세상애 히미 업써요	첫아이는 세상에 힘이 없어요
여기 코도 모 푸러요	여기 코도 못 풀어요
히미 하나두 웁써 가주	힘이 하나도 없어 가지고
이개 머 이르캐 그냥 하두 모태써요	이게 뭐 이렇게 그냥 하지도 못했어요
아무 거또	아무 것도
그래 인재 우리 어먼니미 하시찌요	그래 우리 어머님이 하셨지요
우리 어먼니미 인재 이르캐 핸넌대	우리 어머님이 이제 이렇게 했는데
인재 날떠러 보라 구라다라고요	이제 나더러 보라고 그러더라고요
다매넌 니가 해야지 댄다고 그래서	다음에는 네가 해야지 된다고 그래서
보라고 하넌대	보라고 하는데
이캐 보니까	이렇게 보니까
인재 애기난 대	아기 낳은 데
태쭈럴 자꾸 요래 양짜그로 요러캐 요러캐 해요	탯줄을 자꾸 요렇게 양쪽으로 요렇게 요렇게 해요
요르캐 자꾸 양짜그루 훌떠라고요	요렇게 자꾸 양쪽으로 훑더라고요
그라드니마넌 인재 요기두 실루 짬매라카고	그러더니 여기도 실로 동여매라고하고
요짜개두 짬매라카고	이쪽에도 동여매라고 하고
애기 인넌대	아기 있는데
인재 요만창 낭구구	이제 요만큼 남기고
인재 고기 끄너	고기를 끊어
인재 이르캐 끈 끄너 가주 요짜개 짬매구 해 가주구 피두 몬 나오개 해 가주	이제 이렇게 끊 끊어 가지고 요쪽에 동여매고 해 가지고 피도 못 나오게 해 가지고
이개 태라구 이짜나요	이게 태라고 있잖아요
그거 인재 또 이르캐 나오니까 인재	그거 이제 또 이렇게 나오니까 이제
사라미  살거뜨라고요	사람이  살겠더라고요
그래선 우리 어먼니미 알키 조가주구서넌 그래 그대루 인재 제가 해써요	그래서 우리 어머님이 가르쳐 줘가지고는 그래 그대로 제가 했어요
제가 그래 우리 어먼니미	어 제가 그래 우리 어머님
손자를 인재 우리 크나하구 둘째하구 야하구 하구 나쓰닝깨	손자를 우리큰아이하고 둘째하고 얘하고 하고 나았으니까
인재 우리 네 네째꺼지 해찌요	우리 네 넷째까지 했지요
네째꺼지 우리 어먼니미 사라서 우리 어먼니미 해써요	넷째까지 우리 어머님이 살아서 우리 어머님이 했어요
그라고서넌 인재 꾹 끄리주구 이개 삼 핸는대	그리고는 국 끓여주고 이제 이게 삼 했는데
아들 스이넌 인재 기냥	아들 셋은 그냥
허허	허허
제가 그냥 인재 큰딸하고 그냥 이래 하고	제가 그냥 이제 큰딸하고 그냥 이렇게 하고
그르구 나면	그리고 나면
여르매도 불 때지요 막 방애다가	여름에도 불을 때지요 막 방에다가
그러묘	그럼요
상구 불 때고 사라찌요	계속 불 때고 살았지요
상구 불 때고	계속 불 때고
꼬치 좀 따머 어디 마를 때가 이써요	고추 좀 따면 어디 말릴 데가 있어요
그래 방애다 말라써요	그래 방에다 말렸어요
방애다 말르다가 인재	방에다 말리다가 이제
어디 살다가 보니깨루 인재 또 이 연타니 나와 가주구서	어디 살다가 보니까이제 또 이 연탄이 나와 가지고
연타늘 인재 저 우리 아래채 요기 인는 쪼만 방애다가 인재 해 가주구	연탄을이제 저 우리 아래 채 여기 있는 조그만 방에다가 이제 해 가지고
고기다가 인재 또	거기다가 이제 또
또 그래서 꼬추능 거기다 말르구	또 그래서 고추는 거기다 말리고
인재 지 연타늘 인재 또 이래 또 버개다가 인재 요래 해 노코	이제 연탄을또 이래 부엌에다가 이제 이렇게 해 놓고
방애 그 연타널 때고 불두 때고 이래 두부 가지루 해서 때구 사라써요	방에그 연탄을 때고 불도 때고 이렇게 두 가지로 해서 때서 살았어요
조리	조리
저 사누조리 할 때두 따뜨타개 하지 안나요	저 산후조리할 때도 따뜻하게 하지않나요
사누조리럴 어티개 해요	산후조리를 어떻게 해요
시어먼니미 게실 때야 사누조리 인저 일쭈이런 해찌요	시어머님이 계실 때야산후조리 이제 일주일은 했지요
예저내 일쭈일 아니 일쭈일 아니먼 더넌 안나조요	예전에 일주일 아니 일주  일 아니면 더는 안하지요
예저낸 그래서요 다	예전에는 그랬어요 다
그래서 인재 일쭈이른 시어먼니미 이쓸 때 해찌마넌	그래서 이제 일주일은시어머니가 있을 때 했지만
낻나트루근 인재 우리 어먼니미 해찌요	아이 넷 낳도록은 우리 어머님이했지요
낸 나쿠능 우리 내째 아들 두살 머거서 우리 할머이가 도라가시구	넷 낳고는우리 넷째 아들 두 살 먹어서 우리 할머니가 돌아가시고
그미티루넌 인재 제가 해찌만	그 밑으로는 이제 제가 했지만
그르키 이르키 아푼 대가 마나요	그렇게 이렇게 아픈 데가 많아요
선생님 내가 기냥 너머너머 아파요	선생님 내가 그냥 너무너무 아파요
이래머 아파 가주구서	이래 뭐 아파 가지고서
허허	허허
어떤 때는 이르키 생가글 해보먼 그래요	어떤 때는 이렇게 생각을 해 보면 그래요
아이구 내가 어트개 그러구루 살다가 내 몸만 이르캐 대꾸나 시퍼 가주구	아이구 내가 어떻게 이러구로 살다가 내 몸만 이렇게 됐구나 싶어 가지고
한시만 생가기 마이 드러갈 때가 이써요	한심한 생각이 많이 들어갈 때가 있어요
허허	허허
왜 그러캐 마니 난능가 모르개써요	왜 그렇게 많이 낳았는가 모르겠어요
허허허	허허허
근대 그 가조깨라고 이써써요	근데 그 가족계획이라고 있었어요
가족깨 인재 그거 핸는대 저넌 그개 마뜰 아내 가주구 모태써요	가족계획 그거 했는데 저는 그게 맞지 않아 가지고 못 했어요
모타고	못 하고
그캐 팔 람매럴 인재 난는대루 다 키워써요	그렇게 팔 남매를 이제 낳는 대로다 키웠어요
잘 키워찌요 머	잘 키웠지요 뭐
팔 람매럴 다 기냥 고 난는대루 다 고대루 키워 가주구	팔 남매를 다 그냥그 낳는 대로 그대로 키워 가지고
즈더리 저래 다 가서 바번 머꼬 살고 인재 이라닝깨	저희들이 저렇게 다 가서 밥은 먹고 살고 이러니까
애더리 인재 돈 주구 이라니깨 이르캐 사닝깨	애들이 이제 돈 주고 이러니까 이렇게 사니까
인재 이걸로 저넌 만조커고 이르캐 사라요	이걸로 저는 만족하고 이렇게 살아요
고냥 허허	그냥 허허
조리할 때 처매 인재 애 나코 나면	조리할 때 처음에 애 낳고 나면
국뚜 끄려 주구 밥뚜 해주구 그러자나요	국도 끓여 주고 밥도 해주고 그러잖아요
우리 시어먼니미 하시찌요	예 우리 시어머님이 하셨지요
그걸	그걸
일쭈일 간	일주일 간
그걸 머라 그래	예 그걸 머라 그래
맨처매 멍는 밥	맨 처음에 먹는 밥
근대 인재 처꾹빠비라 구라자나요	그런데 이제 첫국밥이라고 그러잖아요
처꾸개 처매 애기 나서 인재 바패 주능 개 처꾹빠비여	첫국에 처음에 아기 낳아서 이제 밥해 주는 게 첫국밥이야
그거는 어트개 머거써요	그거는 어떻게 먹었어요
그거넌 인재 에 인재 이 양바니 인재	그거는 이제 에 이제 이 양반이 이제
그때는 미여기 어디 기해써요	그때는 미역이 어디 귀했어요
며기 기해 가주구	미역이 귀해 가지고
멱뚜 사다 노치두 아내써요	미역도 사다 놓지도 않했어요
여기 점빵이 하나 이썬는대	여기 전방이 하나 있었는데
거기 가서 이 양바니 가서 사 가주구 와서	거기 가서 이 양반이 가서 사 가지고 와서
그래 인재 우리 어먼니미 그래 끄리 줘찌요	그래 우리 어머님이 그래 끓여 주었지요
그땐 왜 미역뚜 그르캐 기하등가 몰라요	그땐 왜 미역도 그렇게 귀했던가 몰라요
미역뚜 기해써요	미역도 귀했어요
멱뚜 요마낭 거 하나 가주구 인재 일쭈일 그냥 그려 머거찌	미역도 요만한 거하나 가지고 이제 일주일 그냥 끓여 먹었지
쪼꼼썩	조금씩
요새는 머 미역 다	요새는 뭐 미역 다
막 미역 천지 아니애요	막 미역 천지 아니에요
재배하자나요	재배하잖아요
그러묘	그럼요
미여기 머 얼마나 마나요	미역이 뭐 얼마나 많아요
지금 애기 안 나두 미여꾸걸 머 얼매나 끄리머거요	지금 아기 안 나도 미역국을 뭐 얼마나 끓여 먹어요
저두 지금두 미역꾹 잘 끄리 머거요	저도 지금도 미역국 잘 끓여 먹어요
지금	지금
그때는 미역뚜 기해 가주구	그때는 미역도 귀해 가지고
요렁 거 하나만 하니배 기냥 끄리 머꾸 그라먼 끈나능 거요 인재	요런 거 하나면 한 입에 그냥 끓여 먹고 그러면 끝나는 거요 이제
며꾸기구 머구 머	미역국이고 뭐고 뭐
허허허	허허허
그때 당시는	그때 당시는
배기리나 돌잔치 아까 제가 여쭤 바짜나요	백일이나 돌잔치 아까 제가 여쭤봤잖아요
배길 가틍 거 예저내 잔치는 잘 아내찌요	백일 같은 거 예전에 잔치는 잘 안했지요
배길	백일
아내써요	안 했어요
우리 애덜	우리 애들
배기른 기냥 인재 기냥 내빌라두구	백일은 그냥 이제 그냥 내버려두고
인재 돌만	이제 돌만
그냥 미여꾹만 그 나른 배기리먼 그날 인재 기냥 미여꿍만 끄리서 기냥 바파구머꼬	그냥 미역국만 그 날은 백일이면 그날 이제 그냥 미역국만 끓여서 그냥밥 하고 먹고
인재 돌때넌 기냥 인재	이제 돌 때는 그냥 이제
돌 돌떠그루 해 줘야 조타 하닝깨 기냥 인재 그래	돌 돌떡으로 해 줘야 좋다고 하니까 그냥 이제 그래
머머 해써요 돌 때는	뭐뭐 했어요 돌 때는
돌 때 인재 기냥 이 기냥 백썰구 떡카구	돌 때 이제 그냥 이 그냥 백설기떡하고
그또 그냥 이르캐 백썰구	그것도 그냥 이렇게 백설기
그때마내도 자라넌 사람덜 이르캐 떠걸	그때만 해도 잘 하는 사람들 이렇게떡을
무지개 떠그라 무지개 떠기라고 이르캐 해놔요	무지개 떡이라고 무지개 떡이라고 이렇게 해놔요
수수파떠기라 고라능 겨 수부파떡	수수팥떡이라 그러는 거야 수수팥떡
그때 인재 그르캐 해논는대	그때 이제 그렇게 해 놓는데
무지개 떠기라고 머 무럴 이르캐 세가지 디리서 요르캐 해요	무지개 떡이라고 뭐 물을 이렇게 세 가지 들여서 이렇게 해요
고로캐 해 논는대	그렇게 해 놓는데
우리넌 인재 그렁 거뚜 모태써요	우리는 이제 그런 것도 못 했어요
모타고 그냥 인재 백썰구 하구	못 하고 그냥 이제 백설기 하고
쑤수 그	수수 그
홀찍깨라카넝 거 만드는 거	벼훑이라고 하는 거 만드는 거
거기서 나오 뚜디리먼 나오거던뇨	거기서 나오는 두드리면 나오거든요
거거 쑤수때	그거 수수깡
그거 인재 농사징 걸루 그걸 글캐 해 가주구서	그거 이제 농사 지은 걸로 그것을 그렇게 해 가주구서
그걸 빠시 가주구 인재 이래 쑤수파떠기라구 인재	그걸 바숴 가지고 이제 이렇게 수수팥떡이라고 이제
쑤수파떠기라카지요 그거럴	예 수수팥떡이라고 하지요 그것을
쑤수파떡	수수팥떡
그 고물	그 고물
고무를 팓 파스로	고물을 팥 팥으로
파스루	팥으로
파스루 하능 거 인재	어 팥으로 하는 거
파스루	팥으로
고물루 하구	고물로 하고
애들 돌 돌잔치 하면서 돌쌍은 안 차려요	애들 돌 돌잔치 하면서 돌상은 안차려요
그때 당신 돌싸리	그때 당시는 돌상이
돌쌍은 우리넌 모차리써요	돌상은 우리는 못 차렸어요
우리애덜 팔 람매 다 모태존넌대	우리 애들 팔 남매 다 못 해줬는데
이 삼신깨라고 이짜나요	이 삼신 할머니라고 있잖아요
삼신할매이라고	삼신할머니라고
요 구석찌다가	이 구석에다가
이재 지벌 까라요	이제 짚을 깔아요
지벌 깨끄시 인재 다 추리서	짚을 깨끗이 이재 다 추려서
인재 이캐 다 추리 가주	이제 이렇게 다 추려가지고
깨끄타개 추리 가주 인재	깨끗하게 추려 가지고 이제
구석찌다가 쪽 깔구서	구석에다가 쪽 깔고서
미어꾸 끄리고	미역국 끓이고
인재 그 쌀바벌 해 가주구서 인재 그래 거기서	이제 그 쌀밥을 해 가지고서제 그렇게 거기서
맹간자하고 인재 요래 쎄가지	맨간장하고 이렇게 세 가지
물 떠 노코	물 떠 놓고
고로캐 바가지다 무럴 떠 노 떠 노코	그렇게 바가지에다 물을 떠 놓 떠놓고
그래 가주구서	예 그래 가지고서
삼신할마이한태 빈다고 그래서	삼신할머니한테 빈다고 그래서
하하하	하하하
구석찌다가 그르캐 하능 기여	구석에다가 그렇게 하는 거야
하하하	하하하 예
그래 노코 인재 삼신할마이 바가치라고	그래 놓고 삼신할머니 바가지라고
인재 여 옌나래 실겅 이르캐	이제 여기 옛날에 시렁 이렇게
저 매노차나요	저 매어 놓잖아요
실겅이라고 이르캐 에	시렁이라고 이렇게
집찜마둥 이따시피 해요	집집마다 있다시피 해요
그라먼 인재 거기다가 메주 다	그러면 이제 거기다가 메주 다
메주럴 끄리서 달구 이라자나요 고런대	메주를 끓여서 달고 이러잖아요 그런데
인재 거기다 메주루두 달구	이제 거기다 메주도 달고
구석찌다가 삼신바가지라구 인재 물 떠 농능 거요	구석에다가 삼신바가라고이제 물 떠 놓는 거요
그거넌 바가치	그것은 바가지
고기다가 인재 물두 떠 노코	거기다가 이제 물도 떠 놓고
그래야 인재 그기 어퍼나요 또	그래야 이제 그걸 엎어 놔요 또
멀뚜즉 해 노코	해 놓고
또 나중애 인재 또 애덜 인재 또 인재 머 아푸거나 머 어트가거나 하먼	또 나중에 이제 또 애들 이제 또 이제 뭐 아프거나 뭐 어떻게 하거나 하면
인재 집까라 노쿠 물 떠다 노쿠 또	짚 깔아 놓고 물 떠다 놓고 또
우리 할마이넌 또 빌대요	우리 할머니는 또 빌데요
흐흐 비러 비러	흐흐 빌어 빌어
그라먼 애더리 인재 그래 또 갠잔코	그러면 애들이 이제 그래 또 괜찮고
그래 가주구	그래 가지고
그르캐 살구	그렇게 살고
머 애들 도래넌 항상 인재 기냥 그르캐 백썰구하구 저 쑤수파떠카구	뭐 애들돌에는 항상 그냥 그렇게 백설기하고 저 수수팥떡 하고
우린 이르캐배끼 아내조써요	우린 이렇게밖에 안 해 줬어요
멱꾸끄리던지 바패 노코 이래 직까라 노코	미역국 끓이든지 밥해 놓고 이렇게짚 깔아 놓고
고기다가 인재 기냥 바팡 거럭 미여꾹 항 거럭 맹간장 인재 요래 쫌 떠 노코	거기다가 이제 그냥 밥 한 그릇 미역국 한 그릇 맹간장 이제 이렇게 좀떠 놓고
떠꾸걸 해 농 거	떡국을 해 놓은 거
이래 처꾸빠비라구 애기 나먼 또 그르캐 해요 또	이래 첫국밥이라고 애기 낳으면 또 그렇게 해요 또
이르캐 해노	이렇게 해놓지
그리캐 해찌요 머	그렇게 했지요 뭐
쑤수파떠근 언재까지 해 조써요	수수팥떡은 언제까지 해 줬어요
며쌀 쩡도까지	몇 살 정도까지
그거넌 돌 때만 해줘써요	그거는 돌 때만 해줬어요
그 뒤애는	그 뒤에는
안 해 조써요	안 해 줬어요
그거  이 그 열 쌀 먹뚜룩 해 주먼 조태요	그거  열 살 먹도록 해 주면좋대요
열 쌀 먹뚜룩	열 살 먹도록
그리타는대 우리넌 그러캔 안 해조 바써요	그렇다는데 우리는 그렇게는 안 해줘 봤어요
그래서	아 그래서
열 쌀 먹뚜룩 아내 보고	열 살 먹도록안 해 보고
냥 돌 때	그냥 돌 때
돌 때만 이재 그래 해 주구넌 안해 조써요	돌 때만 그렇게 해 주고 안 해 줬어요
요새 머그니까 수수파떠기 마신는대 저 어려쓸때는 그개 그르캐 머끼 시러써요	요새 먹으니까 수수팥떡이 맛있는데 저 어렸을 때는 그게 그렇게 먹기 싫었어요
마저	맞아
근대	근데
그래두 마시	그래도 맛이
그런대 저히 어머니가 지금 말쓰마 제가 그래서 여쭤 보넝 거애요	그런데 저희 어머니가 지금 말씀하신 제가 그래서 여쭤 보는 거예요
거이 열 쌀 때까지 해써요	거의 열 살 때까지 했어요
저 하꾜 다닐 때까지 그걸 해주셔써요	저 학교에 다닐 때까지 그걸 해주셨어요
그래 가주구 저는 머끼 시른대 자꾸만 생일만 대먼 해 주능 거애요	그래 가지고 저는 먹기 싫은데 자꾸만 생일만 되면 해 주는 거예요
해 주지요 그기 조태요	해 주지요 그게 좋대요
그쌔 열 쌀 먹뚜루기요	글쎄 열 살 먹도록이요
열 쌀 먹뚜룩 수수파떠캐주믄 저 조타넌대 아내조써유	열 살 먹도록 수수팥떡해 주면 저 좋다는데 안 해 줬어요
저넌	저는
함 분 돌 때만 우리애더런	한 번 돌 때만 우리 애들은
다 돌 때만 함 분 해 주만 안 해조요 거냥	다 돌 때만 한 번 해 주면 안 해줘요 그냥
해주두 모타고	해주지도 못하고
막 그냥 그냥 지 생이리라구 인재	막 그냥 그냥 제 생일이라고
양 며꿍만 끄리 주구	그냥 미역국만 끓여 주고
인재 이래 바벌 좀 머 인재	이제 이래 밥을 좀 뭐 이제
그때 머 쌀두 얼매나 기해요	그때 뭐 쌀도 얼마나 귀해요
그래서 쌀바비라고 인재 쪼꼼 해서 주구 미여꾸 끄리서 기냥 이래 주구 이래찌	그래서 쌀밥이라고 이제 조금해서 주고 미역국 끓여서 그냥 이렇게 주고 이랬지
그러캐 아내써요	그렇게 안 했어요
저는 해보지 아내써요	저는 해 보지 않았어요
그런 시가니 웁구	그런 시간이 없고
해 줄 씨간두 웁서	해줄 시간도 없어
모르개써유 귿때 저히두 그르캐 풍조카개 살지를 아나꺼든뇨	모르겠어요 그때 저희도 그렇게 풍족하게 살지를 않았거든요
그런대 하이튼 그 저 수수파떠근 그르캐 하시드라구요	그런데 하여튼 그 저 수수팥떡은 그렇게 하시더라고요
그걸 해 주만 조태요	예 그걸 해주면 좋대요
쑤수파떠글 그래 열 쌀 먹뚜룩 해 주먼 조타캐서	수수팥떡을 그래 열 살 먹도록 해 주면 좋다고 해서
그래 해 주넌 엄마드리 마나써요	그렇게 해 주는 엄마들이 많았어요
저넌 해 주두 모태떠요	저는 해 주지 못했어요
수수두 저기 수 수수두 찰 개 이꾸 메 개 메 메 개 이꾸 그래요	수수도 저기수 수수도 찰 게 있고 메 게 메 메 게 있고 그래요
게 그 수수파떠카능 거넌 찰 걸루 해야 대요	그래 그 수수팥떡하는 것은 찰걸로 해야 돼요
찰 걸루 하고	예 찰 걸로 하고
메거넌 인재 메쌀	메 거는 멥쌀
그거넌 방애 찔 때두 그거넌 인재 메싸런 바배 바불 해 머꼬	그거는 방아 찧을 때도 그거는 이제 멥쌀은 밥에 밥을 해 먹고
찰거넌 인재 거 수수파떠갈 때	찰 거는 이제 그 수수팥떡 할 때
떠캐 머걸 때	떡 해 먹을 때
그러구 인재 그걸루 저 수수부꾸미라고 꿔요	그리고 이제 그걸로 저 수수부꾸미라고 구워요
부칭개루요	부침개로요
그르닝깨 부칭개루 꾸만 그걸루 떠꾹 끄리넌 대두 느쿠	부침개로 구우면 그걸로 떡국 끓이는데도 넣고
기냥 인재 이르캐 부꾸미라고 그 그래요	에 그냥 이제 이렇게 부꾸미라고그것을 그래요
수수부꾸미라구 그래요	수수부꾸미라고 그래요
그그 이러멀	그것 이름을
부침개 꾼넝 거럴	부침개 굽는 거를
그래 가주 그르캐 해서두 해 머꾸 고라지요	그래 가지고 그렇게 해서도 해 먹고 그러지요
찰 걸렁 그르캐 해요	찰 것으로는 그렇게 해요
두 가지루	두 가지로
그거 쩌기 비 방삐 매능 거 이짜나요	그거 저기 방 비 매는 거 있잖아요
하양 거	하얀 거
그거 그거는 멩거애요	그거는 멘 거예요
그건 그	그건 그
찰 거애요 그개	찰 거에요 그게
그기요	그게요
두 가지 다르나요	두 가지가 다른가요
지그먼 그 비매넝거넌별로 조털 아내요	지금은 그 비 매는 것은 에 별로 좋지를 않아요
옌날 수수거떨 아내요	옛날 수수같지 않아요
그거넌	그거는
근대 그기 마니 안 나온다카대요	그런데 그게 많이 안 나온다고 하데요
그 비 매넝거넌	그 비 매는거는
근대	근데
찰쑤수 메쑤수	찰수수 메수수
우리 우리덜 농 옌나래 농사질 때넌	우리 우리들 농 옛날에 농사지을 때는
그르캐 막 비 비 매넝 거 이렁 거 직 지금거치 징 개 안 나오고요	그렇게막 비 매는 거 이런 거 지금같이 긴 게 안 나오고요
비럴 매도 거냥 인재 쪼마치 쪼만하지요	비를 매도 그냥 이제 조그만큼 조그만하지요
인재 옌날 우리덜	이제 옛날 우리들
빨강 거두 이써써요	빨강 것도 있었어요
우 옌날 우리덜 비매 가주 쓸 때넌	예 옛날 우리들 비 매 가지고 쓸 때는
빨가나이 쪼마나니 머 다 매두 쪼매내써요 그냥	빨간하니 조그만하니 뭐다 매도 조그만 했어요 그냥
고래서 고렁 걸루 그냥 메쑤수 찰쑤수 인재 이렁 걸루 해 가주구	그래서 그런걸로 그냥 메수수 찰수수 이제 이런 걸로 해 가지고
뚜디리 가주 이래 해 머거찌마넌	두드려 가지고 이렇게 해 먹었지만은
그거 지금 나오는 이른 그른 비짜리넌 옌나래넌 웁써써요	그거 지금 나오는이런 그런 빗자루는 옛날에는 없었어요
지금 이기 중녀내 그기 나와짜나요	지금 이게 중년에 그게 나왔잖아요
그 비 매능 개	그 비 매는 게
비 매능 거뚜 오래 돼찌	비 매는 것도 오래 됐지
그 인재 비 매능 거 나오능 거 또 오래되갠내	그 이제 비 매는 거 나오는 것또 오래 되겠네
할먼니문 지금 얘기 드러보니까 머	할머니는 지금 얘기 들어보니까 뭐
저기 씨집싸리 가틍 거는 별루 안 하싱 거 가트내요	저기 시집살이 같은 것은별로 안 하신 거 같네요
씨집싸린 안 해써요	시집살이는 안 했어요
그냥 마음	그냥 마음
시집싸린	예 시집살이는
그런대서는 마으믄 펴나셔떵거 가태요	그런 데서는 마음은 편하셨던 거 같아요
우리 할머니가	예 우리 할머니가
아주 마미 차카시구요	아주 마음이 착하시고요
아주 인재 이 이르캐 피라내 와 가주 산다구	아주 이제 이 이렇게 피란에 와가지고 산다고
아주 저 얼마나 기냥 애낀지 몰라요	아주 저럴 얼마나 그냥 아꼈는지 몰라요
그라고 옌나래넌 저기 또 아드럴 마니 나먼	그리고 옛날에는 저기 또 아들을 많이 낳으면
메느릴 엄청 조아해짜나요	며느리를 엄청 좋아했잖아요
개서 우리 어먼니미좀그전 인재 그저내넌 점	그래서 우리 어머님이에 좀그전 이제 그전에는 좀
형재루 마니 내려오고	에 형제로 많이 내려 오고
인재 독씬도 이써꼬	이제 독신도 있었고
형재로만 내려와꺼던뇨	형제로만 내려왔거든요
우리 어먼님 대꺼지	우리 어머님 대까지
예전부텅 그래따는대	예전부터 그랬다는데
우리 대애 이 요그 이 양반 동짜 돌리무루 와 가주구서넌	우리 대에 이 요기 이 양반 동자 돌림으로 와 가지고는
자손드리 줌 흐내써요	자손들이 좀 흔했어요
그래 가주구 딸 하나 나쿠서이재 아드럴 인재 내리 느이럴 나꺼던뇨	그래가지고 딸 하나 낳고서 이제 아들을 이제 내리 넷을 낳았거든요
그라니 우리 어먼니미 세상애 나 혼자만 메느리 봉 거거치	그러니 우리 어머님이 세상에 나 혼자만 며느리 본 것같이
아주 그냥 그르캐 저럴 생가걸 하더라고요	아주 그냥 그렇게 저를 생각을 하더라고요
그라구 인재 고상안다구	그리고 이제 고생한다고
우리 어먼니미 인재 이르캐 와 가주구 고생한다 이르캐 아주 한다구	우리 어머님이 이제 이렇게 와 가지고 고생한다 이렇게 아주 한다고
우리 어먼니미 아주 마미 천시니써요	우리 어머님이 아주 마음이 천신이었어요
아주 그냥	아주 그냥
우리 어먼님 나 하나두 시집싸리 안 씨기써요	우리 어머님 나 하나도 시집살이 안 시켰어요
시댁카구 칭전하구 혹씨 그 습꽈니 달라 가주구	시댁하고 친정하고 혹시 그습관이 달라 가지고
머 실쑤하시거나 머 그렁 거는 업써써요	뭐 실수하시거나 뭐 그런 거는 없었어요
그렁 거넌 업써요	그런 거는 없어요
음식	음식
제사 음시기나 머 명절 풍수비나 이렁 거뚜 여기 다 그렁 거 차이가 별루 업찌요	제사 음식이나 뭐 명절 풍습이나 이런 것도 여기 다 그런 거 차이가 별로없지요
별로 업찌요 그렁 건	별로 없지요 그런 건
그린대 인재 우리넌 인재 이	그런데 이제 우리는 이제 이
저넌 인재 칠팔손하구 인재 이 당숙	저는 이제 칠 팔촌하고 이 당숙
이런 대서 인재 나 저한태 당숙떠라고 칠팔쏜 이런 대서 인재 만치	이런 데서이제 저한테 당숙들하고 칠팔촌 이런 데서 많지
저넌 딸만 우리 아부지가 네시라서요	저는 딸만 우리 아버지가 넷이라서요
그 이재 시지불 다 오고 나니깨 그 뒤루넌 머	그 이제 시집을 다 오고 나니까그 뒤로는 뭐
친정애 그리차나요	어 친정에 그렇잖아요
그래 가주구 인재 사춘 동생도 인재 이르캐 그 여르시고	그래 가지고 사촌동생도 이제 이렇게 그 여렷이고
그래서 인재 이 고무덜두 여러시구 이르치마넌	예 그래서 이제 이 고모들도 여럿이고 이렇지만은
저만 우리 아부지 대애서	저만 우리 아버지 대에서
에 우리 크나부지하구 우리 아부지하구 둘 두 형제부니 딸만 이써요	에 우리큰아버지하고 우리 아버지하고 둘 두 형제 분이 딸만 있어요
그르캐	그렇게
그래 가주구서 줌 그 자소니 줌 기핸넌대 인재	그래 가지고 좀 그 자손이 좀귀했는데 이제
줌 친정애두 자소니 좀 마니 귀한 태기써써요 예저내넌	좀 친정에도 자손이좀 많이 귀한 턱이었었어요 예전에는
그랜는대 여기두 오닝깨	그랬는데 여기도 오니까
그르캐 인재 쫌 형재더리 우 우애서넌 형재더리 두 분썩 머 이르캐 좀 되더라고요	그렇게 이제 좀 형제들이 위 위에서는 형제들이 두 분씩 뭐 이렇게 좀 되더라고요
이 양반두 인재 형재구	이 양반도 이제 형제고
그르캐 이란는대 인재 우리 이 양반 동자 돌리매 와 가주구	그렇게 이랬는데이제 우리 이 양반 동자 돌림에 와 가지고
우리더리 그르캐 마니 나찌요	우리들이 그렇게 많이 낳았잖아요
그라이 그라닝깨 우리 어먼니미 그르캐 조아 하시드라고요막	그러니 그러니까 우리 어머님이 그렇게 좋아 하시더라고요 막
우리 어먼니먼 이 이 동내서도 너머 차카고	우리 어머님은 이 이 동네에서도 너무 착하고
그리캐 아주 저기 참 조은 으러니라구 이르캐 마니 얘기럴 드러써요	그렇게 아주 저기 참 좋은 어른이라고 이렇게 많이 얘기를 들었어요
그르니까 자손드리 잘 되지요	그러니까 자손들이 잘 되지요
하하	하하
그링 거 가태요	그런 거 같아요
호호호	호호호
피란 가따 와서두	피란 갔다 와서도
이우찌배 비가 오먼 이우찝 베럴 먼지 더퍼주고	이웃집에 비가 오면 이웃집벼를 먼저 덮어주고
내꺼넌 나중애 애 가서 이르캐	내 것은 나중에 가서 이렇게
비가 와도 그 에 너렁 거럴 퍼 당꼬 이르캐 하신 냥바니래요	비가 와도 그 에넌 것을 퍼 담고 이렇게 하신 양반이래요
그래서 그르캐 자손더리 잘 되넝 거 가태요	예 그래서 그렇게 자손들이잘 되는 거 같아요
저두 그래요	저도 그래요
그래 참 너머 천시니어써요	그래 참 너무 천신이었어요
아주 우리 어먼니미	아주 우리 어머님이
난 시집싸리라곤 아나고 사라써요	난 시집살이라고는 안 하고 살았어요
머 그냥 옌나래넌 그리차나요	뭐 그냥 옛날에는 그렇잖아요
사넝 거뚜 우리 어먼님 진짜 배두 마니 골쿠 도라가시써요	사는 것도 우리 어머님 진짜 배도 많이 곯고 돌아가셨어요
고래 저두 그냥 이르캐 와서 사넌대 아럴 느이럴 라코	그래 저도 그냥 이렇게와서 사는데 아이를 넷을 낳고
그 인재 우리 어먼님 도라가시찌마는	그 이제 우리 어머님은 돌아가셨지만은
대영고기라고 먹짜나요	대양곡이라고 먹잖아요
대양곡 그거 먹찌 농사넌 지꼬 사라도	대양곡 그거 먹지 농사는 짓고 살아도
인재 그때는 스댕그럭 이써요	이제 그때는 스테인리스 그릇이었어요
스댕 그러깅대	스텐인리스 그릇인데
바불 그냥 인재 요만창 요래 디리먼	밥을 그냥 이제 요만큼 요렇게 드리면
나럴 애기 어머이라구 그냥 나럴 그걸 반천 더러줘요	나를 아기 어머니라고그냥 나를 그걸 반쯤 덜어 줘요
반천 더러 주먼 내 그기 안 너머가요	반쯤 덜어 주면 내가 그게 안 넘어가요
그래 아이고 어먼님 날 이걸 더러 주먼 대냐고 잡쑤라먼	그래 아이고 어머님날 이걸 덜어 주면 되냐고 잡수라면
야야 너넌 애기 어머이라 머거야 한다	야야 너는 아기 어머니라 먹어야한다
이라민성 그르캐 날 머그라구 더러주구 이러카싱 냥바니지	이라면서 그렇게날 먹으라고 덜어 주고 이렇게 하신 양반이지
그라구 인재 어머이가 또 따리 인재 느이라서	그리고 이제 어머니가 또 딸이이제 넷이라서
하난 일번 가서 이꼬	하나는 일본 가서 있고
인재 이 우리 어머이가 팔씹다서새 도라가션넌대	이제 이 우리 어머니가 팔십다섯에 돌아가셨는데
친정 어머이가	친정 어머니가
인재 딸래 스 스이찌배 여기 저기 가서 마니 게시고	이제 딸네 셋 집에 여기 저기 가서 많이 계시고
또 저한태 와서두 마니 게시고	또 저한테 와서도 많이 계시고
그래서 이따가 우리 어머이럴 인재 조카한태 가서 도러가셔써요	그래서 있다가 우리 어머니는 조카한테 가서 돌아가셨어요
우리 사촌동생한태 가서	우리 사촌동생한테 가서
요줌	예
요줌 며느리드른 어때요	요즘 며느리들은 어때요
옌날 생가캐 보면	옛날 생각해 보면
우리 메널래더넌 차캐요 다	우리 며느리들은 착해요 다
안즉까지넌뇨	아직까지는요
안즉까진 다 차칸대	아직까진 다 착한데
다른 사람덜 매너리덜 머 어띠코 머가 어띠코 막 이르캐 싼능 거 보만	다른사람들 며느리들 뭐 어떻고 뭐가 어떻고 막 이렇게 하는 거 보면
그링가 이리루	아 그런가 이래도
우리 메늘래더런 아직꺼진 잘 해요	우리 며느리들은 아직까지는 잘 해요
자라고 차캐요 다	잘하고 착해요 다
메늘래	며느리들
아직까지가 아니라 차카먼 게속 차카지요	아직까지가 아니라 착하면 계속 착하지요
하하하	하하하
며느리가 또 잘하면 더 이쁘자나요	며느리가 또 잘 하면 더 예쁘잖아아요
해해해	해해해
귀여꼬	귀엽고
근대 우리 큰메느리가 쌍둥이럴 나써요	예 그런데 우리 큰며느리가 쌍둥이를 낳았어요
쌍둥이럴 첟 처다드럴 쌍둥이럴 첟빼애 나쿠서넌 재 형재나쿠서넌 안 나요	쌍둥이를 첫 첫아들을 첫 배에 낳고서는 형제 낳고는 이제 안 나요
인재 우리 쌍둥이더리 하난 커 가주 지금 쌍둥이 하낭 구닌 가구	이제 우리쌍둥이들이 하나는 커 가지고 지금 쌍둥이 하나는 군인 가고
하난 지배 이꾸 인재	하나는 집에 있고 이제
그뚜 곧 간대요	그것도 곧 간대요
가두 그리타는대	걔도 그렇다는데
메느리가 고래 함 분 나서 애기두 안 낭 거 거틀꺼요 아매	며느리가 그래 한번 낳아서 애기도 안 낳은 거 같을 거요 아마
근대 그르키 차캐요	그런데 그렇게 착해요
근대 차카고	그런데 착하고
내가 우리 메늘래한태 잘 모대 중 거시 인재 줌 마미 아푸지요	에 내가  우리 며느리들한테 잘 못해 준 것이 좀 마음이 아프지요
허허허	허허허
멀 모태줘요 멀	뭘 못 해 줘요 뭘
머 좀 자래조야 하넌대	으 뭐 좀 잘 해줘야 하는데
즈더란태 내가 도널 타 쓰고 사닝깨	자기들한테 내가 돈을 타 쓰고 사니까
멀 좀 잘 모태주자나요	뭘 좀 잘 못 해주잖아요
허허	허허
에이 그거야	에이 그거야
즈더란태 자래 줘야 대넌대 잘 모태주고	자기들한테 잘해 줘야 되는데 잘 못해주고
키워중 거만 해두 얼만대요	키워준 것만 해도 얼만데요
하하하	하하하
그래자내두 그래요	그러잖아도 그래요
으허허허	으허허허
아이구 내가 느더란태 이르캐 쓰 이르캐 살고 이르캐 줌 모태준다 하먼	아이구 내가 너희들한테 이렇게 살고 이렇게 좀 못 해준다 하면
우리 아들래가 그래요	우리 아들네가 그래요
엄마 저 키와중 거마내두 고맙따구 고래요	엄마 저 키워준 것만 해도 고맙다고 그래요
재사널 좀 물려 주고 이라먼 조은대 그 맘대루 안 됩띠다 근	재산을 좀 물려주고 이러면 좋은데 그게 마음대로 안 됩디다 그건
하하하하	하하하
돈 벌 기회가 웁꼬	돈을 벌 기회가 없고
그라고 또 그때넌 돈 벌장사나 머 여러 가지 조꺼니 안 마저 가주구	그리고 또 그때는 돈 벌 에 장사나 뭐 여러 가지 조건이 안 맞아 가지고
머 우짤 수 웁꼬	뭐 어쩔 수 없고
사넝 거시 그리치요 머	사는 것이 그렇지요 뭐
예저낸 다 고생하구 살자나요	예전에 다 고생하고 살잖아요
재산 물려 주능 거 아무 소용업써요	재산 물려 주는 거 아무 소용없어요
어허허허	어허허허
허허	허허
그거는 아무 소용어꾸	그거는 아무 소용 없고
저는 그러캐 생가캐요	저는 그렇게 생각해요
그 재산 물려줄라면	그 재산 물려 주려면
그냥 내가 사라인는 동아내 그 재산 가주구 펴나개 이따가	그냥 내가 살아있는동안에 그 재산 가지고 편하게 있다가
글쌔 내	글쎄 내
죽 죽 주거야지 댄다 이런 생가기거더뇨	죽죽 죽어야지 된다 이런 생각이거든요
그러니까 어르신들두 그르캐 생가카시면 펴나자나요	그러니까 어르신들도 그렇게 생각하시면 편하잖아요
쪼꿈 미하난 저문 이찌요 머	조금 미안한 점은 있지요 뭐
다런 사라먼 참 재사니 마나 가주구	다른 사람은 참 재산이 많아가지고
근대	근데
아휴	아휴
인재 우리 아덜리나 메느리더리한태 제가 그라지요	우리 아들이나 며느리들한테 제가 그러지요
나넌 자식떠란태 큰소리두 모타구	나는 자식들한테 큰 소리도 못하고
난 느더란태 이기 타 쓰구 이래 사닝깨 내가 모등 기	나는 너희들한테 이렇게타 쓰고 이렇게 사니까 내가 모든 게
우리 메늘래한태두 미안하다카구	우리 며느리들한테도 미안하다고 하고
내가 이르캐 더러 그래요	내가 이렇게 더러 그래요
고라먼 에 어먼니미 아나푸고	그러면 에 어머님이 안 아프고
바패 잡쑤꼬 아번님 바배 주고	밥 해 잡수시고 아버님 밥 해 주고
어따 어먼니 겅강항 거시 조치	무엇보다 어머님 건강하신 것이 좋지
그렁 거 우리가 버러 우리가 멍넝 거지	그런 거 우리가 벌어 우리가 먹는 거지
그르기 조치	그른게 좋지
그런 생각 하시지 말구 몸만 겅강해 달라고 그래요	그런 생각하시지 말고 몸만 건강해 달라고 그래요
머 마내 조따	뭐 안 해 줬다
해 조따 머 어트개따	해 줬다 뭐 어떻게 했다
이런 소린 함번두 아내요	이런 소리는 한 번도 안 해요
우리 메너리더리	우리 며느리들이
그링까 건강하싱 개 해 주능 거애요	그러니까 건강하신 게 해 주는 거예요
예예	예 예예
그래요	그래요
아번님	아버님
아푸구 누워 게셔 바요	이프고 누워 계셔 봐요
그럼 누가 와서 바야 되는대 그개 얼마나 힘들어	그럼 누가 와서 봐야 되는데그게 얼마나 힘들어
그런대	예 그런데재
그거 안 해 주능 건만매두	그거 안 해 주는 것만 해도
아번님 바비나 해주고 어먼니 겅강항 기 저 조타고	아버님 밥이나 해주고어머님 건강한 게 저 좋다고
인재 그르캐 그 얘기지 머	그렇게 그런 얘기지 뭐
다른 얘긴 할 꺼 아니요	다른 얘긴 할 거 아니요
우리 메눌래가 다 차캐요	우리 며느리들이 다 착해요
하하하	하하하
사위두 사위들두 잘 하자나요	사위도 사위들도 잘 하잖요
사위덜두 우리 사우덜그튼 아들 웁써요	예 사위들도 우리 사위들같은 아들 없어요
진짜 참 머 우리짐 냥바니 여 이따시피 해도	진짜 참 뭐 우리집 양반이 여기있다시피 해도
우리 사우덜두 참 잘해요	우리 사위들도 참 잘 해요
우리 사우더리	우리 사우들이
사우더리 인재 오먼 용똔 주지	사우들이 이제 오면 용돈 주지
딸래도 고라지 머	딸네도 그러지 뭐
우리 아덜래덜도 그라고	우리 아들네들도 그러고
그랑깨 그래 이르캐 살지요	그러니까 그래 이렇게 살지요
장 장모가 사위	장모가 사위
장모는 사위 사랑이라 그런대자너요	장모는 사위 사랑이라 그런다잖아요
그링깨 그걸 모태중깨 미아나지요	그러니까 그걸 못 해주니까 미안하지요
아이고 마미지요 머	아이고 마음이지요 뭐
마미구	마음이고
글 모태중개 미아나지 항상	그걸 못 해주니까 미안하지 항상
처가찌배 오면 머 밥 따뜨타개 해 주먼 그개 고마웅 거지요 멀	처가집에 오면뭐 밥 따뜻하게 해 주면 그게 고마운 거지요 뭘
으흥	으흥
게 인재 기냥 바번 기냥 해주지요 머	그래 이제 그냥 밥은 그냥 해 주지요 뭐
바번 해주지만	밥은 해 주지만
즈더리 다 해 가주 와서 머꼬	자기들이 다 해가지고 와서 해 먹고
즈더리 와서 해 가주	자기들이 와서 해 가지고
즈더리 가주 와서 머거요	자기들이 가지고 와서 먹어요
즈드리 가주 와 가주 해 머꼬	자기들이 가져 와 가지고 해 먹고
그라니깨	그러니까
게 내가 그라지요	그래 내가 그러지요
머든 모등 기 느덜 보기 미안하다카먼	뭐든 모든 게 너희들 보기 미안하다고하면
그런 소리 하지 말라카지	그런 소리 하지 말라고 하지
옌나래는 머 사위가 저 뱅년손니미라구 해찌만	옛날에는 뭐 사위가 백년 손님이라고 했지만
으흐흐흐	으흐흐흐
뱅년손니미라카고 사위가 장모사랑은 사위 사랑은 장모라카자나요	백년 손님이라고 하고 사위가 장모사랑은 사위 사랑은 장모라고 하잖아요
근대 그런 사랑얼 제가 모타고 나니 미아나지요	그런데 그런 사랑을 제가 못하고 사니 미안하지요
머 얘기 하시능 거보니까 잘 하시는대	뭐 얘기 하시는 거 보니까 잘 하시는데
하하하	하하하
잘 하덜 모태요 허허	잘 하질 못해요 허허
그냥 밤만 기냥 오먼 바번 기냥 해 주지	그냥 밥만 그냥 오면 밥은 그냥 해주지
손자드른 그럼 얼마나 되요	손자들은 그럼 얼마나 돼요
손자두 망캔내요	손자도 많겠네요
손자 만치요	손자 많지요
이 왜손자하는 둘씩 둘씩	이 외손자는 둘씩 둘씩
두리고	둘이고
근디 우리 친손자덜두 둘씩둘씩	그런데 우리 친손자들도 둘씩 둘씩
딸도 둘씩 둘씨기구 그래요	딸도 둘씩 둘씩이고 그래요
아이구 아이구	아이고 아이고
딸 하나뿌니유	딸 하나뿐이요
우리 아드리야 아들	우리 아들이야 아들
아덜래넌	아들네는
우리가 인재 아덜런 딸 하나뿌니구	우리가 아들은 딸 하나뿐이고
딸도 인재 망내따런 또 아덜만 두리구	에 딸도 이제 막내딸은 또 아들만둘이고
맹끄투머린	맨끄트머린
인재 큰딸하고 두째딸하고만 남매야	큰딸하고 둘째 딸하고만 남매야
남매	남매
그 남자가 훨씬 더 마너요	그 남자가 훨씬 더 많아요
그르갠내요	그렇겠네요
인재 형재 형재 형재더리 더 만치	이제 형제 형제 형제들이 더 많지
아드리 더 마나요	아들이 더 많아요
우리 두째 아드리 남매지 아더런	우리 둘째 아들이 남매지 아들은
두째 아더리 여기 여 영동 여기 겅강아빠뜨 사는대	둘째 아들이 여기 여 영동건강아파트 사는데
가더리 남매구	걔들이 남매고
그르카고넌 아덜리 형재요 형재	그러하고는 아들이 형제요 형제
함 번 저기 지배 이캐 모이면 머 그냥	한 번 저기 집에 이렇게 모이면 뭐그냥
잘 짜리도 업써요	잘 자리도 없어요
벅쩍벅쩍하갠내요	벅적벅적하겠네요
여기꺼지 다 자도 막 꽉 차지요	예 여기까지 다 자도 막 꽉 차지요
방이 이르캐 마는대요 방이	방이 이렇게 많은데요 방이
그르캐써요	예 그렇겠어요
그래서 이기 지벌 질 때 아덜 따리 망키 때미내	그래서 이게 집을 지을 때 아들 딸이 많기 때문에
여기 셰 방 세카내다가 여 화장시럴 이 아내 여기다 느야 되넝 거럴	여기 세방 세 칸에다가 여기 화장실을 이 안에 여기다 넣어야 되는 것을
이걸 방으로 쓸라고	이걸 방으로 쓰려고
하나 더 느코	하나 더 넣고
저 화장실럴 저리 밀 밀치내뿌리써	저 화장실은 저리 밀쳐 밀쳐 내버렸어
다 지 노코서 그래 여기다 화장시를 느써요	다 지어 놓고는 그래 여기에다화장실을 넣었어요
개서 여기 다 자도 다 자두 기냥	그래서 여기 다 자도 다 자도 그냥
쫌 헤헤 그래요	좀 헤헤 그래요
그래도 한 한 이틀 그르캐 인재 머여 기냥 그래다가 인재 여러시 이따가 가먼	그래도 한 한 이틀 그렇게 이제 뭐야 그냥 그러다가 여럿이 있다가 가면
집뚜 다 빙 거 그찌요 머	집도 다 빈 것 같지요 뭐
허저나지요	허전하지요
허저나구	예 허전하고
명절 때넌 머 막 그냥 인재 한 이틀 그냥 그르캐 만치요	명절 때는 뭐 막 그냥 한 이틀 그냥 그렇게 많지요
그래도 그러캐 또 으	그래도 그렇게 또
와따가면 조차나요	왔다가면 좋잖아요
허허허	허허허
조치요	예 좋지요
모미 불펴날 때는 힘드릉 거 가튼대요	몸이 불편할 때는 힘든 것 같은데요
와따 가면 그래두 그개 흐무타구	왔다가면 그래도 그게 흐뭇하고
그럼뇨	예 그럼요
그기 인재 우리넌 인재 그래 글루 그래 이내선	그게 이제 우리는 이제 그래 그것으로 그렇게 인해서
자슥떨루 이내서 이르키 살지요	자식들로 인해서 이렇게 살지요
우리 자식뜨리 다 효자요	우리 자식들이 다 효자요
고래도	그래도
부모들한태 함 분 나뿐 소리 함 번 아나고	부모들한테 한 번 나쁜 소리 한 번안 하고
아직꺼지넌 나이가 오십 쌀썽 너머써도	아직까지는 나이가 오십 살씩 넘었어도
머 부모더란태 나뿐 소리하고 머	뭐 부모들한테 나쁜 소리하고 뭐
이르친 아내요	이렇지는 않아요
그린대 인재 아푸로넌 몰라도 아지까진	어 그런데 앞으로는 몰라도 아직까지는
허허허	허허허
지금 얘기 드러보먼뇨	지금 얘기 들어보면요
그런 사람 좀 이써요	그런 사람 좀 있어요
그런 사람덜도	그런 사람들도
그래니	그러니
쯛 아직까지넌	쯧 아직까지는
옌나래 저기 질쌈하자나요	옛날에 저기 길쌈하잖아요
해찌요	했지요
저 와서 해찌요	제가 와서 했지요
쭈로 머 시머써요	주로 뭐 심었어요
멀루 해써요	뭘로 했어요
인재 삼배더 나보고요	이제 삼베도 놔보고요
인재 머 모캐 가주고	이제 뭐 목화 가지고
그거 해서 인재	그거 해서 이제
인재 지캐 이르캐 명 자사 가주	이제 이렇게 명 자아 가지고
그걸루 배두 하꼬구	그걸로 베도 했고
모카는 언재 어디애 시머써요 주로	목화는 언제 어디에 심었어요 주로
저기 저 지금 고속또로 나써요	저기 저 지금 고속도로 났어요
거기	거기
거기 저 여 아내 저 골짜기 거기가 방애 두째	거기 저 여 안에 저 골짜기거기가 밭이 두 떼기
받티 두 여래 두 때기 이써요	밭이 두 요래 두 뙤기 있어요
그른대 항 군대넌 인재 밀거틍 거 머 버쭝두 하구	그런데 한 군데는 이제 밀같은 것 뭐  하고
그렁 거 하고	그런 거 하고
거기다 항 가라 항 가지넌 저 짝때기럴 명얼 가라떠요	거기다 한 가지 한 가지는 저 쪽 뙤기는 미영을 갈았어요
고 명이 잘 대요	그 미명이 잘 돼요
양지라서	양지라서
개서 인재 거거 명 인재 거기다 해서 따다가	그래서 이제 그거 미영 이제 거기다 해서 따다가
인재 방 뜨신대 말러 가주구	방 따뜻한 데에서 말려 가지고
그 이캐 씨아시라고 이써요	그 이렇게 씨아라고 있어요
거기다 이르캐 인재 돌리서 인재	거기다 이렇게 이제 돌려서 이제
그걸루 인재 이르캐 해 가주구	그걸로 이제 이렇게 해 가지고
화리라 화를 아시능가 몰라	활이라 활을 아시는가 몰라
이 대나무 이르캐 후리 가주구	이 대나무 이렇게 휘어 가지고
녹끄누로 이르캐	노끈으로 이렇게
저 노끄니라카먼 아신 아시지	저 노끈이라고 하면 아시 아시지
예예	예예
노끈 그걸루 이르캐 화를 만 이르캐 만드러 가주구	노끈 그걸로 이렇게 활을만 이렇게 만들어 가지고
그걸루 인재 에 이런머	그걸로 이제 에 이런 뭐
베루 항 거 이써요	베로 한 거 있어요
베루 요로캐	베로 이렇게
베 낭 거 그 뚜꺼웅 걸루	베 난 거 그 두꺼운 걸로
요르캐 지구서로	이렇게 지고서
거 화를 탕 여기다 메	그 활을 탕 여기다 매고
이르캐 씨아루 아사 가주구	이렇게 씨아로 앗아 가지고
명 아승 걸 딱 여기다 땅애다 노코	미영 앗은 걸 딱 여기에다 땅에다 놓고
고 활로 이르캐 이거럴 탕	그 활로 이렇게 이거를 탕
이걸로 자버땡기머 탕탕 이르캐 하머뇨	이걸로 잡아 당기면서 탕탕 이렇게 하면요
그기 다 타저요	그게 다 타져요
그 아주 보얀 소미 대자나요	그 아주 보얀 솜이 되잖아요
그걸루 인재 이 저기 이런 상애나	그걸로 이제 이 저기 이런 상에나
머 이런 이르캐 찌 큰 상 이런 큰상애나 이런대	뭐 이런 이렇게 기 큰상 이런 큰 상에나 이런 데
이런 상 이런 대나 노코선 이거	이런 상 이런 데나 놓고선 이거
그 그 쑤수때 이짜나요	그 그 수숫대 있잖아요
그 쑤수 안 쓸 때 맹 꼭때기	그 수수 안 쓸 때 맨 꼭대기
그 비 매능 거 끄능 거	그 비 매는 거 끊은 거
거 쪼꼼 굴긍 기 이써요	그 조금 굵은 게 있어요
고골루 인재 이르캐 마라요	그걸로 이제 이렇게 말아요
꼬추라구 해요 그거럴	고치라고 해요 그것을
요망코마개 마라 가주구서 인재	요만큼하게 말아 가지고서 이제
거 빼요	그거 빼요
또 빼고 또 빼개 믹	또 빼고 또 빼게 막
마니 이르캐 싸 노코서넌 인재 그걸 해 가주고	많이 이렇게 쌓아 놓고서는이제 그걸 해 가지고
그걷 그 삼 삼끔내키로 요로캐 살짱 무꺼서 해 노먼뇨	그거 그 삼 삼끈으로요렇게 살짝 묶어서 해 놓으면요
그래두 그거럴 인재 노부더 가주구두	그래도 그거를 놉을 얻어 가지고도
인재 그거럴 망 마니 하넌 사람더런 노부더 가주구	이제 그거를 막 많이 하는사람들은 놉을 얻어 가지고
그걸루 인재 이르캐 두레명이	그걸로 이제 이렇게 두레명이
두래명이라 구래요	두레명이라 그래요
그 노부더 가주구 그래서 그걸 러서	그 놉을 얻어 가지고 그래서 그걸 넣어서
인재 노부더서 타고 머	이제 놉을 얻어서 타고 뭐
막 꼬추 말구 이르캐 해 가주구두 하구	막 고추 말고 이렇게 해 가지고도하고
두레 명이요	두레 미명이요
두래놉	두레놉
여러시 하니깨 두래명이라 구래구	여럿이 하니까 두레명이라고 그러고
두래놉	두레놉
그래	예 그래
두래놉 두래명	두레놉 두레명
개 두래명 노부더 가주구	그래 두레 미명 놉을 얻어 가지고
사라멀 마니 모으넝걸 두래	사람을 많이 모으는 걸 두레
그래 가주 인재 그거 꼬추두 이르캐 무꿍 거 그걸 가따가 인재	그래 가지고그거 고치도 이렇게 묶은 거 그걸 가지고 이제
또 명차	또 명 자아
이르캐 가 그거럴 이르캐 그걸 저기 물래라구 고래요	이렇게 가 그걸 이렇게그걸 저기 물레라고 그래요
여 요러캐	여 이렇게
물래 아실껄료	물레 아실걸요
똥그랑 거	동그란 거
그걸로 이러캐	예 그걸로 이렇게
인재 이건 가라기고	이제 이건 가락이고
가라기라능 거 이르캐 해 가주 주럴 매 가주구	가락이라는 건 이렇게 해 가지고 줄을 매어 가지고
거기다 이거 둘루미 이래 이래 이르캐 빼자나요	거기다 이거 두르며 이렇게이렇게 빼잖아요
실 가누깨 빼넝 거 가주구	실 가늘게 빼는 거 가지고
아옵쌔 배 여덜쌔 배 닫쌔 배 이리카거던뇨	아홉새 베 여덟새 베 다섯새 베이렇게 하거든요
그라먼 인재 그기 이 닫쌔 베가 젤 나뿐 베구요	그러면 그게 이 다섯새 베가제일 나쁜 베고요
인재 여덜쌔 베 아옵쌔 베가 젤 공 거요	여덟새 베 아홉새 베가 제일 고운거예요
매 여 고깨 자성 거넌 인재 아홉쌔 베	매 여 곱게 자은 것은 이제 아홉새베
아홉쌔 베라	아홉쌔 베라고
잘 빼야	잘 빼야
그 아옵쌔 베하구 다섭뻬 다서쌔 베가 처으매 함 번 할 때 나오능 거요 아니면 두 번 세 번	그 아홉새 베하고 다섯 베 닷덧새 베가 처음에 한번 할 때나오는 거예요 아니면 두 번 세 번
아니 게소캐서 게소캐서 조은 시럴 뽀바야 대능 거여	아니 계속해서 계속해서 좋은 실을 뽑아야 되는 거야
게소캐 조시럴 마처야 대요	계속해서 중심을 맞춰야 돼요
여러 번 해서	여러 번 해서
인재 다쌔 베라넝 거넌 기냥 인재 부르릉부르릉부르릉하먼 인재 구깨 나와요	예 이제 다섯새 베라는 것은 그냥 부르릉부르릉부르릉 하면 이제 굵게 나와요
쎄개 하느라고 그라넝 거여	빨리 하느라고 그러는 거야
꼬부릉 그라고	꼬부르릉 그러며
쎄개 나와따 인제 해 가주구	세게 나왔다 이제 해 가지고
부릉 구랑깨 나와 굴거요 고개	부르릉 그러니가 나와서 굵어요 그게
그 아매 그걸루 하만 인재 그기 다쌔 베고요	그 아마 그걸로 하면 그 다섯새베고요
명이 인재 안 조웅 거 이써요	미영이 이제 안 좋은 거 있어요
명도 씨찔루 빼거던뇨	미영도 세 등급으로 빼거든요
네 예	네 예
그라먼 인재 그 명이라넝 거럴 인재 그거럴 씨찔로 빼먼	그러면 이제 그 미영이라는 것을 이제 그것을 세 등급으로 빼면
젤나뿡기 다쌔 베요	제일 나쁜 게 다서새 베요
그라고 인 맬 저 젤 조울 게 이써요	그리고 이제 멜 저 제일 좋은 게 있어요
보얀 인재 고 모캐가 뽀야캐 피넝 기 이꺼던뇨	보얀 그 목화가 보얗게 피는게 있거든요
그르까먼 고 조옹 거럴 인재 가리고	그렇게 하면 좋은 것을 이제 가리고
나뿡 거 가리구 시찔루 가리지요 거기	나쁜 거 가리고 세 등급으로 가리지요거기
그라먼 인재 일곱쌔 베 아홉쌔 베 인재 그기 젤 조웅 거요	그러면 이제 일곱새 베 아홉세 배 이제 그게 제일 좋은 거예요
닫쌔 베가 그기 인지 병이 명이 나뿡 걸루	다섯새 베가 그게 이제 명이 미영이 나쁜 걸로
부릉부릉 자사 가주구 내	부릉부릉 자아 가지고 이제
끄트머릴 하능 기여	끄트머리를 하는 거야
그래 가주 그걸루 인재 나뿡 걸루 인재 그걸 베머 그기 다쌔 베요	예 그래 가지고 그걸로 나쁜 걸로 이제 그걸 베면 그게 다서새 베요
제일 조웅 거넌 인재	제일 좋은 것은 이제
하하하	하하하
그러면 그개	그러면 그게
닫쌔베를 나를 때	다서새 베를 날 때
그러잉까 여러 번 뽀바서 다쌔 저기 아옵쌔 베가 대능 거요	그러니까 여러 번뽑아서 다서새 저기 아홉새 베가 되는 거예요
아니면 처매 뽀불 때 귿	아니면 처음에 뽑을 때 그
처매 볼 보풀 때부텀 쁠떵 쁠떵 모캐가 나뿡 기 이써요	처음에 보풀 부풀 때부터 뿔떡 뿔떡 목화가 나쁜 게 있어요
그건 모콰 자채가	그건 목화 자체가
모카 다래라가요	목화 다래가요
모콰 자채가 나뿡 걸루 항거다 이거여	목화 자체가 나쁜 걸로 한 거다 이거야
명 나무애	미영 나무에
명 나무애	미영 나무에
인재 시리 시리 고깨 암 빠저 나온다 이거요	이제 실이 실이 곱게 안 빠져 나온다 이거요
명 나무애 보야캐 저 작 조웅 거 이써요	미영 나무에 보얗게 저 작 좋은거 있어요
명이	미영이
고래 핑 개 하야캐 요래피자나요	그렇게 핀 게 하얗게 요렇게피잖아요
하양 거	하얀 거
그라먼 조웅 거 따루 하구요	그러면 좋은 거 따로 하고요
고다매 또 따루 하구	그 다음에 또 따로 하고
젤 나뿡 거 또 인재 좀 이써요 그기	제일 나쁜 것 또 이제 좀 있어요 그게
그렁 건 아슥 그거럴 이르캐 타만 기냥 뿔떡	그런 건 아이 그것을 이렇게 타면 그냥 뿔떡
그기 인재 그기 뿔떡 인재 저 베라카지요	그게 이제 뿔떡 이제 저 베라고 하지요
그걸 짜먼	그걸 짜면
그건 안 조아요 베가	그건 안 좋아요 베가
그람 이 그걸루 머럴 하너냐머 여자덜 소곧태입꾸요	그러면 그걸로 뭐를 하느냐 하면 여자들 속옷 해 입고요
인재 남자더런 바지저고리럴 맨들자나요	이제 남자들은 바지저고리를 만들잖아요
바지 저고릴 맨들먼 인재 그걸루 두루매기 맨들구	바지저고리를 만들면 이제그걸로 두루마기 만들고
옌나랜 그래짜나요	옛날엔 그랬잖아요
조웅 건 인재 아홉쌔 베 일곱쌔 베 이걸루 해 가주고	좋은 건 이제 아홉새베 일곱새 베 이걸로 해 가지고
그걸루 남자덜 두루매기 맨들고	그걸로 남자들 두루마기 만들고
바지저고리 쬐끼 이렁 걸루 만들자나요	바지저고리 조끼 이런 걸로 만들잖아요
그래 가주구서루 그래 인재 근 그르캐 해서	그래 가지고그래 이제 그건 그렇게 해서
그걸로 하지	그걸로 하지
그러니까 그게 다섯쌔 베 일 일곱쌔 베 아옵쌔 베 하능 개	아 그러니까그게 닫쌔베 일곱쌔베 아홉쌔베 하는 게
모콰가	목화가
모카애서	예 목화에서
조웅 건지 안 조웅 건지 거기서부터 결쩡대능 거지요	좋은 것인지 안 좋은 것인지 거기서부터 결정되는 거지요
거기서부텀인재	예 거기서부터 예
요기넌 인재 젤 조웅 거	여기는 이제 제일 좋은 거
요긴 두째 요긴 세째요	여기는 둘째 여기는 셋째야
세째가 젤 나뿡 거지요	셋째가 제일 나쁜 거지요
그기 명이 안 조아요	예 그게 미영이 안 좋아요
그거넌	그것은
젤 조웅 거시 인재 보야캐 명 송오리서부텅 고로캐 잘 피요	제일 좋은 것이보얗게 미영 송이에서부터 그렇게 잘 피어요
인재 고건 따루 해 가주구	이제 그건 따로 해 가지고
제일 고웅 걸루 그로캐 하지	제일 고운 걸로 그렇게 하지
상중하로 가리넝 거여	상중하로 가리는 거야
그게 인재 처매 달리면	그게 이제 처음에 달리면
꼬치 펴따가 지면 이르캐 똥그라캐 요로캐 반들반들 하자나요	꽃이 피었다가지면 이렇게 동그랗게 요롷게 반들반들 하잖아요
다래	목화다래
다래가 열지 아나요	목화다래가 열지 않아요
에 고골	에 그걸
씨버 머그먼	씹어 먹으면
그양 고대도 얘기핸짜이	그냥 방금도 얘기했듯이
물랠 돌리 가주 이 시럴 뽐는 대도 기수리 드러가	물레를 돌려 가지고 이 실을뽑는 데도 기술이 들어가
근대 인재 그기 고웅 거넌뇨	그런데 그게 고운 것은요
이 가느라야 되니까 조웅 거넌	이게 가늘어야 되니까 좋은 거는
그르치요	그렇지요
고고 아옵쌔 베 맨들라먼	그거 아홉새 베 만들려면
이 정성으루 드리야 돼요	이 정성으로 드려야 돼요
시리 시리 인재 쪼꼬루 나와야 대거더뇨	실이 실이 이제 족 고르게 나와야 되거든요
꼬추럴 살고마창 지 가주구 인재	에 고치를 살짝 쥐어 가지고 이제
요래 살살 둘르민성 요래 고 시를 뽀바요	이렇게 살살 돌리면서 요렇게 그실을 뽑아요
그래 가주구 인재 고골루 젤 조웅 개 아옵쌔 베요	그래 가지고 이제 그걸로제일 좋은 게 아홉쌔 베요
으음	으음
게 그걸루 인재 두루마기 바지저고리 머 인재 남자덜 해 주구	그래 그걸로 이제 두루마기 바지저고리 뭐 이제 남자들 해 주고
인재 그 두 번째두 인재 또 바지저고리 두루매기 그렁 거 만드는 사람두 이꾸	이제 그 두 번째도 또 바지저고리 두루마기 그런 거 만드는 사람도 있고
젤 나뿡 거넌 여자들 소곧	제일 나쁜 것은 여자들 속옷
으흐흐흐	으흐흐흐
여자덜 소곰 만드러 입짜나요	여자들 속옷 만들어 입잖아요
옌나래넌 지그먼 팬트라카자나요	옛날에는 지금은 팬티라고 하잖아요
옌나랜 그걸루 팬트 맨들구	옛날에는 그걸로 팬티 만들고
고 고쟁이라구 이써요	고 고쟁이라고 있어요
여꺼지 지다낭 거	여기까지 기다란 거
그렁 거	그런 거
여 미태까지 내려오능 거지요	여기 밑에까지 내려오는 거지요
마창 거 고쟁이	예  고쟁이
이 그두 그 여자 오시 세 가지요	이 그것도 그 여자 옷이 세 가지예요
여자 오뚜	여자 옷도
여자런 세 가진	여자들은 세 가지는
남자넌 팬트하구 바지저고리 이부먼 되는대	남자는 팬티하고 바지저고리 입으면 됐는데
여자 아주 이지 예저내넌 게 두 가지 세 가지럴 이버요	여자 아주  예전에는 그 두 가지 세 가지를 입어요
여자는뇨	여자는요
세 가지요	세 가지요
네가지꺼지 입찌요	예 네 가지까지 입지요
어떠캐섣	어떻게 해서
그 이르미 다 다를꺼 아니요	그 이름이 다 다를 거 아니에요
그럼	그럼
팬트	팬티
팬트 이꾸서 인재 이 또 고쟁이라구 이써요	팬티 입고서 이제 이 또 고쟁이라고 있어요
그거 그거 이꾸	그거 그거 입고
또 인재 또 저기 기냥 이르캐 바지처럼 만드러 가주	또 이제 저기 그냥 이렇게 바지처럼 만들어 가지고
그냥 인재 이르캐 가래 가래꼬장이라구 이써요	그냥 이제 이렇게 가래 고래고장이라구 있어요
가래꼬쟁이	가랫고쟁이
그래 그거하구 세 가지 이꾸	그래 그거하고 세 가지 입고
이 그 소꼬시라넝 거넌뇨	이 그 속곳이라는 거는요
소꼬시라넝 거넌 바지가 지그무로 마라먼 여자덜 합빠지 막	속곳이라는 거는바지가 지금으로 말하면 여자들 핫바지 막
통 킁거	통 큰 거
킁 거 이래 막	예 큰 거 이렇게 막
그럼 인재 그렁 거 해 가주구	그러면 이제 그런 거 해 가지고
그걸루 또 해 소꼬시라구 이버요	그걸로 또 해 속곳이라고 입어요
소꼬시 고쟁이 바까태 이버요 안내 이버요	속곳이 고쟁이 바깥에 입어요 안애 입어요
젤 배까태 임넝 거시 소꼬시요	제일 바깥에 입는 것이 속곳이요
소꼳	속곳
단소꼬슨 머요	단속곳은 뭐요
그기 단소꼬시여	그게 단속곳이야
그개 단소꼬시애요	그게 단속곳이에요
예 그기 단소꼬시요	예그게 단속곳이요
젤 나중애 인재	제일 나중에 이제
제일 나중	제일 나중
거테	겉에
치마미태	치마 밑에
그래 저 바로 치마 미태 임넝기 단소꼬시요	그래 저 바로 치마 밑에 입는 게단속곳이에요
그라고도 또 치마 이꾸 압치마 입짜나요 또	그리고도 또 치마 입고 앞치마입잖아요 또
근대 여자덜두 허리띠라구 이써요	그런데 여자들도 허리띠라고 있어요
허리띠	허리띠
그뚜 허리띠럴 만드러 가주구	그것도 허리띠를 만드어 가지고
허리띠라고 또 짬매자나요	허리띠라고 또 동여매잖아요
그 저	그 저
여자들 옌나래 여자드리 엄청 마니 이버요 오설	여자들 옛날에 여자들이 엄청 많이 입어요 옷을
지그먼 여자드리 쪼꿈 이꾸	지금은 여자들이 조금 입고
남자드리 마니 입짜나요 지그먼	남자들이 많이 입잖아요 지금은
예저내넌 남자더런 머 인재 기냥 팬트 이꼬	예 예전에는 남자들은 뭐 그냥 팬티 입고
바지저고리 그냥 이부만 댄는대	바지저고리 그냥 입으면 됐는데
여자드른 우애도 인재 저기 속쩍쌈 이꼬	여자들은 위에도 이제 저기 속적삼입고
허리띠 하고	허리띠 하고
또 조고리 입짜나요	또 저고리 입잖아요
적쌈하고 저고리하고 어트개 딸라요	적삼하고 저고리하고 어떻게 달라요
적싸먼 인재 여러매 임넘 개 적싸미이요	적삼은 이제 여름에 입는 게 적삼이에요
여르매	여름에
적싸먼 여러매 임넝 개 적싸미고	적삼은 여름에 입는 게 적삼이고
배기접쩌고리라카능 거 인재 트래다 바거 가주구 인재	배기겹저고리라고 하는것은 이제 틀에다 박아 가지고 이제
배기접쩌고리리야	배기겹저고리래
저고리를 또 트래 바거 가주 해 이버요	저고리를 또 틀에 박아 가지고 해 입어요
니비서	누비어서
그거시 인재 배기접쩌고리라 고라지	그것을 이제 배기겹저고리라고 그러지
배기접쩌고리는 그럼 하양걸로 겨부로 저브로 맨드러요	배기겹저고리는 그럼하얀 걸로 겹으로 겹으로 만들어요
바가 가주구요	박아 가지고요
기냥 이캐 두처버로 해 가주	예 그냥 이렇게 두 겹으로 해 가지고
두처부루 바가서 해 이버요	두 겹으로 박아서 해 입어요
그말두 지금 처음 드러보는 마리애요	그 말도 지금 처음 들어보는 말이에요
배기조고리요	배기저고리요
바금저고리	박음저고리
배기접쩌고리래능 거 첨 드러 보는 마리요	예 배기겹저고리라는 거 처음들어 보는 말이에요
바거 배기접쩌고리라 그리요 바가서 임넝 거요	배기겹저고리라고 그래요 박아서 입는 거요
바검접쩌고리지요	박음겹저고리지요
인재 그개	이제 그게
그러면 인재 아까 그 다래	그러면 아까 그 다래
다래 그냥 다래라고 해요 모콰따래라 그래요	다래 그냥 다래라고 해요 목화다래라 그래요
모괃따래	목화다래
모콷따랜대 그르캐 아주 사라무루 마라먼 이뿐 사람	목화다래인데 그렇게 아주 사람으로 말하자면 예쁜 사람
중간 싸람 아이구 왜 저러캐 미워 이르차나요	중간 사람 아이고 왜 저렇게미워 이렇잖아요
그거 마창가지지요 그기	그거와 마찬가지지요 그게
아주 그 보얀 아주 송오리 때부텀 그리캐 아주 명 쏭오리가 조아요 이뿌구	아주 그 보얀 아주 송이 때부터 그렇게 아주 미영 송이가 좋아요 예쁘고
보이얀 한	보얀
그냥 맨처매	그냥 맨 처음에
그래서 인재 고고럴 따루 모아 나요	그래서 이제 그거를 따로 모아 놔요
고걸 따로 막 푸대애다가 인재 막 말롸야 대요	그걸 따로 막 부대에다가 이제막 말려야 돼요
낭중애 여능 건	나중에 여는 건
그거뚜 또오	그것도 또
그거뚜 막 이르캐 인재 베태다가 말루먼	그것도 막 이렇게 이제 볕에다가 말리면
뿔떡	뿔떡
인재 그걸 보온 베 중 그 중간찔루 이르캐 세깔 세 가지루 그래 빼 가주구서	이제 그걸 보온 베 중 중간 등급으로 이렇게 세가 세 가지로 빼 가지고서
고걸 말롸 가주구서 그래 씨아시 아사 가주 구라자나요 그기	그걸 말려 가지고 그렇게 씨아 앗아 가지고 그러잖아요 그게
이기 명 쏭이자나요	이게 미명 송이잖아요
미영송이	목화송이
다래송이	다래송이
조웅거	좋은 거
그개 처째요 지금	그게 첫째요 지금
명쏭이라 그래요	목화송이라 그래요
그 햐야캐 핑 거	그 하얗게 핀 거
명쏭이	예 목화송이
그거 저 바태 족 피어 이쓰먼 그거 이뿌자나요	그거 저 밭에 족 피어 있으면 그거 예쁘잖아요
이쁘지요	예쁘지요
그기 인지 다래송 다래송이라구 하는대	그게 이제 다래송이 다래송이라고 하는데
다래송이가 아니라 명송이라카드라고요 그거럴	다래송이가 아니라 목화송이라하더라고요 그것을
다래는 암 핑 거 얘기하자나너요	다래는 안 핀 거 얘기하잖아요
그기 다래고요	예 그게 다래고요
그래서 인재 명쏭인대	예 그래서 이제 목화송인데
채고 조웅 걸 명쏭인대	최고 좋은 게 목화송인데
그거 저 바태서 그거 채고 조웅 거럴 뽀바요	그거 저 밭에서 그거 최고로좋은 것을 뽑아요
조고 인재 또 인재 고기 젤 먼저 피거던뇨	저거 이제 또 이제 고게 제일 먼저피거든요
그람 뽀꼬	그럼 뽑고
그 다매는 글 뽀바다가 저런 동사내다가 저런 대다가 인재 피 너러요 그거럴	그다음에는 그걸 뽑아다가 저런 동산에다가 저런 데다가 이제 펴 널어요 그것을
이래 피 널먼	이렇게 펴 널면
인재 그또 먼지 피능 거 이꼬 나중 피능 기 이써요	이제 그것도 먼저 피는 게있고 나중에 피는 게 있어요
그래서 고거또 또 고고 피기	그래서 그것도 또 그거 피기
그저 따루 인재 또 하고	그저 따로 이제 또 하고
젤 나중 피능 기 그기 뿔떡뻬라 그래요 그개	제일 나중에 피는 게 그것을 뿔떡베라 그래요 그걸
그래서 그거 여자덜 소고태 입꼬 머	그래서 그거 여자들 속옷 해 입고 뭐
그냥 여자덜 소고또 그기 머	그냥 여자들 속옷도 그게 뭐
여자드리 기냥 팬트 해 이꼬	여자들이 그냥 팬티 해 입고
그 고쟁이 이꼬	그 고쟁이 입고
소꼬디꼬	속곳 입고
하하	하하
거기다가 또 치마 이꼬 압처마 이꼬	거기다가 또 치마 입고 앞치마 입고
아이구 여기다 허리띠 하구	아이구 여기다 허리띠 하고
인재 또 쏙쩍쌈 입 저고리 입찌 아휴	또 속적삼 입 저고기 입지 아휴
여자드리 그르캐 마니 이버요	여자들이 그렇게 많이 입어요
여자더런 지그먼 마 이르캐 다리가 나오구 이래 파리 나오자나요	여자들은 지금은 막 이렇게 다리가 나오고 이렇게 팔이 나오잖아요
그저내넌 이기 나오먼뇨	그전에는 이게 나오면요
저 와스만 해두요	저 왔을 때만 해도요
여기 여 미태 산적쩌비 이써써요	여기 요 밑에 산직집이 있었어요
산직찌비 이썬넌대	산직집이 있었는데
이기 지금도 그 영상 김씨 사찍찌비요	이게 지금도 그 용산 김씨 산직집이요
근대 요기 산지기가 사란는대	그런데 여기 산지기가 살았는데
저 와스마내도 산지기라구 인재 저 그 사람드리	저 와서만 해도 산지기라고이제 저 그 사람들이
이 이라 그래써요	이 이라고 그랬어요
이이 아부지가 마루니라 구라대요	이이 아버지가 마름이라고 그러대요
거 이이 아부지가	그 이이 아버지가
그른대 그 사람더리 저떠러 아씬님 아씬님 이래써요	그런데 그 사람들이 저더러 아씨님 아씨님 이랬어요
츠매 저 와서마내두 여기 와서	처음에 저 와서만 해도 여기 와서
그 사람더리 아씬님 아씬님 이래꺼더뇨	그 사람들이 아씨님 아씨님 이랬거든요
그래는대 그 사람덜두 더 잘사라요 지금	그랬는데 그 사람들도 더 잘 살아요지금
여가 양바니라고 양방꼬지라고	여기가 양반이라고 양반곳이라고
그래서 인재 저도 우리 어머이가 나럴 하나 키워	그래서 이제 저도 우리 어머니가 나를 하나 키워
인재 매 망내딸 그서 저 열뚜 살 머건는대	이제 매 막내딸 거기서 저 열두살 먹었는데
어디루 내놔야 하까 시꾸	어디로 내놔야 할까 싶고
어머이 혼자 앙 그리커써요	어머니 혼자 안 그렇겠어요
망내딸 하나럴	막내딸 하나를
어디루 내놔야 조우까 시꾸	어디로 내 놔야 좋을까 싶고
머 그냉 이래 저래 생가카다가	뭐 그냥 이래 저래 생각하다가
영상 김씨는 이 지비 여기 영상 낌씨내 양바니라고	용산 김씨는 이 집이 여기 용산 김씨네가 양반이라고
그 인재 우리넌 금넝 낌씨구	그 이제 우리는 금릉 김씨고
여기넌 인재 영동 영동 영상 낌씨라카더라고요	여기는 이제 영동 영동 용산김씨라고 하더라고요
그래서 인재 그래서 인재 버넌 달라도 인재 이르캐 깅간 깅가찌리 와써요	그래서 이제 그래서 이제 본은 달라도 이제 이렇게 김가는 김가끼리 왔어요
오긴 완넌대	오긴 왔는데
그래 인재 옌나래 인재 참 그래 와 가주 이래 사는대	그래 이제 옛날에 이제그렇게 와 가지고 이렇게 사는데
자기 이 지배 사넌 사라미 저한태 장 아씬님 아씬님 이르카더라고요	저기이 집에 사는 사람이 저한테 장 아씨님 아씨님 이러케 하더라고요
처매 와가선	처음에 와 가지고는
그르캐 사라 여가 여기 양반터라구요	그렇게 살아 여기가 여기 양반터라고요
양반싸람 터라구	양반사람 터라고
그러면 모콰 모카 모캐라구 하지요	그러면 목화 목화 모과라고 하지요
근대 그개 씨 암 뺑 거를 얘기하능 겅가요	그런데 그게 씨 안 뺀 것을 얘기하는 건가요
모콰	목화
목 씨 암 뺑 건 모콰고요	예 목 씨 안 뺀 건 목화고요
모콰넌 씨 암 뺑 거	목화는 씨 안 뺀 것
씨 빼면 인재	씨 빼면 이제
씨 뺑 거넌 명송이	씨 뺀 거는 목화송이
명송이	목화송이
탕 거	예 탄 거
이르캐 타자나요	이렇게 타잔하요
그러먼 솜하고 명송이하고는 어트개	그러면 솜하고 목화송이하고는 어떻게
솜하고	솜하고
명송이가	목화송이가
인재 탕 건 소미지 탕 건	이제 탄 건 솜이지 탄 것은
탕 건 소미고	에 탄 건 솜이고
인재 그 씨 암 빵 건 송이 송이지	그 씨 안 뺀 건 송이 송이지
명송이	목화송이
인재 그 다래애서 뺑 개 명쏭이지요	그 다래에서 뺀 게 목화송이지요
다래애서 뺑 개	다래에서 뺀 게
씨 씨 씨가 인능 거	아 씨 씨 씨가 있는 것
씨 드러 가주	예 씨 들어 가지고
조웅 거 인재 고기 명송이고	예 좋은 거 이제 그게 목화송이고
씨 드 씨가 들고	씨 들 씨가 들고
고 재 고고 명 이캐 뺑 개 고 명송이지요	그 이제 고고 미영 이렇게 뺀 게 목화송이지요
뺑 기	뺀 게
씨 뺑거	씨 뺀 거
씨 빼 가주 탕 거	씨 빼 가지고 탄 거
탕 거는 소미라고 마라지	탄 거는 솜이라고 말하지
소미고	솜이고
건 토미고	그건 솜이고
인재 거그 다래애서 이르캐 피 가주구서 명이 요래 나오자나요	이제 거기 다래에서 이렇게 피어 가지고 목화가 이렇게 나오잖아요
고기 명송이지	그게 목화송이지
그개 그개 그러먼 목 모콰라고 해요 그거	그게 그게 그러면 목 목화라고해요 그걸
그개 인재 옌나래넌 그기 미영이라구 핸넌대	예 그게 이제 옛날에는 그게 미영이라고 했는데
모콰라고 그라지요 그기	목화라고 그러지요 그게
그기 옌나래 미영 쫑이니 이라고	그게 옛날에 명송이라고
예기 모콰라 하대요 지그먼	이걸 목화라고 하데요 지금은
그러면 월래 모카가 이르캐 큰 나무자나요	그러면 원래 목화가 이렇게 큰 나무잖아요
이캐	이렇게
그 그걸 모콰라고 하고	그 그걸 목화라고 하고
목 나개 에 모콰나무	예 목나개 에 목화나무
거기애 달링 걸 명이라고 하고	거기에 달린 걸 명이라고 하고
그걸로 저기 시를 뽀부면 그 시른 무순 시리라 그래요	그걸로 저기 실을 뽑으면 그 실은 무슨 실이라고 그래요
씨는 장 그 있어	씨는 장 거기 있어
실 씰	실 실
시른 인재 그기	실은 이제
시른 인재 무명시리구	실은 이제 무명실이고
명 명시리지요 머 인재	명 명실이지요 뭐 이제
명실 무명실	명실 무명실
무명시리지요	예 무명실이지요
무명시리라 구라지 머	무명실이라 그러지 뭐
근대 그기 물래루 자사 가주구	그런데 그게 물레로 자아 가지고
여 이르캐 여매 여 구깨가 요마나먼 빼내거든녀	여 이렇게 요만 여 굵기가 요만하면 빼내거든요
거 가락개다가 끼머 가주구	그 가락에다가 끼워 가지고
그거 인재 그래 그기 가라기라고 고래서	그거 이제 그래 그게 가락이라고 그래서
그기 그이 하넌 그거 아실껄머	그게 그이 하는 그거 아실 걸 뭐
몰라	몰라
아시능가	아시는가
우리 큰딸도 그건 몰르껀대	우리 큰달도 그건 모를건데
에 그기 나트리라구 이써요	에 그게 날틀이라고 있어요
나틀	날틀
나트리 열 깨가 이써요	날틀이 열 개가 있어요
요 구멍이	요 구멍이
요로 이르캐 나트리라고	요롷 이렇게 날틀이라고
요로키 요만창 노풍 기	오렇게 요만큼 높은 게
기리기가 요 요만 함 발 댈랑가 모르거써	길이가 요 요만 한 발 되려나 모르겠
그 베럴 맬라고	그 베를 매려고
나능걸 날트리라 그래여	나는 것은 날틀이라
고골 인재 고초럴 자사 가주구	예 그걸 이제 고치를 자아 가지고
명 가라기라 그르구 열깨를 만드러 가주구	명 가락이라고 그 열 개를 만들어가지고
고 나트래다가	그 날틀에다가
그거럴 인재 한 하낙쓱 끼어 요래	그거를 이제 한 하나씩 끼워 이렇게
빼 가주구	빼 가지고
머 열깨럴	뭐 열 개를
열깨럴 빼 가주구	열 개를 빼 가지고
나 인재 날지요	날 이제 날지요
나능 거시 인재 열 깨럴 줄 줄 뽀바 이르캐 다마놔요	나는 것이 이제 열 개를줄 줄 뽑아 이렇게 담아놔요
열 깨럴 다	열 개를 다
그러먼 인재 가라기 풀리먼 또 하낙 낑꼬	그러면 이제 가락이 풀리면 또 하나끼우고
또 또 하다가 또 다릉 기 또 머니 떠러지먼 그거 또 하나 낑꼬	또 하다가 또다른 게 또 먼저 떨어지면 그것도 또 하나 끼우고
그래 가주구서루 인재 가래럴 메 까래럴 맨드느냐 하먼	그래가지고서 이제 가래를 몇 가래를 만드느냐 하면
그걸루 베럴 이 나라요	그걸로 베를 이렇게 날아요
베 나능거슨 머 암 보시쓸 꺼여	베 나는 것은 뭐 안 보셨을 거야
그러먼 인재 머럴 뱅느냐 하먼	그러면 이제 뭐를 박느냐 하면
그거럴 네 개럴 바가요	그것을 네 개를 박아요
네 개럴	네 개를
이 고쟁이 요마 요마 요망쿰 킁 거럴 네 개럴 바가요	이 꼬창이 요만 요만 요만큼 큰 것을 네 개를 박아요
요기넌 개세고	여기는 개새고
요긴 참새거든뇨	요기는 참새거든요
고로캐 해요	그렇게 해요
그래 가주구서 베럴 인재	그래 가지고 베를 이제
개 개새	개새
개새 참새 이써요 이르캐	개새 참새 있어요 이렇게
요 개새 요기 참샌대 요 개새라 배럴 베뿌럴롸요	요 개새 요기가 참새인데요 개새라 베를 벳불을 놔요
베뿌럴	벳불을
베뿌럴 인재 노만	벳불을 이제 놓으면
그 이캐 가르캐 뺑 거 차곡차곡 항 거럴 그거럴 가따가 인재 쌀마요	그 이렇게 가래 이렇게 뺀 거 차곡차곡 한 것을 그것을 갖다가 이제 삶아요
그거럴	그거를
인재 며때서 인재 이캐 해 가주구서	이제  이제 이렇게 해 가지고
그거 인재 해서	그거 이제 해서
이캐 사 끄 저기 푸럴 메기요	이렇게 사 그 저기 풀을 먹여요
푸럴	풀을
푸럴 이걸 가따가 가래 뽀바 농 거럴	풀을 이걸 갖다가 가래 뽑아 놓은 것을
도투마리라고 이써요 이르캐	도투마리라고 있어요 이렇게
도투 두 개	도투마리 두 개
이캐 말모걸 이르캐 두 개 바가 노코	이렇게 말목을 이렇게 두 개 박아 놓고
도투마리를 여기다 이르캐 탕 노쿠서루	도투마리를 여기다 이렇게 탁 놓고서
이기 인재 안 땡기 가드축	이게 안 당겨 가도록
말모걸 바가야 대자나요	말목을 박아야 되잖아요
그래서 여기 도투마리라구 노쿠서	그래서 여기 도투마리라고 놓고서
가따가 인재 그거 열 깨	갖다가 이제 그거 열 개
그 가락 이르캐 뺑 거럴 인재 나라요	그 가락 이렇게 뺀 것을 이제 날아요
요기 요기 여기 참새라고 인재 요짜개 요로캐 요로캐 해 노코	요기 요기 여기참새라고 이제 이쪽에 이렇게 이렇게 해 놓고
요기 또 욜루 와 가주구	여기도 또 요리 와 가지고
욜루 가구 욜루 욜루 이르캐 가요	요리 가고 요리 요리 이렇게 가요
요래 요래 맨드라서 노만	요렇게 요렇게 만들어서 놓으면
그 기 개새 참새라고 해요	그게 개새 참새라고 해요
그거럴	그거를
이개 멀로 하너냐 하먼 꼬쟁이럴 이르캐 난 그기 이써요	이게 뭘로 하느냐하면 꼬챙이를 이렇게 나는 그게 있어요
두 개	두 개
두 개버 이르캐 두 개쓱 떼능 기요	두 개 이렇게 두 개씩 빼는 게요
그라먼 인재 두 개럴 요 사이럴 요로캐 인재 저기 저기 머여	그러면 이제 두개를 요 사이를 이렇게 이제 저기 저기 뭐야
그링깨 가이패로 이르캐 맨들거던녀 저 가이패로	그러니까 가위표로 이렇게만들거든요 저 가위표로
요기두 요로캐 가이패 요기도 요로캐 가이패 맨드라 가주구	여기도 이렇게 가위표 여기도 요렇게 가위표 만들어 가지고
고기따 요로캐 끼머요	거기다 이렇게 끼워요
고고럴 이캐	그거를 이렇게
마라자먼 인재 이개 이르캐 이르캐 이르캐 생깅 걸	말하자면 이제 이게 이렇게 이렇게 이렇게 생긴 걸
여기다 이르캐 인재	여기다 이렇게 이제
짬매뜨라고요	동여맸더라고요
이르캐	이렇게
그기 짬매 가주구 이기 요동 모타개 인재 해 노코넌	그게 동여매 가지고 이게요동을 못 하게 해 놓고는
거기다가	거기다가
머냐하먼 인재 바디라고 이써요	뭐냐 하면 이제 바디라고 있어요
바디	바디
바디럴 인재 그거시 인넌대	바디를 이제 그것이 있는데
고걸 다 끼야 대요	그걸 다 꿰야 돼요
구멍 하나애다가 다 끼워 가주구	구멍 하나에다가 다 끼워 가지고
예 하나하나 다 끼 가주구	예 하나하나 다 꿰 가지고
그거뚜 이저뻐린내	그것도 잊어버렸네
그거 이기 머 잉애 잉애	그게 이게 뭐 잉앗대 잉앗대
잉애	앵앗대
잉애 잉애 잉애때럴 인재 거기다 꼬꾸	잉아 잉아 잉앗대를 이제 거기다꽂고
잉애때가 두 개가 되거던녀	잉앗대가 두 개가 되거든요
그라만 잉애때럴 꼬꾸서	그러면 잉앗대를 꽂고서
고기다가 인재 그 열 까다기거던녀 고기	거기다가 이제 그 열 가닥이거든요고게
열 까당 열까당 나릉 걸 인재 다 끼구	열 가닥 난 걸 다 끼우고
요래 메 뻐늘 거기 가꺼든녀	요래 몇 번을 거기 갔거든요
고기 이르캐	거기 이렇게
그기 참 나라서 이르캐 해 노먼	그게 차 날아서 이렇게 해 놓으면
다쌔 베 여덜쌔 베 머 일곱쌔 베 아홉쌔 베	다섯새 베 여덟새 베 뭐 일곱새베 아홉새 베
이르캐 가따가 이르개 노머	이렇게 갖다가 이렇게 놓으면
그걸 나라 노먼	그걸 날아 놓으면
그거 인지 그기 고 구멍구멍 다 끼지요 인재 고고럴	그거 이제 그게 고 구멍구멍 다 꿰지요 이제 고것을
고고 인재 고곰 마 바디애다 대	고거 이제 고거 바디에다 대
여기 참새 개새 참새가 인넌대 고고럴 따지 가주구서 나릉 걸 따지서 고기 끼우먼 땅 마자요	여기 참새 개새 참새가 있는데 그거를 따져 가지고 난 걸 따져서 고기 끼우면 딱 맞아요
여기 저기 바디라고 이써요 고개 저개 명 고 끼능 거	여기 저기 바디라고 있어요 그게 저기 목화 그 끼우는 거
고거시 인재	그것이 이제
고기다 끼 가주구 인재 매능 기	거기다 꿰 가지고 이제 매는 게
인재 고거시 매넝 기 머냐 하먼	예 그것이 이제 매는 게 뭐냐 하면
부럴 롸 가주구 푸를 끄리 가주구서 인재 거기다 발라요	불을 놓아 가지고 풀을 끓여 가지고 거기에다 발라요
죽 까따가 저기 여기넌 그거럴 머라고 고라지	죽 갖다가 저기 여기는 그그것을 뭐라고 그러지
그기 머 그기 머라고라지	그게 뭐 그게 뭐라고 그러지
끄씽개지 머	끄싱개지 뭐
여기 이르캐 끄싱갱가	여기 이렇게 끄싱개가
그거	그거
끄싱개라구 돌맹일 가따 노쿠 인재	끄싱개라고 돌맹이를 갖다 놓고
거기다가 돌맹이럴 눌러 놔야지 이기 짝 요러캐 가주구 굴런	거기에다가 돌맹이를 눌러 놔야지 이게 쫙 이렇게 가지고 굴러
그래가주 이래 이래 푸럴 미기 가주 그기 저기 소리라구 이써요 솔	그래가지고 이렇게 이렇게 풀을 먹여 가지고 그게 저기 솔이라고 있어요 솔
베매는 솔 거 아실껀대 왜	베 매는 솔 그 아실건데 왜
그걸루 그래 매 이르캐 기냥 하미 풀 발라 가주	그걸로 그래 매 이렇게 그냥하면서 풀 발라 가지고
이래 이래 매구 인재 엉가이 말르먼	이렇게 이렇게 매고 이제 언간히 말르면
거 개새 참새 그 두 개럴 가따가 인재 저기서 이래 이래 훌꾸	그 개새 참새그 두 개를 갖다가 이제 저기서 이렇게 이렇게 훑고
여기도 이르캐 이르캐 인재 내려오먼 인재	여기도 이렇게 이렇게 이제 내려오면 이제
이개 두잳 첟뻔째가 내리가먼 저기 짜넌대 인넝 거시 참새요 고기	이게 두개 첫번째가 내려가면 저기 짜는데 있는 것이 참새요 그게
몰라 그르캐 하드라구라 그라개	몰라 그렇게 하더라고 그렇개
그르캐 하더라고요	그렇게 하더라고요
그래서 고골루 인재 여 아패 가능 기 이르캐 이르캐 인재 그거 해서 노먼	그래서 그걸로 이제 이 앞에 가는 게 이렇게 이렇게 이제 그거 해서 놓으면
고 디애꺼 요래 요래 해 가주구 말르먼 인재 그 도투마리라구 하는디다 감짜나요 이래	그 뒤에 것 요렇게 요렇게 해 가지고 마르면 이제 그 도투라미라고 하는 데다가 감잖아요 이렇게
가마서 조꺼지 가먼 인저 또 고라고	감아서 저기까지 가면 이제 또 그러고
그래 가주 그르캐 해 노코 고기다 인재 배트리라구 해는대 고기다 디애다 언저노코 그거럴	그래 가지고 그렇게 해 놓고 고기에다 베틀이라고 하는데 거기다뒤에다 얹어 놓고 그것을
바디지비라고 해 노코 고래 그 베트리라고 이짜나요	바디집이라고 해 놓고 그렇게 그 베틀이라고 있잖아요
고기다 노코 그래 짜지요 베럴	거기다 놓고 그렇게 짜지요 베를
그렁 건 다 하시쓸 껄 머	그런 건 다 하셨을 걸 뭐
저는 본저근 인는대 어릴 때 바 가주구 잘 몰라요	저는 본 적은 있는데 어릴때 봐 가지고 잘 몰라요
그거뚜	그것도
그거 모르다가 말쓰마시능 걸 가마니 드르니까 옌날생가기 쪼꼼씩 나요	그거모르다가 말씀하시는 걸 가만히 들으니까 옛날 생각이 조금씩 나요
나지요	나지요
요기다 노쿠서 요로캐 요로캐 항 거뚜 생강나구	할머니가 거기다 놓고서 이렇게 한 것도 생각나고
그 삼 삼넝 거 삼	그 삼 삼는 거 삼
그렁 거뜨리 이캐 이르캐 얘기를 드따보니까 쪼꿈씩 생가기 나드라고요	예 그런 것들이 이렇게 이렇게 얘기를 듣다 보니까 조금씩 생각이 나더라고요
그건 사매요	그건 삼이에요
사민대 그거뚜	삼인데 그것도
그거 사먼 또 그거뚜 방애다가 우린 방애다가 그걸 쌀마 가주구 해 바써요	그  거 삼은 또 그것도 방에다가 우리는 방에다가 그걸 삶아 가지고 해 봤어요
방애다가	방에다가
에 방애다가 불 마니 때 가주구 방애다가 쌀마 가주 줌 저 마니 하덜 안하니까	에 방에다가 불 많이 때 가지고 방에다가 삶아 가지고 좀 저 많이 하지를 안하니까
마니 하넌 사람더런 막 도라무통애다가 이르캐 해 노코	많이 하는 사람들은막 드럼통에다가 이렇게 해 놓고
막 부럴 소태다 해노코 쯔더라 쯔더라고요	막 불을 솥에다 해 놓고 찌더라찌더라고요
그래 가주 삐끼넌대	그래 가지고 벗기는데
우리는 기냥 방애다가 해바써요 방애다	우리는 그냥 방에다가 해봤어요 방에다가
그걸 삼때가 크자나요	그걸 삼대가 크잖아요
엄청 크지	엄청 크지
삼때가 한 질반두 더 되	삼대가 한 길 반도 더돼
예예	예예
아이구 죄송함니다	아이고 죄송합니다
다릴 좀 뻐더야지	다리를 좀 뻗어야지
아이 갠차아요	아이 괜찮아요
펴나개 하세요	편하게 하세요
아이고 아이고 아이구 아퍼 아이구	아이고 아이고 아이구 아파 아이고
빽꼭 빼꼬카니 해 가주구 고깨 잘 커야	빼곡 빼곡하니 해 가지고 곧게 잘 커야
이 사미 조웅 조웅거시 나온다고	이 삼이 좋은 좋은 것이 나온다고
근대 이거넌 그런근데 이거는  저넌 이르키 기냥 관저리 이써 가주구	
저넌 이르키 기냥 관저리 이써 가주구	저는 이렇게 그냥 관절염이 있어 가지고
아파서	아파서
여그 가 안자써뜨니만	여기에 가 앉았었더니만
아휴	아휴
펴나개 안즈셔야 대요	편하게 앉으셔야 돼요
무룹 아프시지요	무릎 아프시지요
무루비 아파요	무릎이 아파요
퍽 아파 가주구 이 관저리	퍽 아파가지고 이 관절이
옌나래 쩌기 쪼그려 가지고 저 반 마니 매셔쬬	옛날에 저기 쪼그려 가지고 저밭 많이 매셨죠
하하하	하하하
애기두 어꾸두 매 반는대요 머	아기도 업고도 매어 봤는데요 뭐
그래니까	그러니까
그래서 무루비 그래요	그래서 무릎비 그래요
저이 어머니두	저이 어머니도
우리 두째 머스마 가를 어꾸서두 매 반는대 머	우리 둘째 머슴애 걔를 업고서도 매어 봤는데 뭐
인재 너무 부파 가주구	이제 너무 아파가지고
삼베 시물라먼 인재 그걸 머라 그래요	삼베 심으려면 이제 그걸 뭐라 그래요
그걸	그걸
삼 심능다 그러나요	삼 심는다 그러나요
사미라	삼이라
그르치 삼 심능다 하능 거지	그렇지 삼 심는다 하는 거지
사미지유 삼	삼이지요 삼
사미 삼때	삼대
사마 사미라고 하능 기여 사멀	삼이 삼이라고 하는 거야 삼을
사물	삼을
씨럴 뿌리 가주구	씨를 뿌려 가지고
예예	예
그르니깨 씸능다고 아나고 이개 씸능개 아니고 뿌리 가주구	그러니까 심는다고안 하고 이게 심는 게 아니고 뿌려 가지고
뿌리 가주 이래	뿌려 가지고 이렇게
인재 그개 크먼 그걸 삼때라구 하지요 인재 그기	이제 그게 크면 그걸 삼대라고 하지요 이제 그게
그개 대마자나요	그게 대마잖아요
대마지 대마	대마지 대마
대마	대마
대마	대마
이파링 거 대마초라고 하고	이파리는 거 대마초라고 하고
아휴 선생님 보기 죄송함니다 이래서	아휴 선생님 보기 죄송합니다 이래서
아이고 아니 갠차나요	아이고 아니 괜찮아요
근대 이짜기 좀 부숭 거 가찌요	근데 이쪽이 좀 부은 거 같지요
그러내요	그러네요
쪼꼼	조금
부서찌요	부었지요
부언내요	예 부었네요
에 파쓰럴 부치 가주구 글거서 이래요	에 파스를 붙여 가지고 긁어서 이래요
파 쩌넌 피부가 야개 가주구	파 저는 피부가 약해 가지고
파쓰럴 부치먼 막 갤구워 가주	파스를 붙이면 막 가려워 가지고
가렵쬬	가렵죠
여가 지금 부 이짝 따리가 더 아푸거던뇨	여기가 지금 부 이쪽 다리가 더아프거든요
여가 부서 부서찌요 선생님	여기가 부었 부었지요 선생님
이 부서 가주구	이 부어가지고
아파 가주구 인재 꾸부리고 이써떠니 이 이짜기 츠맨 아푸더니 이짜기 또 아푸더라고요	아파 가지고 구부리고 있었더니 이 쪽이 처음엔 아프더니 이쪽이 또아프더라고요
근대 이짜기 아푸 또 또 이르캐 아파요 이쪼기	그런데 이쪽이 아프 또 또이렇게 아파요 이쪽이
개도 이쪼기	그래도 이쪽이
사진 찌거 보션나요	사진 찍어 보셨나요
수술하라캐요	수술하라고 해요
뼈가 다라따 그러지요	뼈가 닳았다 그러지요
예예	예예
수수라라캐	수술하라고 해
수술하라카넝 거럴 아나고	수술하라고 하는 것을 안 하고
연골주사라넝 거럴 마자 반넌대 이 아푼지가 오래돼서 그링가 별로 효꽈가 엄능 거 가태요	연골주사라는 것을 맞아 봤는데 이 아픈 지가 오래 돼서 그런가 별로 효과가 없는 거 같아요
안 되지	안 되지
하냥대 병원내 간는대  정화캉 거	한양대 병원에 갔느데  정확한 거
하냥대 병워내는	한양대 병원에는
지배로 어디 와떵가부내	집으로 어딜 왔던가보네
그 아들 지부로 와찌 사진 찌꾸	그 아들 집으로 왔지 사진 찍고
이 양바나	이 양반아
이거 여 빼두	이거 여기 빼도
삼 삼물 가라서 크자나요	삼 삼을 갈아서 크잖아요
그르치	그렇지
그럼 인재 수화칼 때 어뜨캐 수하캐요 그거	그럼 이제 수확할 때 어떻게 수확해요 그것
근대 그 사멀 일딴 가라쓰먼	그런데 그 삼을 일단 갈았으면
가마 이써요 고고	가만 있어요 그거
이재 까찌끈 커따 이거여	이게 다 컸다 이거야
그라먼 삼닙쌔길	그러면 삼잎을
삼닙쌔기를 미리 다 처내뿌린다고	삼잎을 미리 다 쳐서 내버린다고
싹 처내뻐리여 삼닙쌔길	싹 쳐 내버려 삼잎을
그라고 인재 그걸 비어 가주구	그리고 이제 그걸 베어 가지고
다발루 무꺼 가주구	다발로 묶어 가지고
큰 삼 소시라구 이따고	큰 삼솥이라고 있다고
이 또랑 까애다 그걸 거러 노코	이 도랑가에다 그걸 걸어 놓고
쩐다고 쩌	찐다고 쪄
이 사멀 쩌야	이 삼을 쪄야
도라무통애	드럼통에
쩌야 인재 소시 크다고 거기	쪄야 솥이 크다고 이제 거기
이래 머이 큰 소슬 자관 어트개 드러 소설 맹그라 가주구	이렇게 뭐 큰 솥을좌우간 어떻게 들어 솥을 만들어 가지고
아주 마니 가따 쟁깅다고 그걸	에 아주 많이 갖다 잰다고 그것을
쟁기 가주구그 삼을 쩡 거럴	재어 가지고 에 그 삼을 찐 것을
인재 그래야 또랑 가애서 해 나야	이제 그래야 도랑가에서 해 놔야
옌날 꺼 아실라고 선생님 청주서 오싱 거여	옛날 거 아시려고 선생님이 청주에서 오신 거야
그걸 인재 또랑애 가따 인재 무래 당과	그걸 이제 도랑에 갖다 이제 물에담가
당과야 인재 씨끄 씨근 다매 뻬낀다고	담가야 이제 식은 식은 다음에 벗긴다
뻬껴	벗겨
뻬끼 가주구	벗겨 가지고
인저 대공은	이제 대
그럼 그거 찔 때는 어트개 쩌요	그럼 그거 찔 때는 어떻게 쪄요
쩌넝 건 나수로	찌는 건 낫으로
나수루 비 뿌리	낫으로 베어 버려
저기 그 찌	아 저기 그 찌
나스로 비 가주 다발루 무꺼 가주구	어 낫으로 베어 가지고 다발로 묶어가지고
다발로 무꾸	다발로 묶고
그리구서 저기	그리고서 저기
인재	이제 에
삼쏘설 맹그러논 대 거러농 대다가 가따가	삼솥을 만들어 놓은데 걸어 놓은 데다가 갖다가
그 삼쏘태다가	그 삼솥에다가
싸가주구 부를 때가주 쩐다구	쌓아 가지고 불을 때가지고 찐다고
가뜩카개	가득하게
쌀마 쌀마	삶아 삶아
이 이기 소치라먼 선생님	이 이게 솥이라면 선생님
이기 소치라먼 여길 꽉 찡궈요 아마	이게 솥이라면 여기를 꽉 끼워요 아마
이개	이게
꽉 찡궈 가주구	꽉 끼워 가지고
이 이 세로루 하나요 여푸루 누우	이 세로로 하나요 옆으로 누워서
여푸루 누워서 막 찐다고	옆으로 누워서 막 찐다고
여푸루 누어서 찐다고	어 옆으로 누워서 찐다고
여푸루 아내찌	옆으로 안 했지
아이 여푸루 누어서 쩌	아니옆으로 누워서 쪄
딴따낭 걸	
요로캐 어울리지	이렇게 어울리지
그기 지무로 막 찌능 거기 때미내	그게 김으로 막 찌는 것이기 때문에
그래서 쩌자구 머 그르캐 아니야	그래서 찌자고 뭐 그렇게 안 해
그 미태다가 불 때구	그 밑에다가 불 때고
인재 그 미태	어 이제 그 밑에
이개 아주 끋 쩌 한 한 질반 이르캐	이게 아주 끝 저 한 한 길 반 이렇게
예예	예
사람 키루 질반쭘 이르캐 크니까 잘 대먼	사람 키로 길반 쯤 이렇게 크니까 잘되면
그르캐 질개 크니까	그렇게 길게 크니까
이거 새와서 할라카먼 골란하고	에 이걸 세워서 하려면 곤란하고
또 마이 제대로 모단다고	또 많이 제대로 못 한다고
그릉깨 막 둔 이래 둔너서 기냥 막 잰다고 재야	그러니까 막 드러눕 이렇게드러누어서 그냥 막 잰다고 재
이짝 저짜그로 이래 마촤서 재 가주구 가뜩 이래 싸 가주구 덥꾸 양짜갤 덥꾸막 노피 싸 가주구지멀 올리 가주 지물 딴 대로 모쌔개 하고 우로만 올라가개 해 가주 전채럴 전채럴 다 쌈넌다구	이쪽 저쪽으로 이렇게 맞춰서 재 가지고 가득 이렇게 쌓아 가지고 덮고 양쪽을 덮고 막 높이 쌓아 가지고 에 김을올려 가지고 김을 딴 데로 못 새게 하고 위로만 올라 가게 해 가지고 전체를 다삶는다고
멀루다 더퍼요 그러면	뭘로 덮어요 그러면
그 인재 더깨를 지금	그 이제 덮개를 지금 에
옌나래넌 머 그 저 끄냥	옛날에는 뭐 그 저 그냥 에
거시기 에 무슨 저 베 베그텅 거 이렁 걸로 해 가주구	거시기 에 무슨 베 배같은 걸 이런 것으로 해 가지고
그거 하넌 사람더리 인재 별또로 맹그라가주구	그거 하는 사람들이 이제 별도로만들어 가지고
이래 덤능 걸 맹그란는대	이렇게 덮는 걸 만들었는데
지그먼 조웅 기 마이 이찌	지금은 좋은 게 많이 있지
조웅 기 지끄먼 인재 푸라스티그로 맹긍 거라든지 어짜든지 머	좋은 게 지금은플라스틱으로 만든 것이라든지 어쩌든지 뭐
일방 노가빠지넝 거만 아니먼 되넌대	일방 녹아빠지는 것만 아니면 되는데
그렁 걸루 해 가주	그런 걸로 해가지고
멍석 끄틍걸로 가따 이래 우앨 더꼬	멍석 같은 것으로 갖다 이렇게 위를덮고
단다니 이르캐 더퍼 가주구	단단히 이렇게 덮어 가지고
쩌 가주구	쪄 가지고
그 또랑 까애다 가따 시쿼 가주	그 도랑가에다 갖다 식혀 가지고
인재 뻬끼 가주구	이제 벗겨 가지고
이걸 말룬다고 말려	에 이걸 말린다고 말려
그라고 저 하야캐 그 저	그리고 하얗게 그 저
삼때는 인재 가따가	삼대는 이제 갖다가
에 이런대 인재 발 발도 여꺼 가주 써 머꼬	에 이런 데 이제 발 발도 엮어가지고 써 먹고
에 지벙 집 찌먼 지벙 이넌대 거 거기두 가따 깔고	에 지붕 집 지으면 지붕이는데 그 거기에도 가져다 깔고
머 이래 둘루넌 대두 치구 머 이런 대두 써 머꼬	뭐 이렇게 두르는 데도 치고뭐 이런 데도 써 먹고
그 인재 껍띠기럴 베껴 가주구 그게 사미니	그 이제 껍데기를 벗겨 가지고 그게삼이니
그기 베 난는 사미 되넝 거지	그게 베 짜는 삼이 되는 거지
그 껍 껍띠기	그 껍 껍데기
껍띠길 베껴 가주 또	껍데기를 벗겨 가지고 또
또 재새걸 해야 그글짜기야	에 또 재색을 해야 그것을 에 째
짜개 가주구	째 가지고
인재 시럴 맹그넝 거여	이제 실을 만드는 거야
또 이서 가주구	또 이어 가지고
이래 가주 씨럴 씨럴 맹그러 가주구	이렇게 해 가지고 실을 실을 만들어 가지고
삼대를 매 인재 맹그넝 거지	어 삼대를 만 이제 만드는 거지
아 그래잉 그거	아 그러니까 그거
껍띠기가 그리잉까 인재 널 널부니까 고걸	껍데기가 그러니까 이제 넓 넓으니까 그걸
짜개야	째
짜개야	째
일리리 짜개 가주 또 글 이서	일일이 째 가지고 또 그걸 이어
이서 가주구	이어 가지고
그걸 멀루 인너냐 하먼뇨	그걸 뭘로 잇느냐 하면요
그 삼멀 다 삐끼 넝기	그 삼을 다 벗기는 게
또랑애다가 노코 흔드러머뇨	도랑에다가 놓고 흔들면요
이게 흔드러 가주	이렇게 흔들어 가지고
고 하양 거만하양 거만 남넌다고 하양 거	그 하얀 것만 하얀 것만 남는다고 하얀 거
요로캐 하노콤썩 해 가주구서 요기럴 인재 씩 요기 씩꿔요	요렇게 한움쿰씩해 가지고서 여기를 씻 요기를 씻어요
요래 요래 씩꿔 가주구서넌 콱 짬매드라고요	요렇게 요렇게 씻어 가지고는꼭 동여매더라고요
막 하노콤썩	막 한움쿰씩
거때 마 아주 예줌바 이 또랑애 여기 무리 마이 내려가써요 그때만 해두	그때만 해도 아주  이 도랑에 물이 많이 내려갔어요 그때만 해도
인재 또랑애서 쩌구	이제 도랑에서 찌고
남저남저 흔들머뇨 그기 내리가요	남실남실 흔들면요 그게 내려가요
요 막 흔들만	요 막 흔들면
그 껍띠기가	그 껍데기가
걱 거태 인능 거	겉 겉에 있는 거
아주 껍띠기 새파랑 건 뻐꺼저고	아주 껍데기 새파란 것은 벗겨지고
하양 거만 나마야 베럴 맹그넝 거여	하얀 것만 남아야 베를 만드는 거야
근대 아주 하양 거만 안 남 쩌 그르캐 하양 거만 안 나마	아주 하얀 것만 안 남 저 그렇게 하얀 것만 안 남아
근대 낭기 점 더러 이 붇끼두 하구 이린대	그런데 나무가 좀 더러 이게 붙기도 하고 이런데
그거럴 인재 기냥 이기 짜갱 그시 이르캐 넙쭈카지 이개	그거를 이제 그냥 짼것이 이렇게 넓적하지 이게
그라먼 고고럴	그러면 그거를
넙쭈카기만 해궁 그개 짜갠다닝깨 그거 또	넓적하기만 하면 그걸 쪼갠다니까 그걸 또
다스 까닥뚜 나오넝 거 이꾸 여서 까닥뚜 나오넝 거뚜 이꾸	다섯 가닥도 나오는 거 있고 여섯 가닥으로 나오는 것도 있고
세 가닥뚜 나오능 기 이꼬 두 가닥 나오는 가능 건 그리여	세 가닥도 나오는게 있고 두 가닥 나오는 가는 것은 그래
그래서	그래서
삼베도 그걸 가늘기 짜개만	삼베도 그걸 가늘게 째면
저 이 머여	저 이 뭐야
고대 모콰	아까 목화
모콰 저 쌔쑤 나오넝 거마냥	목화 저 새수 나오는 것마냥
더 곤 삼베가 나오고	더 고운 삼베가 나오고
구깨 짜개먼 인저 뿔떡쌈뻬가 나오넝 거지	굵게 째면 뿔떡삼베가 나오는 거지
고고또 고래되요	그것도 그렇게 돼요
처매 가리야 대요 그거또명마냥	처음에 가려야 돼요 그것도 목화마냥
그래 가주 인재	그래 가지고 이제
삼베가요	삼베가요
가쟁이 벙 기 이짜나요	가지가 벋은 게 있잖아요
상태가	상태가
가쟁이 벙 거넌 인재 따로 과 가리 노코	가지가 벋은 것은 이제 따로 가 가려 놓고
꼬꼬타개 매끄낭 건 또 따루 하구 이래요	꼿꼿하게 매끈한 것은 또 따로 하고 이래요
명마냥	목화마냥
그라먼 인재 깨끄타고 키 킁 거넌 인재 첨 재 고깨 짜개 가주구 인재	그러면이제 깨끗하고 키 큰 것은 이제 참 저 곱게 째 가지고 이제
차 저 고온 삼베가 대고	차 저 고운 삼베가 되고
이 그 가쟁이 벌구 막 이렁 건 인재 좀	이 그 가지가 벋고 막 이런 것은 이제 좀
그 수기 이짜나요	그 숙이 있잖아요
고람 재 그렁 건 쪼곰 쪼곰 구깨 짜개 가주구	그러면 이제 그런 건 조금 조금 굵게 째 가지고
그거또 쫌 내고	그것도 좀 내고
그거뚜 모콰로 모콰로 베 맹그렁거랑 비스타다고	그것도 목화로 목화로 베 만드는거랑 비슷하다고
안 조웅 거로	안 좋은 거로
물래애 자꼬 이래야 된다고 그거또	물레에 잣고 이래야 된다고 그것도
꽈야 대니까	꼬아야 되니까
그거 그러먼 삼때가 곧깨 고깨 할라그러면 좀 심 저기 갈 때 줌 달개 가라야 되갠내요	그거 그러면 삼대가 곧게 곧게 하려고 하면 좀 심 저기 갈 때좀 달게 갈아야 되겠네요
아이 달개 가라야 되요	아이 달게 갈아야 되요
너머 너머 다라도 안 되고	너무 너무 달아도 안 되고
너무 드무러두 안 대능 기요	너무 드물어도 안 되는 거요
고고 참 씨 뿌리능 기	그거 참 씨 뿌리는 게
드물먼 가재이가	드물면 가지가
씨 뿌리멀 아주 기술쩌그로 해야 대능 거요	씨 뿌림을 아주 기술적으로 해야 되는 거요
그르개써요	그렇겠어요
씨 뿌리멀	씨 뿌림을
이 너무 드물먼 가쟁이가 버러서 안 댄다 마리여	이 너무 드물면 가지가 벋어서안 된다 말이야
가쟁이가 버러서	가지가 벋어서
그거 그래 가주구 이 토비라구 여여 이 저기 칼 뚜꺼운 칼마냥요	그거 그래가지고 이 톱이라고 요요 저기 칼 두꺼운 칼마냥요
뚜꺼웅 칼 이짜나요	두꺼운 칼 있잖아요
두꾸깨 맨들무넌	두껍게 만들면
두꺼깨 맨드러 가주구	두껍게 만들어 가지고
사라미 이르캐두 암 빌 정도루 해 가주구서	사람이 이렇게 해도 안 벨 정도로해 가지고서
고거 요러캐 무꾼대럴 인재 요거 무꾼대는 여기 암 뻐까지거던녀	고거 요렇게묶은 데를 이제 요고 묶은 데는 안 벗겨지거든요
뻐꺼지덜 아내요 그기	벗겨지들 안 해요 그게
그래서 고건 나두꾸 인재 해 가주구서넌 이기 빤때기다 노쿠	그래서 그건 놔두고 이제 해 가지고서는 이걸 빤때기에다 놓고
이기 요 지리기 요고마난 짐 지버 가주구 이르캐 만드능 기 이써요 요르캐	이게 요 길이가 요것만한 짐 집어 가지고 이렇게 만드는 게 있어요 요렇게
다 삐끼야 대요 이르캐	다 벗겨야 돼요 이렇게
이 이슬 때	이 이을 때
이슬 때	이을 때
그래야	그래야
이스매럴 이스매럴	매듭을 매듭을
그 당과서 이재 그뚜 추지야지	그 담가서 그것도 축여야지
말르먼 안 대거던녀	마르면 안 되거든요
그래 요래 토파리 이써요	그래 요렇게 톱칼이 있어요
톡콰리라캐요 그거럴	톱칼이라고 해요 그것을
톱칼	톱칼
토칼	예 톱칼
그리선 이르키 삐끼 가주구서루넌	그래서는 이렇게 벗겨 가지고서는
에헤 가쟁이 이 나무럴 하나 요로캐 가쟁이 요기 요로캐 짜개 가주구	에가지 이 나무를 하나 이렇게 가지를 여기를 이렇게 째 가지고
요기다 꼬바요	요기에다 꽂아요
꼬바 가주구 인재 이르캐 질만 여자드리 이르캐 다리 여그다가 이르캐 하낙씩빼 가주 이서요	꽂아 가지고 이렇게 길면 여자들이 이렇게 다리 여기에다가 이렇게 하나씩 빼어 가지고 이어요
허허 그 인너라고	허허 그 잇느라고
거 짜갱 거	그거 쪼갠 거
쪽 이서야 대니까	쪽족 이어야 되니까
이서 가주구 한 소코리썩 맨드러 가주구넌 에헤 비어 가주구 끄내키루 고고좀 모쓰넝 거 그거럴 요로캐 짬매지요 그냥	이어 가지고 한 소쿠리씩 만들어가지고는 에헤 베어 가지고 끈으로 그거 못 쓰는 거 그것을 요렇게 동여매지요그냥
그개 십짜루 짬매서 요로캐 쏘다 노코	그게 십자로 동여매서 요렇게 쏟아 놓고
그라먼 요로캐 모새루 인재 가따 요로캐 요로캐 해 노코	그러면 요렇게 모래로 이제 갖다 요렇게 요렇게 해 놓고
그거뚜 열 깨를 해 가주구서	그것도 열 개를 해 가지고서
그 저기다 저 이르캐 에 열깨 톰 이기 맨더넝 거 거거다가 꼬바 가주구	그 저기다가 저 이렇게 에 열 개 톱 이렇게 만드는 거 거기다가 꽂아 가지고
물래루 자사 가주구 꾸리를 맹글 참 저 가라걸 맹그라 가주 하자나 그또	물레로 자아 가지고 꾸리를 만들 참 저 가락을 만들어 가지고 하잖아 그것도
그거뚜 명마냥 자사 가주구 고또 해야 대구 또까치 그 명아고 또까타요	그것도 목화마냥 자아 가지고 그것도 해야 되고 똑같이 그 목화하고 똑같아요
그런 그런시그루 하넝 거	아 그런 그런 식으로 하는 거
인재 삼베다 명베다 이래  하능 거또 또까타요	삼베다 명베다 이렇게 하는 것도 똑같아요
나넝 거까지두 또까틍 거지 인재	나는 것까지도 똑같은 거지 이제
과정이	과정이
베트래다 올리 노코 짜넝 거또 머 다 또까터	베틀에다 올려 놓고 짜는 것도 뭐다 똑같아
그 인재 꾸리지 그근	그 이제 꾸리지 그건
꾸리럴 이 맹그넝 기 인재 부개다 느코 하넝 거 인재 그 그럼 명 무명하넝 거랑그 쌈베하넝 거랑 또까터고	꾸리를 만드는 게 북에다 넣고 하는 거 명 무명하는 거랑 그 삼베하는 거랑 똑같고
명두 그리치	명도 그렇지
그럼 가튼 베트래서 하능 거지요	그러면 같은 베틀에서 하는 거지요
에 가튼 베트래서 똑까튼 과정으로 하넝 거여	예 같은베틀에서 똑같은 과정으로 하는 거야
예저내 하루 베 짜면 어너 얼마나 짜써요	예전에 하루 베 짜면 어느 얼마나 짰어요
예저내 잘 짜넌 사라먼뇨	예전에 잘 짜는 사람은요
이르개 스무 자가 함 필 열따서 짜두 함 필 서른 자 함 필 이르캐 따지요	이렇게 스무자가 한 필 열다섯 자도 한 필 서른 자 한 필 이렇게 따져요
이 스무 자 함 필 서른 자 함 필 인재 열따서 짜 함 필	스무 자 한 필 서른자 한 필 이제 열다섯 자 한 필
젤 그르캐 만드라 가지구 인재 필루 나와요	제일 그렇게 만들어 가지고 이제필로 나와요
그라먼 잘 짜넌 사라먼 열따서 짜 그거 다 짜넌 사람두 이꾸	그러면 잘 짜는  사람은 열다섯 자 그거 다 짜는 사람도 있고
스무 자 다 짜넌 사람두 이꾸 인재 그래요	스무 자 다 짜는 사람도 있고 이제그래요
근대 인재 그 서른 자 하 함 필 짜넌 사라먼 바미나 나지나 짜먼 서른 자 짠다카드라고요	그런데 이제 그 서른 자 한 필 짜는 사람은 밤이나 낮이나 짜면 서른 자 짠다고 하더라고요
하루애 모 짠디야	하루에 못 짠대
어림두 업따능 기여	어림도 없다는 거야
아니 바미나 나지나 짜먼인재 그르캐 짠디야	아니 밤이나 낮이나 짜면 이제 그렇게 짠대
서른 자 함 필	서른 자 한 필
하루애 저 짠디야 그르캐	하루에 짠대 그렇게
옌나래 명 불써 노코 막 그르캐 짠다 카대	옛날에 그 명 불켜 놓고 막 그렇게 짠다고 하대
할부리 형니먼 그르캐 짜바따는대	할부리 형님은 그렇게 짜봤다는데
그르캐 모짜	아 그렇게 못 짜
잘 짜지 우리 형님	잘짜지 우리 형님
한 사밀씨근 걸리지	한 삼 일씩은 걸리지
사밀	삼 일
인저 그르캐 짜띠야	이제 그렇게 짰대
여기 모시두 시먼나요	여기 모시도 심었나요
모시	모시
모시는 아내바써요	모시는 안 해 봤어요
모시 아내요 여긴	모시는 안 해요 여기는
여긴 아내요	여긴 안 해요
한산모시라고 저짜그루 하능 거지	한산모시라고 저쪽으로 하는 거지
저 상주서 마니 하지	저 상주에서 많이하지
상주요	상주요
여 상주 함창이라는 대서 그건 마니해요 모시는	여기 상주 함창이라는 데서그건 많이 해요 모시는
지금두 한다카든대요	지금도 한다고 하던데요
그럼 그거 인재 질쌈할 때요	그럼 그거 이제 길쌈할 때요
어떵 거뜨리 이써요 그 기 기구가	어떤 것들이 있어요 그 기 기구가
도구가	도구가
도구는 머	두구는 뭐 에
아까 항거 저기 미영 씨 빼능 거는	아까 한 거 저기 미여 씨 빼는 거는
씨아시	씨아
씨아시고	씨아고
그 실 이러캐 감넝 거는	그 실 이렇게 감는 거는
물래	물레
물래고	물레고
얼 얼래래능 거뚜 이써요	얼 얼레라는 것도 있어요
가라기라구	가락이라고
가락	가락
가라기 인재 에 여 명 물래애다가 주럴 이르캐 매 가주구	예 가락이이제 여기 미영 물레에다가 줄을 이렇게 매 가지고
여기 저기 마라자먼 여 수판이짜나요	여기 저기 말하자면 여기 주판있잖아
수팡그텅 거럴 네 개짜리두 이꾸 다서 깨짜리가 이써요	주판같은 것을 네 개짜리도 있고 다섯 개짜리가 있어요
그라먼 인재 그거럴 인재 수판거텅 거넌 내빌라두구	그러면 이제 그것을 이제주판같은 것은 내버려두고
인재 여기두 여기 인재 그 가라기라구 이써요	이제 여기도 여기 이제 그 가락이라고 있어요
여기두 삐쭈카고 이짜개도 삐쭈개요	여기도 뾰족하고 이쪽에도 뾰족해요
이만 이마낭 거지요	이만 이만한 거지요
그르캔 안 질지요	그렇게는 안 길지요
쎄 세루 댕 걸 마라능 거	쇠 쇠로 된 걸 말하는 거
쎄루 댕 거고만	예 쇠로 된 거 고만한
요 요 요 정도는 대요	예 요 요요 정도는 돼요
한 요정도 대능 거 가뜬대	한 이 정도 되는 거 같던데
건 너머 커요	그건 너무 커요
아니 요 정도요 요 정도 대넌대	아니 요 정도요 요 정도 되는데
그래요	그래요
제가	제가
요 정도 대요	요 정도 돼요
요 정도 되넌대 가문태넌 인재 고기 다서 깨짜리 네 개짜리 이써요	요 정도되는데 가운데는 이제 고기 다섯 개짜리 네 개짜리가 있어요
줄 그넌대고	줄 긋는 데고
네네	네
다서 깨짜리	다섯 개짜리
똥그랑 거 요로캐	동그란 거 이렇게
예예 수판 고거텅 거	예예 주판 그 같은 것
고고 인넌대	그거 있는데
맨 우애넌 줌 인재 짤루꾸	맨 위는 좀 이제 짧고
여 가락 꼼넌 대 여기 이마낭 거시 요기넌 인재 그 멀루 하너냐 하먼	여기가락 꽂는 데 여기 이만한 것이 요기는 이제 그 뭘로 하느냐 하면
옌날 수숟 쩌기	옛날 수수 저기
수숙	조
조 이찌요 조	조 있지요 조
조 그거 조조때여	조 그거 조 대궁이여
저 조 그거	저 조 그거
그거 인재 굴긍 걸 가따가	그거 이제 굵은 것을 갖다가
근 대공 그거 그거 하능 기여	그것은 대궁 그거 그거 하는 거야
인재 자근자근자근자근 요래 요래 눌루문뇨	이제 자근자근자근자근 요렇게 요렇게 누르면요
고기 요래 줌 부서저요	그게 요렇게 좀 부서져요
부서저서	부서져서
이기 고기 부서저만	이게 그게 부서지면
인재 이르캐 그 가라기라능 걸 거기다 꼬바요	이제 이렇게 그 가락이라는 걸거기에 꽂아요
우애꺼넌 짤루꾸	위에 거는 짧고
미탠 질거더녀	밑에는 길거든요
거 징 걸 고고 인재 이 요만항 거루 과라개다가 꼬바나요	그 긴 것을 고고 이제 이 요만한 것으로 가락에다가 꽂아 놔요
고 가라개다 미태다가	고 가락에다 밑에다가
꼬바 노코서넌 인재 그래 거기다 물래 돌리고 인재	꽂아 놓고서는 이제 그렇게 거기에다 물레를 돌리고 이제
요 수투 수판 거튼 대넌 인재 주럴 물래애다 다라 매지요 물래애다	요 수판주판 같은 데는 이제 줄을 물레에다 달아 매지요 물레에다
그 인재	그 이제
다라 매만	달아 매면
인재 마라자먼 지그무루 마라먼 쌀 찐는 방애깐처럼	이제 말하자면 지금으로 말하자면 쌀 찧는 방앗간처럼
그기 이캐 피때가 도라가자나요	그게 이렇게 피대가 돌아가잖아요
인재 그거 도라가드시	이제 그거 돌아가듯이
이르캐 돌리먼 도라가거더뇨	이렇게 돌리면 돌아가거든요
그라먼 인재 요로캐 그 사미구 인재 명이구	그러면 이제 요렇게 그 삼이고이제 명주고
명얼 그거 고추라카거더녀	명주를 그거 고치라고 하거든요
그거나 그거나 또까타요	그거나 그거나 똑같아요
그개 돌리 가미 자사요	그게 돌려 가면서 자아요
그르캐 해 가주구	그렇게 해 가지고
그래 씨리되넝 거여	그렇게 실이 되는 거야
그리캐 해 가주 자사 농거럴 이거넌	그렇게 해 가지고 자아 놓은 것을 이것은
명언 그 인재 쌀마 저기 갈 저 명 베짜넝 거넌 인재 쌀마 가주구 그냥 하지만	명주는 그 이제 삶아 저기 명주 베 짜는 거는 삶아 가지고 하지만
이거또 쌀마 가주구	이것도 삶아 가지고
그거 삼베넌녀	그거 삼베는요
츠매 어트개 하너냐 하먼	처음에 어떻게 하느냐 하면
그르캐 삐끼 가주구 이르캐 그 이써요 그 이르캐 삐끼는 톡카리	그렇게 벗겨가지고 이렇게 그 있어요 그 이렇게 벗기는 톱칼이
요거 징 개요	이거 긴 게요
예예예	예예예
고걸루 삐끼 가주구서	그걸로 벗겨 가지고서
인재 요래 그런 대서 고 사마 가주구서	이제 요런 그런 데서 삼아 가지고
인재 요망콤씩 채나 머 어디 요런 똥고라난대 강우리나 이 암 부틀 때 곤대그개 암 부틀 때요	이제 요만큼씩 체나 뭐 어디 요런 동그란데 광주리나 이 안붙을 데 고운 데 그게 안 붙을 데요
고론대다 해서 다마서 해 가주구 인재	그런 데다 해서 담아서 해 가지고 이제
엉가니 항 거대먼 쏘다서 인재 이래 십짜로 무꺼 가주 여 나코서	언간히 한게 되면 쏟아서 이제 이렇게 십자로 묶어 가지고 여기 놓고서
또 다시 또 하지요 머 인재	또 다시 하지요 뭐 이제
그래서 그르캐 가주 하는대	그래서 그렇게 해 가지고 하는데
그거 이르캐 토펄 때 그 만드러 가주 그르캐 사마 가주구 이르캐 그기 맨드라노코	그것을 이렇게 톱플 때 그 만들어 가지고 그렇게 삼아 가지고 이렇게 거기만들어 놓고
이기 츠매넌뇨	이게 처음에는요
그리캐 해서 해 맨드러 노쿠	그렇게 해서 해 만들어 놓고
또 저기 이써요	또 저게 있어요
인재 그걸 물래애다 자승 거 이짜나요	이제 그걸 물레에다 잔 거 있잖아요
그거 인재 그 숟조 그 대공애다가 고거 가라기라고 요망콤 만드러 농거	그것 이제 그 숟 에 조 그 대궁에다가 고거 가락이라고 요만큼 만들어 놓은 거
그라먼 그거럴 어디다 하느냐 하먼 자새가 이써요	그러면 그것을 어디에다 하느냐 하면 얼레가 있어요
자새	얼레
자새라고요	얼레라고요
둥그러낭 개 이망쿰 커요	둥그런한 게 이만큼 커요
막 한 통그라낭 거시	막 한 동그란한 것이
저기 주럴 가따가 다러 매노코	저기 줄을 갖다가 달아 매어 놓고
하하하	하하하
이 그 사멀 인재 이르캐 그걸루 요래 한대	이 그 삼을 이렇게 그걸로 이렇게한 데
짬맨대를 토부루 이르캐 만드러 가주구	묶은 데를 톱으로 이렇게 만들어 가지고
요고 짜갠 대다가 그걸 이르캐 인재 거러 노쿠서넌	이거 쪼갠 데다가 그걸 이렇게 걸어 놓고서는
그걸 인재 이르캐 여기다 사마서	그걸 이렇게 여기다 삼아서
만들먼 씹짜루 무꺼서 내 노쿠	만들면 십자로 묶어서 내놓고
또 고 체로 하나 담 또 그라고	또 그 채로 하나 다 하면 또 그렇게 하고
그래 맨드라 다 해 가주구	그래 만들어 다 해 가지고
그거럴 인재 꾸리럴 가 이르캐 또 가마서 짜농 거뚜 따루 이꾸	그거를 꾸리를이렇게 또 감아서 짜 놓은 것이 또 따로 있고
그거 인재 또 사멀 인재 또 가락 가라그로 맨등 거럴 열 깨럴 해 놔요	그거또 삼을 또 가락으로 만든 거를 열 개를 해 놔요
이거 쏘이 만드라짜나요	이거  만들었잖아요
만드라서 십짜로 해 농거럴 열 깨럴 해 노코서	만들어서 십자로 해 놓은 것을열 개를 해 놓고서
킁거 이래 막 마라자먼 이기 물래나 또까틍 거여	큰 거 이렇게 막 말하자면이게 물레나 똑같은 거야
물래넌 그 이르캐 이르캐 해 가주 인재 그거 삼 가락뚜 인재 거그다 이르캐 해노치만	물레는 그 이렇게 이렇게 해 가지고 이제 그거 삼 가락도 거기에다 이렇게 해 놓지만
이기 인재 그거또 이래 새가 이써요	이게 이제 그것도 이렇게 새가 있어요
참새 개새	참새 개새
에 이 그 베마냥	에 이 그 베마냥
그르캐 만드라서 인재 그걸 이르캐 둥구러캐 할 때애	그렇게 만들어서 이제그걸 이렇게 둥그렇게 할 때에
그거뚜 인재 꼬불 이르캐 둥구러캐 할 때	그것도 이제 곶을 둥그렇게 할 때
이쪼그루 하나 하구 또 하고 이쪼그루 또 하나 하구 이래요 그걸	이쪽으로 하나 하고 또 하고 이쪽으로 또 하나 하고 이래요 그것을
그라먼 이거 가라기 그거 열 깨가 다 풀리두룩 거기다가 다 가마요	그러면 이것 가락이 그거 열 개가 다 풀리도록 거기에다가 다 감아요
인재 그거또 인재 마라자먼 베마냥 열따서 째	이제 그것도 이제 말하자면 베마냥 열다섯 자
스무 자 서른 자 머 이르캐 하두룩 그걸 인재 만드러 가주구 해요 그거럴 그기다 이르캐	스무 자 서른 자 뭐 이렇게 하도록 그걸 만들어 가지고 해요 그것을 거기에다 이렇게
그 킁 거 이마낭 거 자새라능 거시 이써요	그 큰 거 이만한 거 자새라는 것이 있어요
거 자새애다가 그르캐 해놔요 이르캐	그 자새에다가 그렇게 해놔요 이렇게
그만 이망쿰 무꺼저먼 인재 그걸 끌러요	그만 이만큼 묶어지면 이제 그걸 풀어요
끌럴 때 요 개새 참새가 이꺼더녀	풀 때 요 개새 참새가 있거든요
두 가 이르캐 두 가지루 이르캐 여기가 십짜루 이래이래 한대가	두 가 이렇게 두 가지로 이렇게 여기가 십자로 이렇게 이렇게 한 데가
그람 고거럴 무꺼야 대요	그러면 고것을 묶어야 돼요
그거 다 쏘다지먼 모타자나요	그거 다 쏟아지면 못하잖아요
요거뚜 무꺼 노코 요거뚜 무꺼 노코 무꺼야 대요 고로캐	요것도 묶어 놓고 요것도 묶어 놓고 묶어야 돼요 고렇게
개새 참새라능 개	개새 참새라는 게
나중애 이개 그 가마쓸 때 이거 암 풀러지개 할라구 해농 거내요	나중에 이게그 가감았을 때 이게 안 풀어지게 하려고 해 놓은 거네요
그래 가주구 그거럴 인재 그래 인재 고로캐 만드라요	그래 가지고 그거를 이제 그래 이제 고렇게 만들어요
그래 만드라서 인재 그르캐 맨드러 농 거 이르캐 해 노만 그걸 가따가 쩝 인재저개 이르캐 해가주구 저 그거럴 인재 이르캐 또 그걸로 인재 베럴 나라요	그렇게 만들어서 이제 그렇게 만들어 놓은 것을 이렇게 해 놓으면 그걸 갖다가 쩝이제 저기 이렇게 해 가지고 저 그것을 이제 이렇게 또 그것으로 베를 날아요
베우처럼 나라요	베처럼 날아요
인재 이개 다시 그거럴 이르캐 가마 가주구	이제 이게 다시 그것을 이렇게 감아 가지고
인재 이르캐	이렇게
그거럴 인재 이르캐 가마 가주구서넌 해 노코	그것을 이제 이렇게 감아 가지고서는 해 놓고
저기다 해 노코 그거뚜 베마냥 똑까치 만드라요 이래	저기다 해 놓고 그것도베마냥 똑같이 만들어요 이렇게
이르캐 해 노코 고걸 이러캐 이키 그걸 나라 가주 이르캐 나라 가주구서 그 해가주구	이렇게 해 놓고 고걸 이렇게 이렇게 날아 가지고 이렇게 날아 가지고서그 해 가지고
가 그걸 가마 가주구서루	감 그걸 감아 가지고서
이르캐 해 농걸 이래 거 이 저 그 자새라넌 대다 해 농 거럴 해 가주구	이렇게 해 놓은 것을 이렇게 그 그 자새라는 데다 해 놓은 거를 해 가지고
그래서 그걸 이르캐 저기짜개다 해서 이르캐 꼬바 가주구 다 이르캐 가마 가주구서루 새루 이르캐 날지요	그래서 그걸 이렇게 저기 쪽에다 해서 이렇게 꽂아 가지고 다 이렇게 감아 가지고서 새로 이렇게 날지요
고골 또 고대루 요기 베마냥 이르캐	고걸 또 그대로 여기 베마냥 이렇게
그래 해 주구서니 그 똑까치 베마냥 짜요	그래 해 가지고서는 그 똑같이 베마냥 짜요
그거뚜 인재 이캐 매 가주구	그것도 이제 이렇게 매어 가지고
풀 발라 가주구	풀 발라 가지고
그르캐 만드라 가주 하드라구유	그렇게 만들어 가지고 하더라고요
이거 아까	이거 아까
근대 나넌 그 삼베는 해바써요	그런데 나는 그 삼베는 해 봤어요
무명베하구	무명베하고
그거넌 우리 어먼니미 해 가주구	그것은 우리 어머님이 해 가지고
그거넌 인재 와 가주구 한 이삼 년 핸능가 몰라요	그것은 이제 와 가지고 한이삼 년 했는가 몰라요
그르캐 하구서넌 고만 안 하드라고요	그렇게 하고서는 그만 안 하더라고요
그이 츠비여 다 나더라고요	그  다 나더라고요
너나 나나 할 꺼 웁씨	너나 나나 할 것 없이
저녀 암 마꼬	전혀 안 맞고
아나드라고요	예 안 하더라고요
대번 막	대번 막
그래두 그 총기 조으시내요	그래도 그 총기 좋으시네요
절머쓸 때 해보싱 걸 지금 이르캐 자세하개 말씀하시내요	젊었을 때 해보신걸 지금 이렇게 자세하게 말씀하시네요
저넌 열려덜 싸래 여기 와써두 베럴 짠는대요	저는 열여덟 살에 여기 왔어도 베를 짰는데요
그쎄요	글쎄요
그쎄요 지금	글쎄요 지금
그 그르구 보면 그거 오심 년 저내 하싱 건대	그 그러고 보면 그거 오십 년전에 하신 건데
그걸 지금 다 기어카고 게신대	그걸 지금 다 기억하고 계신데
열려덜 쌀 머거서두 여기 와 가주구서 짠는대요	열여덟 살 먹어서도 여기 와가지고 짰는데요
지가 이캐	제가 이렇게
우리 어먼니머 차라래	우리 어머님은 차라리
그거이 베 또 디애서 이크 이캐 패 가주구	그거 베 또 뒤에서 이렇게 이렇게펴 가지고
도토마리 이르캐 감넝 거 그거뚜 제가 해떠요	도투마리 이렇게 감는 거 그것도 제가 했어요
해 가주구 인재 그거뚜 이캐 잉애라구 이르캐 다라노먼	해 가지고 이제 그것도 이렇게 잉앗대라고 이렇게 달아 놓으면
그걸 가따 이래 해 노먼	그걸 갖다 이렇게 해 놓으면
잉애때가 이써요	잉앗대가 있어요
이래 잉애때	이렇게 잉앗대
다러 이르캐 다러 매넝 거	이렇게 달아 매는 거
그라먼 인재 고 개새 참새럴 두 군대다 꼬바요 요래	그러면 그 개새 참새를두 군데다 꽂아요 요렇게
이 꼬바 노쿠서 인재 그거럴 꼬쟁이가 그 잉애때라구 이써요	이 꽂아 놓고서이제 그것을 꼬챙이가 그 잉앗대라고 있어요
잉애 이캐 잉애 이르캐 거넌 잉애요	잉앗대 이렇게 잉앗대 이렇게 거는 잉앗대요
고기	거기
어트개 생긴느냐 하먼	어떻게 생겼느냐 하면
꼬쟁이가 이르캐 간따난 전지마냥 요고만항 기 요만창 징 기 이써요	꼬챙이가 이렇게 간단한 전지마냥 요고만한 게 요만큼 긴 게 있어요
요만창 징 깅대	요만큼 긴 건데
가쟁이가 버러 가주구	가지가 벋어 가지고
또 요로캐 요만창언 요고요고 내 집빼머 요고요고 하난 댈꺼여	또 요렇게 요만큼은 요거 요고 내 뼘으로 요거 요거 하나는 될 거야
요만창 널룽 기 이써요	요만큼 넓은 게 있어요
그라먼 인재 고 꾸리하나 이르캐	그러면 이제 그 꾸리 하나 이렇게
인재 여 이 저 시리 이써요	이제 여 이 저 실이 있어요
굴군 실 인재	굵은 실 이제
그 명우루 자사 가주구 시를 만들자나요	그 명으로 자아 가지고 실을 만들잖아요
그라구 옌나랜 옫 꾸매넌	그리고 옛날엔 옷 꿰매는
오슬 꾸매거드녀	옷을 꿰매거든요
그걸루 해서	그것으로 해서
그거 인재 그 실로 가따가	그거 이제 그 실을 갖다가
인재 요로캐	이제 요렇게
이개 하나넌 또 미태로 제키고	이게 하나는 또 밑으로 젖히고
또 하나 여기 잉애 이르캐 걸구	또 하나 여기 잉앗대 이렇게 걸고
또 이루 가서 또 하나 하나 욜루 제끼 노쿠	또 이리 가서 또 하나 하나 이리로 젖혀 놓고
또 하나 이래 거러 가주	또 하나 이렇게 걸어 가지고
요로캐 해서 또 이르 넨 내리가먼	이렇게 해서 또 이리 내 내려가면
하나 요로캐 재껴 노코	하나 이렇게 젖혀 놓고
또 요골로 거러 요로캐고	또 이걸로 걸어 이렇게고
똑 하낙썩 재끼 나야 대요	꼭 하나씩 젖혀 놓아야 돼요
이거럴 마냐개 요 두 개를 우로 가던지	이것을 만약에 요 두 개가 위로 가든지
저 두 개가 미테루 가던지 이라먼 이기 모지래자나요	저 두 개가 밑으로 가든지 이러면 이게 모자라잖아요
고 바디지비라카는디 끼는 대가요	그 바디집이라고 하는데 끼우는 데가요
나중애 이르캐 할라 그래능 거지요 이르캐	나중에 이렇게 하려고 그러는 거지요 이렇게
이릭	예 이렇게
이리캐 만드러 가주구	예 이렇게 만들어 가지고
하낙씩	예 하나씩
이르캐 가주구서 고기 잉애때라는 대가 그뚜 잘 꼬바야지	이렇게 가지고서 고기 잉앗대라는 데가 그것도 잘 꽂아야지
그거뚜 하나래두 빠지머뇨 곡	그것도 하나라도 빠지면요
이 하나래두 그 잉애때가 하나래두 빠지먼	이 하나라도 그 잉앗대가 하나라도 빠지면
거기가 다시 인재 요 잉애때를 만드라 가주구	거기가 다시 요 잉앗대를 만들어 가지고
거기다 꼬바야 돼요	거기에다 꽂아야 돼요
그래서 고고 정신불명하고 하나	그래서 그거 정신차리고 하나
드르가먼	들어 가면
하나 띠우구 또 요래 하고	하나 띄우고 또 요렇게 하고
하나두 고고뚜 해야 돼요	하나라도 그것도 해야 돼요
고골로 고로캐 재끼 가매	고걸로 고렇게 젖혀 가며
하나 재끼구 또 하나 걸구 하나 재끼구 또 하나 걸구 이래 가주군	하나 젖히고 또 하나 걸로 하나 젖히고 또 하나 걸고 이렇게 해 가지고는
그 잉애때라카넝 거를 인재 요 베트래다 이르캐 꼽찌요	그 잉앗대라고 하는것을 이제 요 베틀에다 이렇게 꽂지요
조쪼그루 인재 그 발로	저쪽으로 그 발로
발로 자부땡기구 함 번 이짜그루 느쿠 또 짜구	발로 잡아 당기고 한 번 이쪽으로 넣고 또 짜고
이짜그루 노코 탐 발 탕 노쿠 또 짜고 이라거드녀	이쪽으로 놓고 발 탁 놓고또 짜고 이러거든요
그기	그게
조사 조사저야 대니까	쪼아 쪼아져야 되니까
그라기 때미 잉애애다가 인재 이기 저 디애는 또 개새가 올라가고	예그러기 때문에 잉앗대다가 이제 이게 저 뒤에는 또 개새가 올라가고
아패 짜너능 거 인재 또 하나 이써요	앞에 짜 놓는 거 또 하나 있어요
그래 거 거기 디루 이래 이래 올리구서	그래 거 거기 뒤로 이렇게 이렇게 올리고서
아패 인재 그 바디지비라구 이짜나요	앞에 그 바디집이라고 있잖아요
개서 인재 탕 노만	그래서 이제 탁 놓으면
인재 이기 하난 미트루 가 노쿠 우애 이꺼드녀	이제 이 하나는 밑으로 가 놓고 위에 있거든요
그람 고기다가 부걸 느만	그러면 거기에다가 북을 넣으면
바디지부루 딱 짜고	바디집으로 탁 짜고
이쪼그루 갈 때넌 바럴 오그리먼	이쪽으로 갈 때는 발을 오그리면
또 이기 새가 이르캐 대고	또 이게 새가 이렇게 되고
글루 노쿠 그래 가주구	그리로 놓고 그래 가지고
그래 가주 짜서요	그래 가지고 짰어요
그거럴 그저내 지가 그래 해바꺼드녀	그거를 그전에 제가 그래 해 봤거든요
지금두 이르캐 생가캐 보먼 그 베트래 대해서 베럴 짜라먼 짤 꺼 가태요	지금도 이렇게 생각해 보면 그 베틀에 대해서 베를 짜라면 짤 것 같아요
제 마매 짜 바서루	제 마음에 짜 봐서
그럼뇨 짤 쑤 이찌요	그럼요 짤 수 있지요
근대 매능 거뚜 머그거뚜 이르캐 제가 해봐꺼드녀	그런데 매는 것도 뭐에 그것도 이렇게 제가 해봤거든요
그래 가주구	그래 가지고
그래서 인재 그걸 이래 풀 발라 가주 해 가주	그래서 이제 그것을 이렇게 풀발라 가지고 해 가지고
이그만 미테 이래 이래 해 가주 말루카 가주구	이것만 밑에 이렇게 이렇게 해가지고 말려 가지고
씨다드머 가주 강꼬 강꼬 그라자나요	쓰다듬어 가지고 감고 감고 그러잖아요
아까 그 개새하고 참새라 그래짜나요	아까 그 개새하고 참새라고 그랬잖아요
그개 그 베트래 인능 거지요	그게 그 베틀에 있는 거지요
배트래	베틀에
꼽 꼽 쩌기 작때기	꽂 꽂 저기 막대기
하난 디루 가구	하나는 뒤로 가고
잉애때 인는 대 하나 이찌요	잉앗대 있는 데 하나 있지요
잉애 여기 바디지비 올라가 가주 요긴 참새	예 잉앗대 여기 바디집이 올라가 가지고 여기는 참새
디애 가능 거 이르캐 이개 미러 가주구 갈 때는 사침때라구 이써요	뒤에 가는거 이렇게 이렇게 밀어 가지고 갈 때는 사침대라고 있어요
사침때라구 인넝 거시 에 요로캐	사침대라고 있는 것이 에 이렇게
그 상가켱으로 맹근 거시	그 삼각형으로 만든 것이
쩌삼가켱이루 이써요	저삼각형으로 있어요
삼가켱이루 인넝 거	삼각형으로 있는 거
상가럴 이래 떠바치고 인넝 거지	를 이렇게 떠 받치고 있는 거지
떠바치고 인넝 거럴 새럴 노깨 맹그러	떠 받치고 있는 것을 새를 높게 만들어
그래 가주 이르캐 떠바치 가주구서넌 이기 인재 항 군대루 그건 내처 올라가지요	그래 가지고 이렇게 떠받치고서는 이게 이제 한 군데로 그건 내처 올라가지요
거 인재 뒤왜 인재 잉애 잉애때 뒤왜 인능 거시 인재 그	그 이제 뒤에 이제잉앗대 뒤에 있는 것이 그
두 두 개 두 가다그로 갈라 가주구 쭉 올라가는대 이누미 요 까지 가따먼 를스니까	두 두 개 두 가닥으로 갈라 가지고 죽 올라 가는데 이 놈이 요기까지갔다면 를 니까
고고시 그닝깨 인재	어 고것이 그러니가 이제
부기 와따가	북이 왔다가
베가 대능 기여	베가 되는 거야
부기 와따 가따 하면서	북이 왔다 갔다 하면서
에 그기	예 그게
그거시 인재 그 그 잉애때가 인재 올라가밍성	예 그것이 이제 그 잉앗대가 올라가면서
아패 또 인재 고 잉애때 저태 개새가 이써요	앞에 또 이제 고 잉앗대 곁에 개새가 있어요
개새가 이쓰먼 잉애때는 기냥 올라가민 인재 이캐 두	개새가 있으면 잉앗대는그냥 올라가면서 이렇게
마라자먼 인재 기럴 발키 주고	에 말하자면 길을 밝혀 주고
인재 개새가 인재 하나 인넝찌 쭉 글루 올리먼	개새가 하나 있는 것이 죽 그리로 올리면
아패 인재 짜능 거 이구 짝 올리서	앞에 짜는 거 있고 짝 올려서
거 도투마리 우리 짝 올리 노코서넌	그 도투마리 위로 짝 올려 놓고서는
인재 요기 아패 참새가 이꺼더녀 짜넌대	이제 요기 앞에 참새가 있거든요 짜는 데
고기	고게
잉애가 인재 고골루	잉앗대가 고것으로
잉애가 바를 자부땡기만	잉앗대가 발을 잡아 당기면
인재 저기 올라가고	저기 올라가고
탕 노먼 인재 그기 내리가고 그라거더녀	탁 놓으면 이제 그게 내려 가고 그러거든요
하나넌 내려가고	하나는 내려 가고
그라먼 인재 고기 자부땡길 때 요짜그루 붕 느쿠	그러면 이제 고기 잡아당길때 요쪽으로 북 넣고
탕 노코 하먼 이짜그로 노코	탁 놓고 하면 이쪽으로 넣고
개서 아패 꺼는 자꾸	예 그래서 앞의 거는 자꾸
그기 인재 부개서 시리 드러가 가주구	그게 이제 북에서 실이 들어가 가지고
그기 인재 씨리	그게 이제 실이
거기 이캐 꾸리 감넝 거 넌넝 거시 머냐하먼 부기라구 그래요	거기 이렇게 꾸리 감는 것 넣는 것이 뭐냐하면 북이라고 그래요
고 부기 인재 드러가따 나가따	그 북이 들어갔다 나갔다
요로캐 생겨서 요개 홈파징 거	이렇게 생겨서 이게 홈 파진 거
고기 꾸릴 고기다 느쿠	예 거기다 넣고
인재 꾸리럴 먿 또라댕기개 하넌 대나물 야깨 까까 주구	꾸리를 못 돌아다니게 하는 대나무를 얇게 깎아 주고
거 부개다가 요로캐 살짝 꼼능 기 이써요	그 북에다가 이렇게 살짝 꽂는 게있어요
그기 고와야 저기 그 시리 앙 끄너저요 고개	그게 고와야 저기 그 실이 안끊어져요 고게
고고시 야깐 북뽀다 야깐 노파야 돼요 고기	그것이 약간 북보다 약간 높아야돼요 고게
고래 가주구 고기 반들반들 해야지	그래 가지고 그게 반들반들 해야지
그기 쪼끔 거칠먼 시럴 끄너 머거요	그게 조금 거칠면 실을 끊어 먹어요
개서 마치마깨 고 꼬바 가주구서 그래	그래서 마침맞게 고 꽂아 가지고서그래
그걸루 짜지요	그걸로 짜지요
그럼 아까 그 참새하고 개새가 하는 여카리 머애요	그럼 아까 그 참새하고 개새가 하는 역할이 뭐예요
그기 인재 올라갈 때 짜구	그게 이제 올라갈 때 짜고
이쪼그루 늘 때 짜구 그라거드녀	이쪽으로 넣을 때 짜고 그러거든요
개새라카넝 거는 인재 거 잉애때 디왜 인넝 거	개새라고 하는 것은 그 잉앗대뒤에 있는 거
인재 길 발키 주넝 거거더녀	이제 길 밝혀 주는 거거든요
개새가	개새가
두 갈 두 가다그로 버러점 버러만 논능 기지	두 가 두 가닥으로 벌지면 벌려만 놓는 거지
그러면 이개 저기 시 실 저기 아까 거기 부기 와따 가따할 때 시리 이르캐 나라 나라 노차나요	아 그러면 이게 저기 실 실 저기 아까 거기 북이 왔다 갔다 할 때 실이 이렇게 날아 날아 놓잖아요
아패 가능 거	앞에 가는 거
근대 하나는 욜루 가고 하나는 욜루 가 요로캐 요로캐할 때 그개 쓰나요	그런데 하는 요리로 가고 하나는 요리로 가 요렇게 요렇게할 때 그게 쓰나요
잉애따라카 잉애	잉앗대라고 하 잉아
잉애때가 고 저태 바루 인재 고래 이써요	잉앗대가 고 곁에 바로 이제 그렇게있어요
잉애때가 인재 올라가따 니리가따하든지 발루 자부댕기먼	잉앗대가 올라갔다 내려갔다 하든지 발로 잡아 당기면
함 분 올라가구 함 분 내리가주구 그기 되능 기여	한 번 올라가고 한 번 내려가지고 그기 되는 거야
그래 잉애때두 이꾸	그래 잉앗대도 있고
활때라능 거뚜 이써요	활대라는 것도 있어요
그 발루 자바 댕기능 거	그 발로 잡아 당기는 거
이르캐 둥그러캐	이렇게 둥그렇게
그 밀때라넝 거넌 인재 아패 껄 다 짜먼 도토마릴 미러요	예 그 밀대라는것은 앞의 걸 다 짜면 도투마리를 밀어요
작때기로	막대기로
그래 미르먼 인재 미러 노쿠서	그래 밀면 이제 밀어 놓고서
이거 아패 다 짱 걸 또 이 또 여기 거기 이써요	이거 앞에 다 짠 것을 또이 또 여기 거기 있어요
저 저기 이 머지 그기	저 저기 이 뭐지 그게 에
달때는 달때는 시 시 시래다 이래 다라맬 발 바래다 다라맬리가주 끈두	달대는 달대는실 실 에다 이렇게 달아 맬 발 발에다 달아 매 가지고 끊도
이기 바디 바디	이게 바디 바디
그거 짜능 건 바디지비구	그거 짜는 건 바디집이고
이거 마능 거시 머지	이거 마는 것이 뭐지
마능 거	마는 거
말코	말코
말루코	말코
말코	말코
말코	예 말코
허허 더 잘 아시내	허허 더 잘 아시네
이기 말코라카드라고요	이게 말코라고 하더라고요
그래서 고 말코 거기 다 짜먼 요기다가 강꼬	그래서 고 말코 그거 다 짜면요기다가 감고
또 인재 그거 인재 또 바 저기 잘 가라고	또 이제 그거 이제 또 저기 잘 가라고
기르멀 살짝 빨라요 바디지배	기름을 살짝 발라요 바디집에
고거럴 저기 바디애다가 고 바디짐 말고	고것을 저기 바디에다가 그 바디집말고
바디는 바디는 실 낑 거고	바디는 실 꿴 것이고
바디지번 인재 거기 거 바디지벌 쌍 기 바디집	바디집은 이제 거기 그 바디를싼 게 바디집
짜넝 거지 짜넝 거	짜는 거지 짜는 거
그거 할 때 쩌 등애다가 이르캐 끈 매 가주구 이르캐 자버다니자나요	그거 할때 저 등에다가 이렇게 끈 매어 가지고 이렇게 잡아 당기잖아요
이개	이게
붇태	부티
부태	부티
이건 부태여	예 이건 부티야
그리구 미태 발루다가 이르캐 해 가주구	그리고 밑에 발로 이렇게 해 가지고
아까 말쓰마싱 거처럼 이르캐 발루 자바다녀따 미러따 그런	아까 말씀하신 것처럼 이렇게 발로 잡아 당겼다 밀었다 그런
그거넌 인재 저기 그 신널 거기다 대따고 신때라 구라대요	그거는 저기 그 신을 거기다 대었다고 신추리라고 그러대요
또 거넌	또 그거는
신때	신추리
시늘 고기다 대 가주구서	신을 고기에다 대어 가지고
그래구 인재 그 신때를 자부댕기구 노쿠	그러고 이제 그 신추리를 잡아 당기고 놓고
그 나무럴 저 활거치 꾸부렁거 이써야 댄다	그 나무를 저 활같이 구부러진 게있어야 된다
그거또 여러 가지요 그기가 보만뇨	그것도 여러 가지요 거기가 보면요
그기 이기 인재 그기 처매 머냐고 하먼	이게 그게 이제 그게 처음에 뭐냐고하면
이기 이캐 저기 시 삼가켱으로 만등 거시 그거시	이게 이렇게 저기 시 삼각형으로 만든 것이 그것이
저거여	저거야
아이고 이 이베 아까 강 뱅뱅 도라요	아이고 이 입에 아까 뱅뱅 돌아요
몰란내요	모랐네요
사침때요	사침대요
사침때	사침대
거 사침때가 베럴 이르캐 두지버노먼	예 그 사침대가 베를 이렇게 뒤집어놓으면
두지버서 이르캐 세워노먼	뒤집어서 이렇게 세워 놓으면
사침때가 가서 이르캐 이캐 가서 바치요	사침대가 가서 이렇게 이렇게 가서받쳐요
두 가다그로 갈라 주능 기여	두 가닥으로 갈라 주는 거야
이기 두 가다그로	이게 두 가닥으로
그기	예 그게
두 가다그로	두 가닥으로
두 가다그루 갈라주능 건 개새가 갈라 주고	두 가닥으로 갈라주는 건 개새가 갈라 주고
개서 인재 그 사침때를 개새가 인재 이르캐 가주구 이르키 이쓰먼	그래서 그사침대를 개새가 이제 이렇게 가지고 이렇게 있으면
고 개새루 해 가주구 사침때를 바짝 올리요	그 개새로 해 가지고 사침대를바짝 올려요
도토마리 저태로	도투마리 곁으로
그래 올리먼 인재 고기 개새가 따라가지요	그렇게 올리면 고기 개새가 따라가지요
고 아패다	그 앞에다
그래 노코 인재 짜는 대는 참새가 짜고	그래 놓고 이제 짜는 데는 참새가 짜고
그기 그래 마리 그르태요	그게 그렇게 말이 그렇데요
그기 해해해	그게 헤헤헤
짜넌 대서 인재 인넝 거 개새 참새가 그래 그르태요	짜는 데서 이제 있는 거개새 참새가 그렇게 그렇데요
거기	거기
모시는 기리를 달 기리를 잴 때는 멀루 자루 하지요	모시는 길이를 달 길이를 잴 때는 뭘로 자로 하지요
자로 재지	자로 재지
자로 하고	자로 하고
다 짜먼 자로 재지요	다 짜면 자로 재지요
근대 츠매부텀 이기 베 날 때요	그런데 처음부터 이게 베 날 때요
베 날째는 더 질다고	베 날 때는 더 길다고
지그먼삼십쎈치 자가 아니지	지금은 에 삼십센티미터 자가 아니지
베 날 때넌	베 날 때는
베 베가 날 때두 이 저기 거시기	베 베가 날 때도 이 저기 거시기
만들 때 그기 인재 그 그르캐 도토마리 가물 때	만들 때 그게 이제 그 그렇게 도투마리 감을 때에
그기 항 가래 두 가래럴 만들지 그거뚜	그게 한 가래 두 가래를 만들지 그것도
항 가래 두 가래 보먼 이 베 날 때 정해저넝 거여	한 가래 두 가래 보면 이 배날 때 정해지는 거야
베 날 때	베 날 때
그르키 날 때 거기서 정해 가주 가주구서루	그렇게 날 때 거기서 정해 가지고가지고서
그거 츠매 날 때 그기 정해저 가주 하능 거여	그게 처음에 날 때 정해져 가지고 하는 거야
땅애서 딱 재 가주구 날 때 고기 이  정해지능 거여	땅에서 딱 재어 가지고날 때 고게 이  정해지는 거야
아까 그 한 필	아까 그 한 필
거 함 필	그 한 필
한 필 그러면 기리가 정해저 인나요 아니먼 그개	한 필 그러면 길이가 정해져있나요 아니면 그게
정 정해 인능 기여	정해져 있는데
얼마를 함 피리라 그래요	얼마를 한 필이라고 그래요
그릉깨 날 때 정해저 인능 기여	그러니까 날 때 정해져 있는 거야
그기 수무 자	그게 스무 자
열따서 짜 서룬 자	열다섯 자 서른 자
스무 자먼 스무 자럴 땅애서 딱 재 가주구	스무 자면 스무 자를 땅에서 딱 재어가지고
서룬 자까지 이써요	서른 자까지 있어요
그기 그기	그게 그게
서룬 자까지	서른 자까지
그기 스무 자를 기준해 가주 나능 거여	그게 스무 자를 기준으로 해 가지고 나는 거야
그래 에 네 필짜리가 이꼬	그렇게 에 네 필짜리가 있고
두 필짜리	두 필짜리
세 필짜린 웁찌 아마	세 필짜리는 없지 아마
개미가 이써요	개미가 있어요
개미	개미
개미 거 개미라고 하넝 거너뇨	개미 그 개미라고 하는 거는요
꺼기다 꺼먹 치를 해놔요	거기에다 검은 칠을 해 놓아요
함 필	한 필
요기만 함 피리다	여기면 한 필이다
표시하느라고	표시하느라고
표시	표시
요꺼지 짜먼 함 피리다	여기까지 짜면 한 필이다
그기 개미라구 하대요 또 그거넌	그게 개미라고 하데요 또 그것은
이 부러저넌 대다 고 치럴 해논넌다 이거여	이 부러지는 데다 고기 칠을해 놓는다 이거야
그래 가주 인재 고기	그래 가지고 고기
그래서 함 피리 대넝 거지	그래서 한 필이 되는 거지
이건 나올 때 여기 인재 저 나라 가주구서	이건 나올 때 여기 이제 저 날아가지고서
나올 때 인재 다 나오먼	나올 때 이제 다 나오면
고기 나른 대가 인재 요기 요가 함 피리자너 요 포럴 해놔요 요러캐	고기 난데가 이제 요기 요기가 한 필이잖아 요기 표를 해놔요 요렇게
쌔카망 걸로	새까만 걸로
그래 고로캐 해 노트라고요	그래 고렇게 해 놓더라고요
그러면 베 짜기저내 그르잉까 함 피리라구 하능 개 열따서 짜다 이르캐 딱 정해징 개 아니고	그러면 베 짜기 전에 그러니까 한 필이라고 하는 게 열다섯 자다이렇게 딱 정해진 게 아니고
이버내는 열따서 짜로 함 필 짜개따	이번에는 열다섯 자로 한 필 짜겠다
이버내는 스무 자를 짜개따 이르캐 정하능 거지요	이번에는 스무 자를 짜겠다 이렇게 정하는 거지요
정하지요 정해야지요	예
이쪼개 말머걸	이쪽에 말목을
할 한 말코애넌 정해저 가주 인능 기여	한 한 말코에는 정해져 있는 거야
한 말코	아 한 말코
한 말코애는 건 열따서 짜 함 필	어 한 말코에는 그것은 열다섯 자 한 필
수무 자 함 피리먼 수무 자 함 필	스무 자 한 필이면 스무 자 한 필
이르캐	이렇게
그래잉까 처매 짜기 저내 수무 자짜리로 짤 껀지 열따서 짜 짜리 짤 껀지 이걸정하고 짜능 거내요	그러니까 처음에 짜기 전에 스무자 짜리로 짤 건지 열다섯자짜리 짤 건지 이걸 장하고 짜는 거네요
아이 정해저 이따구	아이 정해져 있다고
정해즈 인능 기 인재 저 나라요 날 때요 베럴 날 때	정해져 있는 게 이제저 날아요 날 때요 베를 날 때
날 때 정해저 인능 기여 정해저 인능기여	날 때 정해져 있는 거야 정해져 있는 거야
그르니까요 날때	그러니까요 날 때
요기 개새 참새럴 해 노코요	예 여기 개새 참새를 해 놓고요
요기넌 하나요	여기는 하나요
말머글 하나 딱 빠가요	말목을 하나 딱 박아요
저 가서 하나만 바가 노코	저기 가서 하나만 박아 놓고
여기서넌 개새 참새럴 맨드러 가주구	여기서는 개새 참새를 만들어 가지고
하나 딱 빠가 논 대가 열따서 짜다	하나 딱 박아 놓은 데가 열다섯 자다
스무 자다	스무 자다
딱 정해저 인능 기여	딱 정해져 있는 거야
이캐 정해저 가주 이써요	이렇게 정해져 가지고 있어요
고 하나 말모카나 바가 논대	고 하나 말목 하나 박아 놓은 데
예예	예예
그람 고기다가 인재 치를 해요	그러면 고기에다가 칠을 해요
새카망 걸 가따 치를 해드라고요	새까만 걸 갖다 칠을 하더라고요
그래 가주구선 고꺼지 인재 하먼	그래 가지고 거기까지 이제 하면
고꺼지 인재 이기 여기서 불라 가주	거기까지 이제 이게 여기서  가지고
매 가주구 요래 다 그기 여꺼지 따라오자나요	매어 가지고 여렇게 다 그게여기까지 따라 오잖아요
따라오먼 도투마리애다	따라오면 도투마리에다
고기 가마 논 도투마리애다가 고기가 함 필 짠 대라능 걸루 포를 하드라고요	거기 감아 놓은 도투마리에다가 거기가 한 필 짠 데라는 걸로 표를 하더라고요
고로캐 하더라고요 그걸	그렇게 하더라고요 그것을
에 저여	예 저
그르캐 하드룩 대 인능 기요 그기	그렇게 하도록 되어 있는 거요 그게
그라먼 인재 요기가 열따서 짜 짜따	그러면 이제 요기가 열다섯 자 짰다
그라먼 여 인저요가 쌔카망 거 나옹 거 봉깨	그러면 여 이제요기가새까만 거 나온 거 보니까
여기가 스무 자 짜다 이거시 그리 가주 나오드라고	여기가 스무 자 짰다 이것이 그래 가지고 나오더라고
대개 인재 그렁 거가주구 옫슬 해 입짜나요	대개 이제 그런 거 가지고 옷을해 입잖아요
그걸루	그걸로
그 오태이불라며는 그 함 필가지며는 어느 정도 해 이버요	그 옷 해 입으려면그 한 필 가지면 어느 정도 해 입어요
어른 오슬	어른 옷을
함 필가 주구넌 그르캐는 안해 보고요	에 한 필 가지고는 그렇게는 안 해보고요
그냥 함 필로넌 연 대개 보먼	그냥 한 필로는 여긴 대개 보면
인재 자쑤로넌여자덜 여자더런 인재 요기 저기 저 한 자 모타개 해야 대요	이제 자수로는 에 여자들 여자들은 이제 여기 저기 저 한 자 못 되게 해야돼요
지리기가	길이가
여자런른	여자들은
근대 남자더런 이 한 자 지리기루 기리기 오설 만들더라고요	그런데 남자들은이 한자 길이로 길이 옷을 만들더라고요
그라닝깨 인재 고기 오설 만들구	그러니까 이제 거기 옷을 만들고
여기 소매넌 소매두 인재 요기 한 자로 해 가주구 점넌대 요기하구	여기 소매는 소매도 이제 여기 한 자로 해 가지고 접는데 여기 하고
키 큰 사라먼 요기다가 끄똥얼 달더라고요	키 큰 사람은 여기다 끝동을 달더라고요
이르키 다라 가주구	이렇게 달아 가지고
그래 가주구	예 그래 가지고
인재 여지 남자덜 오선 기리기가 한 자 해야 대요	이제 여자 남자들 옷은 길이가 한 자 해야 돼요
여자더런 인재 이기 그르니깨	여자들은 이제 이게 그러니까
한 자를 모태야 대요	한 자를 못 해야 돼요
이 한 자 지기 너머 지르니깨	이 한 자 길이가 너무 기니까
그래 한 옌나래넌 저 여자덜 저고리가 엄청 짤루깨 이버써요	그래 한 옛날에는 저 여자들 저고리가 엄청 짧게 입었어요
짤루깨 이끼 때매 여기 겨드랑이 나오니까	짧게 입기 때문에 여기 겨드랑이가나오니까
그기 이기 허리띠를 해찌요	그게 그래서 허리띠를 했지요
인재 지그먼	이제 지금은
또 이맘쿰 이 아주 또 줌 짤루깨뚜 지그먼 또 이르캐 질개 나오대요 고개	또이만큼 아주 또 좀 짧게도 지금은 또 이렇게 길게 나오데요 고게
근대 고기 여자더런 고기서 반 자 찌리기로 여자덜 오설 해 이버써요 여서	그런데 거기 여자들은 거기서 반 자 길이로 여자들 옷을 해 입었어요 여기서
그때 그러면 저 베트래서 오깜 짤 때 머 노래 부루구 그르진 아나써요	그때그러면 저 베틀에서 옷감 짤 때 뭐 노래 부르고 그러지는 않았어요
헤헤	헤헤
베틀노래 이짜너요	베틀노래 있잖아요
베틀노래가 인넌대 저넌 그런 노랜 아내바써요	베틀노래가 있는데 저는 그런노래는 안 해봤어요
허허허	허허허
베틀노래두 그냥 으냥 이상하드라고요	베틀 노래도 그냥 그냥 이상하더라고요
베틀노랜 자근 누니미 자리야 허허	베틀노래는 작은 누님이 잘해허허
잘 하지요	잘 하지요
그 형니미	그 형님이
지금두 기어카시나요	지금도 기억하시나요
우리 형니미 청애가 엄청 조아요	우리 형님이 청이 엄청 좋아요
하지 엄청 자라지	하지 엄청 잘 하지
옌나래 항 거 다 알지요	옛날에 한 거 다 알지요
지금 팔씹 두링가	지금 팔십둘인가
팔씹 스이	팔십셋
스잉가	셋인가
나보다 세살 더 잡쒀써	나보다 세 살 더 잡쉈어
팔씹쌩가	팔십샌가
고기 청산 사시나요	거기 청성 사시나요
할고리라고 카는대	할골이라고 하는 데
할골	할골
청산 할골	청성 할골
궁촐리요 궁촐리	궁촌리요 궁촌리
청산 할골 궁 궁철리	어 청성 할골 궁촌리
궁촐리요	궁촌리요
청상 청송	청성 청성
청사니 아니고 청성	청산이 아니고 청성
청성	청성
청산 청사니 안 청성이여	청산 청산이 아니고 청성이야
청사니아니고 거가 청성이여	청산이 아니고 거기가 청성이야
청성 궁촐리	청성 궁촌리
청성면 궁촐리	청성면 궁촌리
아이구 아이구	아이고 아이고
나중애 이거 다 끈나고 거기 가서	나중에 이거 다 끝나고 거기 가서
이거 저 베틀노래 함 번 해 보시라고 해야 갠내요	이거 저 베틀노래 한 번 해보시라고 해야겠네요
하하하 할 꺼요	하하하 할 거요
아니 제가 무러 보니까 하시는 부니 거이 업써요	아니 제가 물어 보니까 하시는 분이 거의 없어요
쪼꼼	조금
아패 쪼꼼 하다 이저버려따고 그러시는대	앞에 조금 하다 잊어버렸다고 그러시는데
근대 저 우리 자근 누니먼 이 무명베고 삼베고 아주 화통한 이여	그런데 저 우리 작은누님은 이 무명베고 삼베고 아주 화통한 이야
네 그러개요	네 그러게요
베도 잘 짜고	베도 잘 짜고
모타능 기 웁써	못 하는 게 없어
나넝 거나 머 모등 걸 아주	나는 거나 뭐 모든 걸 아주
누애두 처짜나요	누에도 쳤잖아요
누애	누에
뉘애두 처찌요	누에도 쳤지요
여기 누애두 처써찌요	여기 누에도쳤었지요
예저내 그거뚜 해 보셔써요	예전에 그것도 해 보셨어요
저두 함 번 해 바써요	저도 한 번 해 봤어요
뽕나무가 업써 가주구 즈더런	뽕나무가 없어 가지고 저희들은
저너 해볼라 구래떠니	저는 해보려고 그랬더니
제 욕씨매 그거럴 인재 해볼라캐써요	제 욕심에 그것을 이제 해 보려고 했어요
해볼라구 핸는대	헤 보려고 했는데
뽕이 모지래 가주 모타거뜨라고요	뽕이 모자라 가지고 못 하겠더라고요
그거뚜 그 크기애 따라서 이르미 다르자나요 그거	그것도 그 크기에 따라서이름이 다르잖아요 그것
근대 이 삼베도그 시럴 뽀불 때 중요항 기여	그런데 이 삼베도 에 그 실을 뽑을 때 중요한 거야
시를 가늘개 뽀바야지 이 이 새깔	실을 가늘게 뽑아야지 이 이 색깔
오시 곱찌요	옷이 곱지요
메 쌔 메 쌔 하능 기 나오능 거여	몇 새 몇 새 하는 게 나오는 거야
맹 조코 그거또 명하고 또까타요	좋고 그것도 명하고 똑같아요
새니 머냐하먼 아주 잘 항 기여	새니 뭐냐하면 아주 잘 한 거야
오고 머 시건 또까틍 거여	오고 뭐 식은 똑같은 거야
삼때가 꼬꼬타고	삼대가 꼿꼿하고
가쟁이 안 불고	가지가 안 벋고
쪼꼳탕 거넌 그건 그 고운 삼베루 나가요	꼿꼿한 거는 그건 고운 삼베로 나가요
또까꼬	똑같고
고롱 거넌	그런 것은
뉘꼬치럴 느코 쌀무 쌀무민성 시럴 뽐는담 마리여	누에고치를 넣고 삶으 삶으면서 실을 뽑는다 말이야
고때가 중요항 거여	그때가 중요한 거야
이 우리 형니먼 머 오래해서 머 다 드 잘 알지머	이 우리 형님은 뭐 오래 해서 뭐 다 더 잘 알지요
노래 머 베틀노래두 이떵고만 워냥	노래 뭐 베틀노래도 있더구먼 워낙
난안 해바서 모태 베틀노랜	난 안 안 해 봐서 못해 베틀노래는
누구한태 가서 나중애 가면 누구한태 무러바야 대요	누구한테 가서 나중에가면 누구한테 물어봐야 돼요
어디루 가요	어디로 가요
인재 지배 게실란지 안 게실른지 그거를 몰르지요	이제 집에 계실는지 안 계실는지 그것을 모르지요
아니 머 나중애 끈나구 그냥 놀기사마 가따가	아니 뭐 나중에 끝나고 그냥 놀기 삼아 갔다가
그쌔 그 저놔	글쎄 그 전화
거시기 가먼뇨	거기기 가면요
궁촐리 거기 그개	궁촌리 거기 그게
저나버노를 알키 조	전화번호를 가르쳐 줘
나중애	예 나중에
아니 그라고 거 경노당애 가먼	아니 그리고 거기 경로당에 가면
그 우리 형님또래드리 마나요	그 우리 형님 또래들이 많아요
거 우리 형님	거기 우리 형님
또 우리가 형니미 업써두 그 경노당애 가만 아시넌 분더리 이쓸꺼	또 우리가형님이 없어도 그 경로당에 가면 아시는 분들이 있을 거요
할머니 함짜는 어트개 되는대요	할머니 함자는 어떻게 되는데요
김배키요	에 김백희요
김배키	김백희
아들 딸 다 나가구 혼자 살자나 지금	아들 딸 다 나가고 혼자 살잖아지금
근대 마냐개 아들래 지배나 딸래 지배나 가먼 인재 우꼬	그런데 만약에 아들네 집에나 딸네 집에나 가면 이제 없고
고 우리 형님두 경노당애 거가 사라요 노다지	그 우리 형님도 경로당에 거기에 가서 살아요 항상
아니지요 마냐개 혼차 차자가개 대먼	아니지요 만약에 혼자 찾아 가게 되면
저나버놀 알먼 전화를 열라카고 가먼 된다고	전화번호를 알면 그 전화를 연락하고 가면 된다고
예예	예예
낭중애 머 하다두 대지머	나중에 뭐 해도 되지 뭐
파뤌딸쯔미나 언재 함 번 제가	팔 월쯤이나 언제 한 번 제가
마냐개 인재 우리지배 오시먼 요기서 저나 해 보고 가시두 대고	만약에 우리집에 오시면 여기서 전화 해 보고 가셔도 되고
인재 우리가 우꾸 마냐개 거기 가시먼	이제 우리가 없고 만약에 거기 가시면
인재 그 경노당애 우리 형님보다 나이가 더 마는 양반두 이꼬	이제 그 경로당에 우리 형님보다 나이가 더 많은 양반도 있고
또 자근 양반두 이구 머	또 작은 양반도 있고 뭐
우리 형님 또래더리 또 마나요	우리 형님 또래들이 또 많아요
그리 그기 경노당애 가만	그래서 거기 경로당에 가면
어느 부니던지 인재 아시넌 부니 이쓸 꺼요	어느 분이든지 아시는 분이 있을거예요
우리 헝니미 마냐개 웁떠래도	우리 형님이 만약에 없더라도
예저낸 누애 처 가주구 그거뚜 오깜 짜자나요	예전에는 누에 쳐 가지고 그것도 옷감 짜잖아요
우리 형님 그거 마니 해써요	우리 형님 그거 많이 했어요
명주	명주
젤 쯔넝거지	제일 치는 것이지
그 명주	그 명주
예 명주	예 명주
명주가 공단 아니요 고기	명주가 공단 아니요 그게
비다니라 카능건	비단이라고 하는 것은
비단	비단 예
비다니라고두 하구 공다니라구두 하구	비단이라고도 하고 공단이라고도 하고
공다니라구두 하고	공단이라고도 하고
근대	예 그런데
근대 그거 할라먼 인재 뉘 누애 키우자나요	그런데 그거 하려면 이제 누에누에 키우잖아요
씨 씨 씨라 그래지요	씨 씨 씨라 그러지요
그 똥고랑 거	그 동그랑 거
씨 웁써요	씨 없어요
건 뫼 뉘럴 크먼	그건 누에를 크면
오디 오디라 그라지요	오디오디라 그러지요
오디	오디
아니 아니 그거 말구 뉘애	아니 아니 그거 말고 누에
뉘애 키울 때	누에 키울 때
누애 키울 때 나방	누에 키울 때 나방
뉘애	누에
맨처매 째끄망 거애서	맨 처음에 조그만 거에서
그쌔 나방이	아 글쎄 나방이
날나방이 돼 가주구	날나방이 돼 가지고
뇌가 하니 차마뇨	누에가 한이 차면요
지불 지차나요	집을 짓잖아요
지불 지먼 그개 인재 내오 꼬치라카자나요	집을 지으면 그걸 누에고치라고 하잖아요
뇌꼬치애서 나방이 나와요	누에고치에서 나방이 나와요
나방이 나와 가주 그기 뉘가 인재 아를 깔리드라고요	나방이 나와 가지고 그게 이제 누에가 알을 깔리더라고요
인지 조마이 좁쌀거치	이제 조그만하게 좁쌀같이
거서 뉘애가 나오넝 거	거기서 누에가 나오는 거
좁쌀처럼	좁쌀처럼
고고럴 인재 요런 종일 요만하개 까라 노먼	고거를 이제 요런 종이를 요만하게 깔아 놓으면
고기 나방이 고기다 아럴 깔리대요	거기 나방이 거기에다 알을 갈리대요
개서 고기 그걸루 인재 나와요	그래서 고기 그것으로 이제 나와요
벌거지가 아주 빠나개	벌레가 아주 조그만 하게
그럼 인재 그 뽕얼 종쫑 쓰러 가주	그러면 이제 그 뽕을 쫑쫑 썰어 가지고
쌔끼 쩌갠 아주 종쫑 쓰러 주더라고요	새끼 적엔 아주 쫑쫑 썰어 주더라고요
그래 가주 줌 크구 크구 하먼	그래 가지고 좀 크고 크고 하면
자꾸 인재 기냥 다 그개 막 올라갈 정도대	자꾸 이제 그냥 다 그게 막 올라갈정도 돼
다 크먼 막 기냥 가쟁이채 막 기냥 꺼꺼다가 막 우애다 언저주더라고요	다 크면 막 그냥 가지채 막 그냥 꺾어다가 막 위에다 얹어 주더라고요
그렁 거넌 바써요	아 그런 거는 봤어요
그기 옌나랜 누애도 마이 치 길르구 그랜는대	그게 옛날에는 누에도 많이 치 기르고 그랬는데
지금 아내	지금 안 해
한 집뚜 아내	한 집도 안 해
그거 쩌기 클 때마다 이르미 달릉가요	그거 저기 클 때마다 이름이 다른가요
그거 저기 밥 암 머꾸 하루 자구 막 그르자나요	그거 저기 밥 안 먹고 하루 자고 막 그러잖아요
그 네 스짬 자먼 올라가넝가	그 네 석 잠 자면 올라가는가
이럼	이름
세 잠 자먼 올라가넌대	세 잠 자면 올라가는데
그리니까	그러니까
즈기 마 인재 처짬 두짬 세짬이더 그르캐 올러 그라드라고요	저기 마 이제 첫 잠 두 잠 세 잠이다 그렇게 올라 그러더라고요
잠 자는 대 뽕얼 암 머거	잠 잘 때는 뽕을 안 먹어
고갤 치들고	고개를 쳐들고
잘 때는 암 머거	어 잘 때는 안먹어
츠매 잘 때두 안대구	처음에 잘 때도 안 먹고
두번째 자고 세번째 자먼	두 번째 자고 세 번째 자면
그 인재 꼬추럴 만든다카드라고요	그 이제 고치를 만든다고 하더라고요
그 그거뚜 인재 크먼 뽕 먹짜나요	그 그것도 이제 크면 뽕 먹잖아요
그럼 쭐거리두 생기구 똥두 생기자나요	그렴 줄거리도 생기고 똥도 생기잖아요
그럼 이르키 또 옴겨서 딴 대다가	그러면 이렇게 또 옮겨서 다른 데다가
예예 그러카더라고요	예 그렇게 하더라고요
뇌럴 막 가따가 이르캐 해 노터라고요	누에를 막 갖다가 이렇게 해 놓더라고요
그거 머 하능 거라 그래요	그거 뭐 하는 거라고 그래요
그거는	그거는
잠바개 잠박	잠박에 잠박
뉘에 기르는 잠박 잠바개서 장바걸 가르능 거지	누에 기르는 잠박 잠박에서 잠박을 가르는 거지
뇌 뇌잠박	누에 누에 잠박
뇌 이르캐 잠바기라 그라대	누에 이렇게 잠박이라고 그러대
그 잠바개다가 해서 칭대루 해 노쿠 거따가 막 뽕얼 주더라고요	그 잠박에다가 해서 층대로 해 놓고 거기에다가 막 뽕을 주더라고요
그러구 나서 나중애 인재 이개 다 크면 좀 누루수룸해지자나요	그리고나서나중에 이제 이게 다 크면 누르스름해지잖아요
집 지끼저내 그거	집 짓기 전에 그거
그르먼 인재 거기다가 서비라고 해요	그러면 이제 거기다가 섶이라고 해요
서비라구 올리 주지요	섶이라고 올려 주지요
멀루 해요 섭	뭘로 해요 섶
서벌 인재 저 속 속깍까쟁이나 머	섶을 이제 저 솔 소나무 가지나 뭐
좀 이른 그렁 걸루 하는대	좀 이런 그런 걸로 하는데
옌나랜	옛날엔
지그먼 새루 나옹 거	지금은 새로 나온 거
기개루 대 이찌요	기계로 돼 있지요
기개루	기계로
기개루 짱 거	기계로 짠 것
저기 저걸루 하대요	저기 저걸로 하데요
지그먼 푸라스트	지금은 플라스틱
프라시티루 구멍 빠끔빠끄마개 막 이래 해 가주구 그걸루 이르캐 죽 이르캐 해놔때요	플라스틱으로 구멍 빠끔빠끔하게 막 이렇게 해 가지고 그걸로 이렇게 죽이렇게 해 놨데요
거 보니깨	그거 보니까
근대 지그 옌나래넌 속깝 까쟁이 기냥 가쟁이 젤 마니 버렁 거	그런데 지금옛날에는 솔갑 가지 그냥 가지 제일 많이 벋은 거
그렁 거뚜 해 노쿠	그런 것도 해 놓고
지부루두 여꼬 머 그래 해찌마넌	짚으로도 엮고 뭐 그렇게 했지만
옌나래그치 아나대요 지그먼	옛날에 같이 안 하데요 지금은
프라시티루 나오고	플라스틱으로 나오고
그러캐 해서 저 하야캐 지자나요	그렇게 해서 저 하얗게 짓잖아요
그걸 머라 그래요	그걸 뭐라 그래요
니꼬치라 그러지	누에고치라 그러지
니에꼬치	누에고치
니꼬치지요	누에고치지요
그거 두 개가 드러강 거뚜 이찌요	그거 두 개가 들어간 것도 있지요
두 마리가	두 마리가
쌍둥이	예 쌍둥이
두 마리 드러강 거뚜 이찌요	두 마리 들어간 것도 있지요
그건 머라 그래요	그건 뭐라 그래요
쌍둥	쌍둥
그거 인재 쌍둥꼬치라카지요 머 그거뚜	그거 이제 쌍둥고치라고 하지요 뭐 그것도
저 그 아내 이르캐 짤라 보면 요마낭 거 꿈틀	저 그 안에 이렇게 잘라 보면 요만한 거 꿈틀
번데기	번데기
그르치 번디기	그렇지 번데기
번데기가 두 개 드러찌요	번데기가 두 개 들었지요
고거 쩌기	그거 저기
머야	뭐야
간 해 가주구 살마서 머그먼 마시짜나요	간 해 가지고 삶아서 먹으면 맛있잖아요
마시찌요	맛있죠지요
에헤헤	에헤헤
속 소금 느쿠 뽀까 가주구	소 소금 넣고 볶아 가지고
그건 그게 실 뽀불 때	그건 그게 실 뽑을 때
실 뽀불 때 바루 건지내 논능 기 젤 마시써	실 뽑을 때 바로 건져내 놓는 게제일 맛있어
그래 퉁퉁항개 드러 가주	그래 퉁퉁한 게 들어 가지고
퉁퉁하고	퉁퉁하고
아내 아내	안에
그거뚜 소설 요래 거러노차나요	그것도 솥을 요렇게 걸어놓잖아요
아리 인재 그 참	알이 이제 그 참
그리두 물 느 그 소설 거러노쿠 거기다가 무리 끄르먼	그래도 물을 넣 그솥을 걸어 놓고 거기다가 물이 끓으면
그 네오꼬치를 거기다 느 가주구	그 누에고치를 거기다 넣어 가지고
그거 저기 그 머여	그거 저기 그게 뭐야
그때는	그때는 음
지그먼 와리바시라고 하지	지금은 나무젓가락이라고 하지
그 이짜나요	그 있잖아요
옌나랜 그기 업써 가주구	옛날에 그게 없어 가지고
그거 이짜나요	그거 있잖아요
저기 그거 쑤수 파떠캐멍넝 거 그거	저기 그거 수수 팥떡 해 먹는 거 그거
그거 인재 재 비짜리 매넝 거	그거 이제 제 빗자루 매는 거
그거 쭘 그 킁 거 그거럴	그것 좀 큰 거 그것을
그걸루 인재 쪼꿈 굴긍 걸루 가따가	그것으로 조금 굵은 것을 잦다가
그걸루	그걸로
자꾸 인지 이르키 둘루먼 이 고추가 막 시리 마이 따라나오먼	자꾸 이제 이렇게 둘르면 이 고치가 막 실이 많이 따라 나오면
요 고출 자꾸 이르캐 그걸루 막 일루 저꾸 일루 저꾸	이 고치를 자꾸 이렇게그걸로 막 이리 젓고 이리로 젖고
막 이라드라고요	막 이러더라고요
가모미서	감으면서
요마난 소슬 하나 거러 노코	요만한 솥을 하나 걸어 놓고
그거	아 그거
나도 하넝 건 바써요	나도 하는 건 봤어요
그개 그르캐 솓태다가 그 삼능 거지요 그거	그게 그렇게 솥에다가 그 삶는거지요 그거
소설 거러 노코 요 부럴 때서 쌀마요	예 솥을 걸어 놓고 요기에 불을 때서 삶아요
그람 무리 끄러 끌차나요	그러면 물이 끓어 끓잖아요
끄러먼 인재 물래루 인재 이르캐 돌리먼	끓으면 이제 물레로 이제 이렇게 돌리면
시리 한태 엉키 가주구 여기서 막 쌂는대서 엉키서 나와요	실이 한데 엉겨 가지고 여기서 막 삶는 데서 엉겨서 나와요
그람 인재 이기 자꾸 이거럴 이르캐 돌리민성 막	그러면 이제 이게 자꾸 이것을 이렇게 돌리면서 막
이걸 그냥 나두먼 막 두루루해서 막 이 시리 엄첨 구깨 나오거더녀	이걸 그냥 놔두면 막 두루루해서 막 이 실이 엄청 굵게 나오거든요
그랑깨 자꾸 그걸루	그러니까 자꾸 그걸로
쑤꾸 쑤꾸때기	수수 수수대
그 쑤꾸때기자나요	그 수숫대잖아요
걸로 자꾸 그 저버무루 그걸 막 이르캐 자꾸 제끼더라고요	그걸로 자꾸 젓가락으로 그걸 막 이렇게 자꾸 젓더라고요
소태다 노코 막	솥에다 놓고 막
그건 둘루민서 자꾸 이래 이래 이래 제끼더라고요	그건 돌리면서 자꾸 이렇게이렇게 이렇게 젖히더라고요
그람 이기 한태 막 엉기 가주구	그러면 이게 한데 막 엉겨 가지고
이걸 빨리 아나먼 시리 구깨 뽀피드라고요	이걸 빨리 안 하면 실이 굵게 뽑히더라고요
거 하능 건 바써요	그 하는 건 봤어요
에 나도 함 번 함 번 해보고 안 해 바써요	에 나도 한 번 한 번 해보고 안해 봤어요
그개 실 뽐능 개 기수리라고	그게 실 뽑는 게 기술이라고
그거 그르닝까 무래다가 사 쌀마 가주구 해야지	그거 그러니까 물에다가 사람삶아가지고 해야지
뽕나무가 업서 가주구	뽕나무가 없어 가지고
그기 시리 뽀피능가 보내요	그게 실이 뽑히는가 보네요
그리치	아 그렇지
예 소설 요래 요마낭 냄비럴 냄비 하나 거러나요	예솥을 요렇게 요만한 냄비를 냄비 하나 걸어 놔요
쫑 킁 거 요마낭 거	좀 큰 거 요만한 거
저는 그 시를 어트개 뽐는지 그냥 이르캐 다 지불 지어노먼 하야차나요	저는그 실을 어떻게 뽑는지 그냥 이게 다 집을 지어 놓으면 하얗잖아요
그거 실 뽀부먼 잘 암 뽀피등 거 가튼대 그 어트개 뽐나 그래뜨니그개 무래다가 쌀머 가주구 이르캐	그게 실 뽑으면 잘 안 뽑혔던 거 같던데 그 어떻게뽑나 그랬더니그게 물에다가 삶아가지고 이렇게
물래	물레
물래 아시자나	물레 아시잖아
인재 물래	이제 물레
그거 인재 거뚜 명 잔는 물래	그거 이제 그것도 명 잣는 물레
그걸루 이르캐 해 가주구	그걸로 이렇게 해 가지고
그 뉘애가 마리여	그 누에가 말이야
거 시럴료	그 실을요
똥꾸녀개서 이거 시럴 뽀바서 이래 맹그러농 거란 마리여 그기	똥구멍에서 이거 실을 뽑아서 이렇게 만들어 놓은 거란 말이야 그게
니 꼬치가	누에 고치가
예예	예예
그리차너	그렇잖아
인재 물래애서	이제 물레에서
근데 그개 고대로 쌀무먼 고대로고 하나	그런데 그게 그대로 삶으면 그대로 그 하나
꺼꿀로 하능 거지요	거꾸로 하는 거지요
꺼꿀로 그걸 다시 뽀바 내넝 거요	아 거꾸로 그걸 다시 뽑아 내는 거요
뽀바 내는	뽑아 내는
얘가 얘가 가머농 걸 다 푸능 거지요	얘가 얘가 감아 놓은 걸 다 푸는 거지요
고걸 푸넝 거여	그걸 푸는 거야
근대 이르캐 물래애다가 이만창 가마지자나요	그런데 이렇게 물레에다가 이만큼 감아지잖아요
이개 자꾸 이러카먼	이게 자꾸 이렇게 하면
고걸 또 인저 시 저 네 군대루 짬매 놔야 대요 고고럴	그걸 또 이제 저 네군데로 동여매 놔야 돼요 그것을
그르치요 나중애 암 뭉치지요	그렇지요 나중에 안 뭉치지요
예예	예예
고래 맹그러 농 걸 다시 뽀바 내넝 거여	고렇게 만들어 놓은 걸 다시 뽑아 내는거야
고 고래 해가	그래 해서
그래 가주 그걸 또 이르캐 꾸리럴 감짜나요	그래 가지고 그걸 또 이렇게 꾸리를 감잖아요
꾸리럴 가마 가주 그거뚜 열 깨를 해 노코	꾸리를 감아 가지고 그것도 열 개를 해 놓고
거기다가 또 그 베 나능 거하고 또까치 고로캐 해 가주구	거기다가 또 그 베나는 거하고 똑같이 그렇게 해 가지고
그래서 그거럴 짜 가주구 그래	그래서 그거를 짜 가지고 그래
그러캐 해 가주구 이르캐 시 시를 이러캐 푸러내능 걸 머 한다 그래요 그걸	그렇게 해 가지고 이렇게 실 실을 풀어내는 걸 뭐 한다 그래요 그걸
그거요	그거요
그거넌 머 저기 뇌꼬치	그거는 뭐 저기 누에고치
명 명주실	명 명주실
뽐는다 구라지 머	뽑는다 그러지 뭐
뇌꼬치 실 뽐는다 고라지요	예 누에고치 실 뽑는다 그러지요
명주실 뽐는다 구라지요	명주실 뽑는다 그러지요
명주시리지 내내 그개	명주실이지 내내 그게
그르캐 해서 뽀분 다으매 그걸 가주구 인재 또 아까가치 쭝 나라서	그렇게 해서 뽑은 다음에 그걸 가지고 이제 또 아까같이 죽 날아서
과정은 베 맹그능 거랑 또까튼 방버부로	과정은 베 만드는 거랑 똑같은 방법으로
또 인재 또까튼 방버부로 하능 거지요	또 이제 똑같은 방법으로 하는 거지요
베하고 삼베하고 또까타요	예 베하고 삼베하고 똑같아요
또까튼 방버부로	똑같은 방법으로
하는 방버번	하는 방법은
또까튼 방버부로 하능 거	똑같은 방법으로 하는 거
옌나래	옛날에
그거뚜 삼두 그쌔 이마난 물래라고	그것도 삼도 글쎄 이만한 물레라고
큰 물래라구 해 노코	큰 물레라고 해 놓고
거 개새 참새럴 해 노코	그 개새 참새를 해 놓고
그거뚜 그래 짜 해 가주구넌 그거뚜 꾸리루 감짜나요	그것도 그렇게 해 가지고는 그것도 꾸리로 감잖아요
점부 다	전부 다
그래 가마 가주구서 그거뚜 나라 가주 그거 또까타요	그렇게 감아 가지고서그것도 날아 가지고 그거 똑같아요
베나 삼베나 명주나 하넝 거넌 또까타요	베나 삼베나 명주나 하는 것은 똑같아요
좀 인재 베 이러미 틀리서 그르치	좀 이제 베 이름이 달라서 그렇지
그거뚜 가튼 베틀루 짜나요	그것도 같은 베틀로 짜나요
그르치요	그렇지요
그러먼 그거넌 저기 바디가 다르지요 그거는	그러면 그것은 저기 바디가 다르지요 그것은
암 안 달라요	안 안 달라요
바디두 가타요	바디도 같아요
바디는 가찌	바디는 같지
그른대 인재 요기 글쌔 세미라개 더 마 아주 자자하개 대이찌	그런데 이제 요기 글쎄 세밀하게 더 아주 자세하게 돼 있지
그 바두가	그 바디가
아홉쌔 베 짜 저 짜넝 거 하고	아홉새 베 짜 저 짜는 거 하고
삼베도 곱깨 짜넝 거 하고 이써요	삼베도 곱게 짜는 거 하고 있어요
바디가요	바디가요
바디 시기	바디 식이
끼능 거넌 그기 저 바디구요	꿰는 것은 그게 저 바디고요
인재 바디애 다 낑 거 거기다가 인재 이르캐 생기쓰먼 인재	바디에 다 꿴 것거기다가 이제 이렇게 생겼으면 이제
고 실 실 낑 거럴 이르캐 꼬바요	그 실 실 꿴 것을 이렇게 꽂아요
아래 우애	아래 위에
그라고 꼬삐 여 꼬쟁이가 이짜나요	여그리고  여기 꼬챙이가 있잖아요
한짜개는 이르캐 매키구	한쪽에는 이렇게 막히고
한짜개는 하나만 빼먼 이르캐 들리자나요	한쪽에는 하나만 빼면 이렇게 들리잖아요
고기다 요르캐 해 노코	거기다 이렇게 해 놓고
머 이르캐 마차 가주구서 꼬쟁이 꼬바 노쿠	뭐 이렇게 마춰 가지고 꼬챙이 꽂아 놓고
그라먼 인재 이기 그기 안 나가자나요	그러면 이제 이게 그게 안 나가잖아요
빠지나가다	빠져나가다
그거 고건 바디지비라 구래요	그거 고건 바디집이라고 해요
그래서 인재 고고 바디지번 인재 부기 드르가따가 나오먼	그래서 이제 고고바디집은 이제 북이 들어갔다가 나오면
그 이르캐 탁 때리먼 고 짜지자나요	그 이렇게 탁 때리면 그게 짜지잖아요
또까타요	똑같아요
바디 저 명주나 머나	바디 저 명주나 뭐나
근대 그 바디지비라카능 기	그런데 그 바디집이라고 하는 게
저 바디라카능 기	저 바디라고 하는 게
저 명주 짜는 바딘 참 고아요	저 명주 짜는 바디는 참 고와요
아주	아주
구먹또 자자라고	구멍도 자잘하고
그뚜 고꼬	그것도 곱고
또 그거뚜 뿔떡	또 그것도 뿔떡
그건 실	그건 실
보롬쌔 바지니 머 이라능 기여	어 보름새 바지니 뭐 이러는 거야
고기 보롬	어 고게 보름
보롬쌔 바지요	보름새 바지요
아주 아주 가능 거 보롬쌔	아주 아주 가는 것은 보름새
어허허허	어허허허
고 쫌 굴긍 거는뇨	그 좀 굵은 거는요
인재 굴긍 거넌 머 한 열한 새나 열 머 십쌈새니 머 이라고 이라는 거지	굵은거는 뭐 한 열한 새나 열 뭐 십삼새니 뭐 이러는 거지
닫쌔 베 엳쌔 베 그리치	닷새 베 엿새 베 그렇지
아이 쩌 그건 명주고 명주럴 마라능 기지 명주	아이 저 그건 명주고 명주를 말하는 거지 명주
닫쌔가 젤 라 나증 거고	닷새가 제일 낮은 것이고
명주넌 인재 그르캐 간다 이기여	명주는 그렇게 간다 이거야
보롬 쌔 그러먼 열따서 쌔라는 뜨시내요	아 보름 새 그러면 열다섯 새라는 뜻이네요
여란 새 열 쌔	열한 새 열 새
이 무명	이 무명
이르캐 모콰로 맹그넝 거는 아홉 쌔 열 쌔까지도 안간다고 열 쌔까지 몸 뭉는다고 아홉 쌔 아홉 쌔가 젤 에	이렇게 목화로 만드는 것은 아홉 새 열 새까지도안 간다고 열 새까지 못 묶는다고 아홉 새 아홉 새가 제일
아까 아홉 쌔	예 아까 아홉 새
아니여 아홉 쌔가 최고 조웅 건	아니야 아홉 새가 최고 좋은 건
이거는 보롬 쌔가	이거는 보름새
트기항 기고	특이한 거고
인재 명주넌 보롬 쌔	이제 명주는 보름 새
보롬 쌔 너머가능 거뚜 이따카지 아매	보름 새 넘어 가는 것도 있다고 하지 아마
보롬 쌔가 챌 조웅 기여	보름 새가 제일 좋은 거야
보롬 쌔가 최공 거 아니여	보름 새가 최고인 거 아냐
그래 보롬 쌔까진 치드라고	그래 보름 새까지는 치더라고
아이고 오늘 그 그동안 잘 모뜨러뜽 거 마니 드런내요	아이고 오늘 그 그동안잘 못 들었던 것 많이 들었네요
아하하하	아하하
우리도 아능 거	우리도 아는 거
자세하개를 잘 몯 말씀 잘 모타시드라구 이저버려따구	자세하게 잘 못 말씀 잘안 못 하시더라고 잊어버렸다고
아는 대까지만 얘기하능 기여	아는 데까지만 얘기하는 거야
근대 총기가 조으시니까	근데 총기가 좋으시니까
그걸 자세하개 말씀해 주시내요	그걸 자세하게 말씀해 주시네요
근대 저두 그걸 해바끼 때매 알지 아내바씀 저두 몰라요	그런데 저도 그걸 해봤기 때문에 알지 안 해 봤으면 저도 몰라요
그저내 하도 그저낸	그전에 하도 그전에는
이름까지두 자세하개 아라썬는대	이름까지도 자세하게 알았었는데
여 나이 먹꼬 이라니깨 그기 자꾸 이럼 거텅건 이럼 거틍건 이저버리진다고	나이 먹고 이러니까 그 자꾸 이름 같은 거 이럼 같은 건 잊어버린다고
안 쓰자나요	안 쓰잖아요
안 써	안 써
안 쓰니깨	안 쓰니까
안 쓰니깨 자꾸 이저버리저 가주구	안 쓰니까 자꾸 잊어버려 가지고
깅가 밍가두 시꾸 이르트라구	긴가민가도 싶고 이렇더라고
생가캐보먼	생각해 보면
아이고 우리 선생니미 이개 오시 가주구	아이고 우리 선생님이 이렇게 오셔가지고
이르캐 수고두 하시구	이렇게 수고도 하시고
아유 얘기를 해 주시니까 그르치요	아유 얘기를 해 주시니까 그렇지요
아하하하	아하하하
