dialect	standard
그러면 이제 저 본껵쩌그로 이제 여쭤볼께 인는데 혹씨 어르신 그 지금 요기 호촌 마을이자나 아니 호촌 마으린데 이 마으리 언제 형성된는지 알 쑤 인나요여	예 그러면 이제 저 본격적으로 이제 여쭤볼 게 있는데 혹시 어르신 그 지금 여기 호촌 마을이잖아 아니 호촌 마을인데이 마을이 언제 형성 됐는지 알 수 있나요
이 마으리 형성되기는 그 오래돼찌요	이 마을이 형성되기는 그 오래 됐지요
인제 오래 그 조선시대 전 초기때부텀 대따봄미다	인제 오래 그 조선시대 전 초기 때부터 됐다고 봅니다
돼따 보는데 그 호초니라고 지명 핸거는 거는 인제 유래를 제가 드꼬 이썬는데 여개가 이거우리 마을 이르미 범 호짜 요 미테 아래똥네가 풍촌 풍년 풍짜 마디 촌짜	됐다 보는데 그 호촌이라고 지명 한 거는 그건 인제 유래를 제가 듣고 있었는데 여기가 이거 우리 마을 이름이범호 자 요 밑에 아랫동네가 풍촌 풍년 풍 자 마디 촌 자
풍녁	풍녁
풍녕 풍 풍녁 풍	풍년 풍 풍년 풍
풍녁 풍 바람 풍 짜네요	아 풍녁 풍 바람 풍 자네요
아니 풍년풍이라 여 바람풍 이찌	아니 풍년 풍이라 여기 바람 풍 있지
풍녀이라고 왜	풍년이라고 해 왜
풍년 풍 짜 네네	풍년 풍 자 네네
마지 촌 짜 해가지고 풍초니고 여게는	마디 촌 자 해가지고 풍촌이고 여기는
마디 촌 짜네요 여기는뇨	아 마디 촌 자네요 여기는요
여개는 호며이라고 호명 이 지명이 그 동네 지명 호며인데 범 호 짜하고 마디 촌 짜하고부처가지고 아래똥네가 호초니래요	여기는 호명이라고 호명 지명이 그 동네 지명이 호명인데범 호 자하고 마디 촌 자 하고 부쳐 가지고 아랫동네가 호촌이에요
범 호 짜하고	아 범 호 자하고
마지 촌 짜하고	마디 촌 자하고
마디 촌 짜해서호초니구나 다 합친 거네여	마디 촌 자해서호촌이구나 다 합친 거네요
야 합체	네 합쳐 예
그래 합체 합치니까 인제 익 화암며니 장녀네 그 이 개명 곤처써요	그래 합쳐 합치니까 인제 이 화암면이 작년에 그 개명 고쳤어요
그전 동며니래요 동면 동면 호초닌데 그래 곤 곤처가지고 인제 여개 옌나레 그 인제 호촌니로 그리 쭝니러완는데 왜서 호명이냐 하머는 그저네 여개 동네 이 집 이러게 생긴 이 모양이연하부수형국 연꼬치 물에 떠 인는 형구기다 옌날 도성이 짜글 쩌게 위에다 큰 기와찌비 정선군 부자터이 시방도 이써요	그전에는 동면이에요 동면 동면 호촌린데 그래 고쳐 가지고 인제여기 옛날에 그 인제 호촌리로 그렇게 쭉 내려왔는데 왜서 명이냐 하면 그전에 여기 동네 이 집이렇게 생긴 이 모양이 연화부수형국 연꽃이 물에 떠 있는 형국이다 옛날 도성이 작을 적에 위에다 큰 기왓집이 정선군 부자터가 지금도 있어요
그 인제 연꼬치 무레 떠 인는 걷 떠이따는 거슨 연모시 이써요 여 연몯 물 그초	그 인제연꽃이 물에 떠 있는 것 떠있다는 것은 연못이 있어요 연못 물 그렇지요
그래 연꼬때궁에 구녀이 이써야 됨미다	그래 연꽃 대궁에 구멍이 있어야 됩니다
그래 요  싹다올로오미 연꼳 모양을 대가지고 인는데 연하어 부수형구기라고 형국짜르거든뇨 또 지명이	그래 요  싹 다 올라오면서 연꽃 모양을 대 가지고 있는데 연화부수형국이라고 형국 자르거든요 또 지명이
그르니깐두루 버마초니 아주 옌나레는 또 호며이라 지끼 저네는 그래 조선	그러니까 범화촌이 아주 옛날에는 또 호명이라 짓기 전에는 그래 조선
명 짜는 무슨 명 짠가요	명 자는 무슨 명 잔가요
울 명 짜래요	울 명 자래요
울 명	울 명
또 호래이 운다아이요 그래 버마촌 아주 아주 옌나레 버마초늘 뜰 뻠짜 꼬 톼짜 여 연꼬치 무레 떠이쓰이깐두루 버마초니라고 이러케 제때요	또 호랑이 운다 아니요 그래 범화촌아주 아주 옛날에 범화촌을 뜰 범 자 꽃 화 자 여 연꽃이 물에 떠 있으니까 범화촌이라고 이렇게 지었대요
범화촌	아 범화촌
그래다보니까 그중에도 그 시대에 어떤 그사람 쪼끔 이리 쫌 성겨리 괄괄한 왈왈한 개구재이라서 개구재이	그러다보니까 그 중에도 그 시대에 어떤 그 사람 조금 이리 좀 성격이 괄괄한개구쟁이라서 개구쟁이
괄괄한	예 괄괄한 예
그래 그런분들 이따가 버마 범도 아마 호랑이를 버미라해 그까짇 버마촌 하피리머이인느냐이기야 아주 호랭이가 운다고 호명이라 하자	그래 그런 분들 있다가 범화 범도 아마 호랑이를 범이라고 해 그까짓 인제 범화촌 하필 뭐가 있느냐 이거야 아주 호랑이가 운다고 호명이라하자
그래서 홍 호며이 호명돼땀미다 여가	그래서 홍 호명이 호명되었답니다 여기가
그래요	아 그래요
그럼 여기에 주로 어떤 성 씨 분드리 사세요 며 토 되나요	아 그럼 여기에 주로 어떤 성씨 분들이 사세요 몇 호 되나요
여게가 전씨드리 젤 만치요	여기기가 전 씨들이 제일 많지요
전씨 전씨 정선 전씨	전 씨 전씨 정선 전 씨
정선 전씨	정선 전 씨
이 이놈 전 사라민째 임그뫙짜 이놈 전 정선 전 씨	이 이놈 전 사람 인 자 임금 왕 자 이놈 전 정선 전 씨
여기 한 며토 정도 돼요	아 여기 한 몇 호 정도 돼요
요 아루똥네가 저 지금 한 이시포 돼요	요 아래윗동네가 저 지금 한 이십 호 돼요
그래요	아 그래요
그럼 여기에는 이제 머 사니나 강 골짜기 머 이런 유래 가튼 거뜰 이씀니까 여기 산도 이꼬	그럼 여기에는 이제 뭐 산이나 강 골짜기 머 이런 유래 같은 것들 있습니까 여기 산도 있고
여개 흠 이 고을 이름 젠거는 아주 옌날 거 아주 머 참 고러때 핸나 어뜨 운제 이 땅 생기구 저	여기 이 고을 이름 지은 거는 아주 옛날 거 아주 뭐 참 고려 때 했나 언제 이 땅 생기고 저
지구가 생게씨니 멀더 머 동목째니 어우시리니 그차내요	지구가 생겼으니 뭐 동목재니 어우  실이니 그렇잖아요
다시 한 번 동	다시 한 번 동
동목째 또어우실 어우실 고 다으메 이망이 이마이	동목재 또어우실 어우실 그다음에 이망이 이망이
이망이요	이망이요
응 이	응 이
이망이가 뭔가요	이망이가 뭔가요
이마이랑 거 고을 이르미 이마이라 또	이망이란 그 고을 이름이 이망이라한다
이망 이망 이 이망이	아 이망 이망 이 이망이
또 가둔지 가둔제 가둔지 가둔지 가둔 요 가둔지라 이따 요게	또 가둔지 가둔제가둔지가둔지 가둔 요 가둔지라고 있다 요기에
저수지 가튼 게 가슨	아 저수지 같은 게 가둔
게 그냥 그 그 가둔지라고 인제 가둔 가둘 까 골까자 가둔지 요 감재 감재 이 동네 고을이르미 그루 돼 이씀미다	그게 그냥 그 가둔지라고 인제 가둔 가둘 가 골 가 자 가둔지 여기감재 감재 이 동네 고을 이름이 그렇게 돼 있습니다
그곧 유래를 좀 알 수 이쓸까요	그곳 유래를 좀 알 수 있을까요
유래 가둔제 유래는 그게 가둔지라 하는데 그게	유래 가둔제 유래는 그게 가둔지라 하는데그게
가둔젠	가둔젠
가둔지 지 지 지지	가둔지 지 지 지지
그기 뭐 가둔지린데 거 가둔지는 유래는 읍꼬 거게 지금 그 사니 복판 하나 이써가지고 그제 모 묘짜리가 조금 된 거 귿 여나부수형국 인저 이따	그게 뭐 가둔지린데 거 가둔지는 유래는 없고 거기에 지금 그 산이 복판 하나 있어가지고 그 제 묘자리가 조금 된 거 그 연화부수형국 인제 있다
여노파다 그런 그런 지며이 이찌	그런 그런 지명이 있지
연호파요	연호파요
이 이너 이너 고기 여너 여너라지 머 이너라 하든지 인는데	이 잉어 잉어 고기 연어 연어라지 머 잉어라 하던지 있는데
저거 저거에는 후리뜽 고기 고기 잠는다고 후리치자나 후리	저거 저거에는 후리등 고기 고기 잠는다고 후리치잖아 후리
후리치고 이짜게 그물메기 고기 잠는 그물처써 그물 그물메기	후리치고 이쪽에 그물메기 고기 잡는 그물쳤어 그물 그물메기
고다메 고기 또 자불라고 아페가 물 안 헤벼고 설토 물 이따 설통	그 다음에 고기 또 잡을라고 앞에 가 물 안  설통 물 있다 설통
설통뇨	설통이요
무레 다머 놔따고	물에 담어 놨다고
설통은 뭐에요	설통은 뭐에요
그기 고기가 무러서 무러 가지고 내려 가지고서는 그 드러가는 걸	그게 고기가 물어서 물어가지고 내려 가지고서는 거기 들어가는 걸
설통예 그 설통을네	아 설통예 그 설통을네
그래서 인제 그 그 고기가 인는 사니 그이가 여너 여너 거가 논다	그래서 인제 그 고기가있는 산이 거기가 연어 연어 거기가 논다
여너 형구짜리다 이런데 거게 물만 이씨며는 무리 고긴 무리써야 되쟈뇨	연어 형국자리다이런데 거기에 물만 있으며는 물이 고기는 물 있어야 되잖아요
물만 이씨먼 아주 큰 대지파이 나는데 여 무리 요기 사키로 올러가무는 삼척 대전 삼척무라 정선무리 하패 내려오다가 보먼 새요	물만 있으면 아주 큰 대지팡이 나는데 여기 물이 요기 키로 올라 가며는 삼척 대전 삼척 물이랑 정선 물이 합해 내려오다가 보면 새요
이 드딴 미트로 여 서킬 고읻 이 호면 퉁충가제는 미테 석 고형이 서켜거 데이꺼든	이 덕단 밑으로 여 석회를 이 호면 는 밑에 석 고형이 석회로 돼 있거든
빠지니까 거 가둔지란데두 우거 배짱과이요	빠지니까 거기 가둔지라는 데도 위로는 배짱광이요
병마리 장거러도 정가리라고 여도 무리 업써요	여기도 물이 없어요
여게 올라가는 요게	여기 올라가는 요기에
그래서 배짱광이라고요	아 그래서 백짱광이라고요
거게물만 쏵 언내려가머는 그 여노파란 고기가 노는 형구기다	거기에 물만 쏵 내려가며는 그 연호파란 고기가 노는 형국이다
그 참 조은 자리래요	그 참 좋은 자리래요
그래가주 그게 그 아페 고기 아페 이 논 다 고 아펠 지리메다 묘 쓰고 또 고기 꼬리 요 꼬라니 인는 데 여다 쓰고 등 지리미다 쓰고 그런 그 언젠 그 지가 사대로 얘기 드꼬 건 그른게이쪼	그래가지고 그게 그 앞에 고기 앞에 이 논 다 고 앞에 지느러미에다 묘 쓰고 또 고기꼬리 요 꼬랑지 있는 데 여기다 쓰고 등 지느러미에다 쓰고 그런 그 지가 대로 얘기 듣고 그건 그런 것이 있지요
그리고 여 어우시리라는 데는 어우실 이 고기 어짜라고 고기 어짜 새 우 짜여	그리고 여기어우실이라는 데는 어우실 이 고기자라고 고기자 새 우 자여
어우실 라는 데가 그 그 한문 끄래 쓰는데 그게 으음 장말기 대말기라 대말기꼭 산꼬때기를대말기라 한다고 우리 강원도 말로 대말기	어우실 이라는 데가 그 그 한문 그렇게 쓰는데 그게장말기 대말기라 대말기 꼭 산 꼭대기를 대말기라 한다고 우리 강원도 말로 대말기
네네	네 네
대말기	대말기
산 꼭띠기	산 꼭대기
대말기 대말기	대말기 대말기
그게 올라가며는 그 인제 일본 시대 때 그 피때 피때를 세워꺼드뇨	거기에 올라가면 그 인제일본 시대 때 그 핏대 팻대를 세웠거든요
고 이쓰먼 하튼 요 구끼 세워가지고 멀리 보면 구끼 인제 모 하는교 그 피때라는 그걸 세우머는 인저 그 어우실 저 짜게는 삼척 하장 저 쪼그론 인는게 이 쪼게는 동면 호초니 저 쪼게는백쩐 저 쪼게 여뚠 그런데 그거는 올라가머는 옌날레 조수가 너머떤 마리 바다가 바단무리 너머따고 바다 조개이찌 조개	그거 있으면 하튼 요 국기 세워 가지고 멀리 보면 국기 인제 모 하는거요 그걸 세우며는 인제 그 어우실 저 쪽에는 삼척 하장 저 쪽으로 있는 것이 이 쪽에는 동면 호촌리 저 쪽에는 백전 저 쪽에는  그런데 그거는 올라가며는 옛날에 조수가 넘었던 말이바다가 바닷물이 넘었다고 바다 조개 있지 조개
그 조개가 이써요 조개가 거게가먼	그 조개가 있어요 조개가 거기에 가면
그래요	그래요
조개 그 껍때기가 인	조개 그 껍대기가 인
껍때 껍때기가	껍대 껍대기가
우리 그 내가 거가 인저 한 한 오십 쎄 되는데 저건 한 삼심년 다 되가누구만	우리 그 내가거기가 인제 한 오십 세 되는데 저건 한 삼 십년 다 돼가는구만
시방 그 안 가조	지금은 거기에 안 가죠
그 저네 그 그 나물 저 곤드레 딱 찌기 뜨뜨러 걸 가 댕겨 까불 그런 게 이써따고	그 전에 그 그 나물 저 곤드레 딱지기 뜯으러 그걸 가 다녀  그런 게 있었다고
그래 간다 거기 옌나레 근녀 글 여르메 거기가 옌나레 아주 아주 옌나레  조소 조소가너머가지고서는 거 조 조개 껍때기 따서 완청에 가먼 저 껍때기 이써따고	그래 간다 거기 옛날에 금년  여름에 거기가 옛날에 아주 아주 옛날에 조소 조소가 넘어가지고서는 거 조 조개껍대기 따서 완청에 가면 저 껍대기 있었다고
그럼 그건 조개 껍때기가 이써서 이제 고기 어짜는 알겐는데 새 우 짜는 뭔가요	그럼 그건조개 껍대기가 있어서 이제 고기자는 알겠는데 새 우 자는 원가요
글쎄 새우 짜는 몰러 새우 짜는 새우 짜 쓰는 거는 그건 인제 그 암녀커게 고 미테 그 피때봉 믿 그 미테 어우시란 데가 고리 지퍼요	글쎄 새 우 자는 몰라 새 우 자는 새 우 자 쓰는거는 그건 인제 그  그 밑에 그 핏대 봉 밑 그 밑에 어우실이란 데가 골이 깊어요 아이구 이 초목 초모기 말 시마게 안 드러 아이구 이 초목 초목이 말 심하게 안 들어
옌날 그 하메 시방 마트는 소를 마니 메기 움마게 키워서 소를 마니 메기니까 어우시리라고해 해짜네	옛날에는 그렇게 했는데 지금은 소를 많이 움막에 키워서 소를 많이 먹이니까 어우실이라고 해 했잖아
그럼 그럭 해써	그럼 그렇게 했어
그러며는 기둥지 어우실 또	그러면 기둥지 어우실 또
가둔지 감제	가둥지 감제
감제는 또 몬가요	감제는 또 뭔가요
감제란 얘 긴 그건 잘 모르게씀니다  감제 껀	감제란 얘기는 그건 잘 모르겠습니다  감제그건
왜 그건 껀 요 태백 까는 꼴 사목 까는 데거 지비 한 대찝 사란는데 그 철걸 해써요	왜 그건 요 태백 가는 골 사목 가는데거 집이 한 대 집 살았는데 그 철거를 했어요
그 호촌니 우리 지역 우리 우리 과놔리거든 여 한 일키로 한 오백 까머는 우카외찰대로 페난데로 거기 지금또 거 집터도 지금 다 이씨요	그 호촌리 우리 지역 우리 관활이거든 여기서한 키로 한  가며는   거기 지금 또 거기 집터도 지금 다 있어요
지금 터도 이써요	아 지금 터도 있어요
그 다으메 또 감제하고 또 아까 하나 하나	그 다음에 또 감제하고 또 아까 하나 하나
그 다메 요 이 동목쩨	그 다음에 요 이 동목제
동목쩨는	아 동목제는
똥목쩨는그기 목쌍도 목쌍도목쌍도 짜 이꼬 그 요 도 짜를 쓰는데	동목제는그게 목상도 목상도목상도 자 있고 그 도 자를 쓰는데
동 동모기며는 건 복쑹아는 도 짜자나요	동 동목이면 그건 복숭아는 도 자 잖아요
보쑹 도짜 쓸리를 동목쩨로 보고 섬 도짜하고 목 짜를 나무 목 짜	복숭 도 자 쓰기를 동목제로 보고 섬 도 자 하고 목 자를 나무 목 자
아복쑹아 복쑹아 도 짜에 나무 목짜요	아 복숭아 복숭아 도 자에 나무 목 자요
그러니까 그르니까 그 유래는 그냥 동목쩨라 그 옌나레 그 머 그 참 복쑹아가 마니 키원나 칼  마이 시먼나 우리 그거만 알지 모	그러니까 그러니까 그 유래는 그냥 동목제라 그 옛날에 그뭐 그 참 복숭아를 많이 키웠나 많이 심었나 우리 그것만 알지 뭐
그러며는 이 마을 뿐드른 주로 어떤 이를 하면서 사라가심니까	그러면 이 마을 분들은 주로어떤 일을 하면서 살아가십니까
지금뇨 혀내 혀내 나도 농사지요	지금요 현재 현재 나도 농사지요
어떤 농사를 지으	어떤 농사를 지으세요
시방 그 지금 옌날 이런 농사 하는 거 지쪼	시방 그 지금 옛날 이런 농사 하는 것 짓죠
그 대마는 인제 안 갈고 대마 삼 그거는 인제 매 사다 틀며 쉬워 고 다음 모 콩 팓 그 오곡 다 하지요	그 대마는 인제 안 갈고 대마 삼 그거는 인제  사다 틀며  고 다음 뭐 콩 팥그 오곡 다 하지요
요 옥쑤수 안 캐요 강냉이나 옥쑤수 머 이런 거 쫌 대충하고 고 다으메 그 요줌 그마이하는 거는 야채 배추 고랭지 배추를 마니 벼 여게	요 옥수수 안 캐요 강냉이나 옥수수 뭐이런 거 좀 대충하고 그 다음에 그 요즘 그 많이 하는 거는 야채 배추 고랭지 배추를 많이벼 여기에
그래요	그래요
응 그럼	응 그럼
꼬추 꼬추 잘 돼요	고추 고추 잘 돼요
고아주	
어르신 말해 주실 때 그냥 이 쪼게서 쓰는 말 인제 그 표준말 말고 이 쪼게서 시 쓰시는 말그러케 그냥 해 주시면 돼요	어르신 말해 주실 때 그냥 이 쪽에서 쓰는 말 인제 그 표준말 말고 이 쪽에서 쓰시는 말 그렇게 그냥 해 주시면 돼요
그래 그래 나 지금 여 여기 말 그대로 하는 거요	그래 그래 나 지금 여 여기 말 그대로 하는 거요
네 네 그대로 해 주시는 거	네 네 그대로 해 주시는 거
그러며는 이 마으리 가지고 인는 머 자랑꺼리가 이씀니까	그러면 이 마을이 가지고 있는 뭐자랑거리가 있습니까
이 마으리 자랑 꺼리	이 마을의 자랑 거리
자랑 꺼리는 뭐 배꼳 배루 꺼버지버 인지니 인심 좀 조은 자랑꺼리 이쪼	자랑거리는 뭐    인심 좀 좋은 자랑거리 있죠
그래요	아 그래요
인시믄 조초	인심은 좋지요
왜나며는 그 도시와 달라서 노 농촌듀 그 농사는 잘 지며는 풍년 잘 지며는 서로 음석 내가좀 나눠 머꼬 서로 서로를 논 머꼬 서로 그 제 지방 지방 찌리 이욷 이우찌리 서로가 우애가돈도카지요	왜냐면 그 도시와 달라서 노 농촌도 그 농사는 잘 지며는 풍년 잘 지며는 서로 음식 내가 좀 나눠 먹고 서로 서로를 나누어 먹고 서로 그 제 지방 지방 끼리 이웃 이웃끼리 서로가 우애가 돈독하지요
서로 음서아 입쏘기 귀처니라구 뭐 사라미 머이들 멍는데 인제 인정이 가고 가거드뇨	서로음식이 입속이 귀천이라고 뭐 사람이 무엇을 먹는데 인제 인정이 가고 가거든요
이 멍는 모 음서글 좀 해가지고 거러 논 거 머꾸 뜨거라	이 먹는 뭐 음식을 좀 해가지고걸어 놓은 거 먹고 뜨거라
와섣 마껄리 한 잔 해 가지고서는 선는건목 크다고 예따 음석 꺼뜰 해 두는 거 머꼬 제사지내문 우리 지베 오시오 저 지베 오시오 해서 가서 가치 노너 머꼬 또 그 서로에 미를 농사  이레 좀 부조카며는 가치 이러케 거드려 주고 가치 거드려 주고 그 하면 인심 조치요 모 그도	와서 막걸리 한 잔 해 가지고서는  크다고 옛다 음식 해 두는 거 먹고 제사 지내면 우리 집에 오시오 저의 집에 오시오 해서 가서 같이 나누어 먹고 또 그 서로의 밀을 농사 일에 콤 부족하며는 같이 이렇케 거들어 주고 같이 거들어 주고 그렇게 하면 인심 좋지요 뭐 그도녜 알게씀니다녜 알겠습니다
그러며는 그	그러면 그
하라번님 그 성하미 어떠케 되세요	할아버님 그 성함이 어떻게 되세요
고재식고재식	고재식 고재식
노풀고짜이쓸재짜시물식짜	높을 고 자에 있을 재 자 심을 식 자
노플 고짜에	아 높을 고 자에
이쓸 재	있을 재
이쓸 재짜에	있을 재 자에
시물 식	심을 식
시물 식짜요 네	심을 식 자요 네
하라번님 여기 그 장소는 주소는 어떠케 되나요 주소	어 할아버님 여기 그 장소는 주소는 어떻게 되나요 주소
주소 강원도 정 정선군 화암면 호촌니 사반 이구팔번지	주소 강원도 정 정선군 화암면 호촌리 반 번지
사척호촌니	사척호천니
호촌니 사반 이구팔번지	호천리 사반 이구팔번지
이구팔번지요 네	이구팔번지요 네
그 다으메 그 어르신 그 연세는 어떠케 됨니까	그 다음에 그 어르신 그 연세는 어떻게 됩니까
갑쑬생	갑술생
갑쑬생	예 갑술생
여덜 칠씸여덜	여덜 칠십여덜
그러면 어르신 지금 여기가 호촌니자나요	그러면 어르신 지금 여기가 호촌리잖아요
그 호촌닌데 그니까 어르시네 어르신 여기서 인제 어르신까지해서 한 며때쯤 되세여	그 호촌린데 그니까 어르신의 어르신 여기서 인제 어르신까지해서 한 몇 대쯤 되세요
여게엔 팔때	여기에는 팔 대
팔 때요	아 팔 대요
금 어르신 그 아번니미나 하라버니믄 그 호초네서 게속 사셔떤 거	그럼 어르신그 아버님이나 할아버님은 그 호촌에서 계속 사셨던 거에요
직쩌니 직쩐 여서 사키로 여 산 우짜기로 직쩌니라고 여 여 이키로로 가먼 오리야	직전리직전 여기서  산 위쪽으로 직전리라고 여 여 로 가면 오 리야
오 리정도에 직쩐니에서 사시고 어르시는 그럼 여기 호초는 언제 오셔써요	아 오 리 정도에 직전리에서 사시고 어르신은 그럼 여기 호촌은 언제 오셨어요
여게 온제가 한 오심년	여기 온 지가 한 오십 년
그래요 그름 어르시네 아버님 하라버니믄 어떤 이를 하션나요	아 그래요 그럼 어르신의아버님 할아버님은 어떤 일을 하셨나요
우리 아버님 하라버니믄 그 농사 로 지꼬 농사일 하셔찌	우리 아버님 할아버님은 그 농사를짓고 농사일 하셨지
그리고 어르시는 그럼 어떤 이를 하션나요	그리고 어르신은 그럼 어떤 일을 하셨나요
내 일쌩이요	내 일생이요
네 네	네 네
나도 농사 지쪼	나도 농사 짓죠
어떤 농사 지으셔써여	아 어떤 농사를 지으셨어요
저는 머이 거 농사도 막 여러가지 제써요	저는 뭐 거 농사도 막 여러가지 지었어요
처메 하꾜 조리파고는 초등하꾜 조러파고는 그 농사좀 지따가 그 목쌍사어비라고 나무 나무장사 그거또 며태하고 에 쪼끔 목 또 이러케 추라 자꼬글 뫄가지고 인제 교환하는 거 하고 사업게통으로 한 이심년 하고 그 다메 또	처음에 학교를 졸업하고는 초등학교 졸업하고는 그 농사 좀 짓다가 그 목상 사업이라고 나무 나무 장사 그것도 몇 해 하고 에 조금 목 또 이렇게 출하 잡곡을 모아 가지고 인제 교환하는 거 하고 사업계통으로 한 이십 년 하고 그 다음에 또
사어블 어턱 어디서 하셔써여	사업을 어디서 하셨어요
여 여게서 해쪼 요 마으레서	여 여기서 했죠 이 마을에서
이 마으레서	아 이 마을에서
그럼 어르신	그럼 어르신
태백 태백 황지 광산 그겓 그 탕광 이 첨 개시될쩌게 그 갱목 마이 하자내요	태백 태백황지 광산 거기에 그 탄광 이 처음 개시될 적에 그 갱목을 많이 하잖아요
그럴쩌게 요 개인산 사가주구서는 거 낙 가따 납품하고	그럴 적에 이 개인 산 사 가지고서는갖다 납품하고
그런닐 하션네요	아 그런 일 하셨네요
그런 그런 일 하시고 또 요 작꼭 사가지구 저 제천 내보내 지무는 제천서 쌀 드러오고 요 요콩강내이 옥쑤수를 가따가 마커 교환해디리고	그런 그런 일 하시고 또 이 잡곡 사가지고 저 제천 내보내지며는 제천에서 쌀 들어오고 요 콩강냉이 옥수수를 갖다가 모두 교환해 들이고
그런 사업 하다가 고다메 또 한 이심년 하다가는 또 농사 대드러서 농사는 처나지대보니라 농사를 제보니 또펴나거든 사시른	그런 사업하다가 그 다음에 또 한 이십 년 하다가는 또 농사 대들어서 농사는 천하지대본이라 농사를 지어 보니 또 편하거든 사실은
그래요 농사를 어릴 때도 지꼬 잠깐 사어블 하다가	아 그래요 농사를 어릴 때도 짓고잠깐 사업을 하다가
시방도 아이 시방도 좀 제요 시방도 꼬추 두말 캐고	지금도 아니 지금도 좀 지어요 지금도고추 두 말 캐고
그러며는 어르신 그 객찌 생화른 어떠케 하션나요	그러면은 어르신 그 객지 생활은 어떻게하셨나요
객찌 생화른 제가 그리 마니 아내찌요	객지 생활은 제가 그리 많이 안 했지요
그 일본시대 때 이항년 하꾜 댕기다가 해방되고 고 다메 그 광사니 저 삼척 도게 광산도 그럴쩌게 그때는 우리가 살기가 상다이 곤궁해가지고서는 내가 그 야간중하꾜는 인제 댕게써요	그 일본시대 때 이 학년 학교 다니다가 해방되고 그 다음에 그 광산이 저 삼척 도계 광산도 그럴 적에 그때는 우리가 살기가 상당히 곤궁해 가지고서는 내가 그 야간 중학교 하는데 다녔어요
나즈론 심부름 하고 일하고 그날 바무로 좀 댕기고 그러케 일쯕 글좀 배워가지고 현재까지 내가 흠 글에 포구니저가지고 농사 지으면서 또 어떤 이러케 제가 이러케 멀 댕기면서 조흔 그이르 이 저 모래가 이씨머는 거기 안저서 소늘 문대가지고 거기 그를 이러케 소느로 쓰고 그래한문도 서당빵에 앙가고 천자를 하루에 넉짜씩 내가 자동으로 해서 배워 배워 가지고 현재까지도 내가 그 그를 좀 쓰고 이씸다	낮엔 심부름 하고 일하고 그날 밤으로 좀 다니고 그렇게 일찍글 좀 배워가지고 현재까지 내가 흠 글에 폭운이 져 가지고 농사를 지으면서 또 어떤 이렇게 제가 이렇게 뭘 다니면서 좋은 그 이 저 모래가 있으면 거기 앉아서 손을 문대 가지고 거기 글을이렇게 손으로 쓰고 그래 한문도 서당 방에 안 가고 천자를 하루에 넉 자씩 내가 자동으로 해서배워 배워 가지고 현재까지도 내가 글 글을 좀 쓰고 있습니다
쓰고 저거 저거또 내가 제가 쓰고	쓰고 저거 저것도 내가 제가 쓰고
네 네	네 네
그래 제 자 자동으로 해서 제날까지 내 그 개명 서명 하구 그 여러가지 그 지반 족뽀 가튼 거내가 존소글 으 지케 나가고 그르지	그래 자동으로 해서 제 날까지 내 그 개명 서명 하고 그여러가지 그 집안 족보 같은 거 내가 존속을 지켜 나가고 그러지
그럼 어르신 항녀근 그러면 초등학꾜	그럼 어르신 학력은 그러면 초등학교
초등학꾜	초등학교 예
조러블 일 일 일본시대 때	졸업을 일본시대 때
하고 해방 해방 후에 선동학꾜초등학꾜 유캉년 조러파고	하고 해방 해방 후에 선동학교 요 초등학교 육학년 졸업하고
그러셔써요	아 그러셨어요
그러며는 어르신 고러케 객찌 생활한 게 아까 그러케 저기 도게 얼마나 생활하셔써여	그러면은 어르신 그렇게 객지 생활한 게 아까 그렇게 저기 도계 얼마나 생활하셨어요
거게 한 이연 이써찌요	거기에 한 이 년 있었죠
이년 이꼬 그 다으메 군생화른 안 하션나여	이 년 있고 그 다음에 군 생활은 안 하셨나요
구네는 앙가쪼	군에는 안 갔죠
구네는 왜냐하므는 그때 그 우리는 그 소집 정지베 걸레가지고 신체검사가해써도 거 인제그 갑쫑 을쫑 병종 이래 병종은 앙가꺼든뇨	군에는 왜냐하면은 그때 그 우리는 그 소집 정집에걸려 가지고 신체검사를 했어도 거 인제 그 갑종 을종 병종 이렇게 병종은 안 갔거든요
그 병종으로 안 따고서는 그양 요 민방위로 떠러지고 마라쪼	그 병종을 안 따고서는 그냥 요민방위로 떨어지고 말았죠
그러면 게속 여기 그냥 정선에서	아 그러면 계속 여기 그냥 정선에서
정선 그래 정서니에요 이 정선 하라버지 그 강능서 올러오센는데 입쩡 하라버지가 저한테그 입쩡선 셰조 고 하라버지가 십칠때 하라버지가 강능서 이 보따리 질머지고 정선에 와서 정차글 해딴 마리요	아 정선 그래 정서그렇죠 정선이에요 이 정선 할아버지 그 강릉에서 올라오셨는데 입정선 할아버지가 저한테 그 입정선 세조 그 할아버지가 십칠 대 할아버지가 강릉에서이 보따리 짊어지고 정선에 와서 정착을 했단 말이요
입쩡 하라번니미	입정 할아버님이
정차글 해가지고 거개 인제 일때버텀 현재까지 이 제 제한테는 칠십 어어 십칠때소느로 제가  지금 마꼬 이씀미다	정착을 해 가지고 거기 인제 일 대부터 현재까지 이 제 저한테는 칠십 어어 십칠 대 손으로 제가 지금 맡고 있습니다
그래깐두루 오뱅 삼심년 우리 역싸지요	그러니까 오백삼십 년 우리 역사지요
와대단하시네요	와예 대단하시네요
어르신 혹씨나 어르신 그그 태어나신 고시 아까 얘기해떤	어르신 혹시나 어르신 그 그 태어나신 곳이 아까 얘기했던
직쩐니	직전리
직쩐니자나요	직전리잖아요
거기서 인제 어르신 대대로 쭉 사라오셛쩌	거기서 인제 어르신 대대로 쭉 살아오셨져
그 우리 파 우리 증조 하라버지가 팔형제 나써씀니다	그 우리 파 우리 증조 할아버지가 팔형제 났었습니다
팔 형제요	팔 형제요
우리 증조 하라버지가 팔형제	우리 증조 할아버지가 팔 형제
우리 하라버지 형제가 오형제	우리 할아버지 형제가 오 형제
그 팔 형제 소니 얼마나 마네요	그 팔 형제 손이 얼마나 많아요
동거제 팔촌 함무리에 팔촌 육촌 시베촌 나가는데	동거제 팔촌 한 무리에 팔촌 육촌 십여촌 나가는데
아그러시구나	아그러시구나
정선서 정선 알지 정선	정선에서 정선 알지 정선
정선 하라버지가 정선 오셔가지구 거겓 그러니까 구 대 마네 구 대 손 손 상 짜 명 짜 하라버지가 나한테 팔 때 하라버지가 보따리 걸머지고 삼 정차글 해가지고 거게서 인제 쫑 내려 오셔 가지고서 삼 대를 또 독씨늘 아들 요 아들 삼대를 데리고 와 가지고 우리 고조 하라버지가팔 형제를 나따 팔 형제	정선 할아버지가 정선 오셔가지고 거기에 그러니까 구 대 만에 구 대손 손 상 자 명 자 할아버지가 나한테 팔 대 할아버지가 보따리 걸머지고 삼 정착을 해가지고 거기에서 인제 쪽 내려 오셔 가지고서 삼 대를 또 독신을 아들 요 아들 삼 대를 데리고 와가지고 우리 고조 할아버지가 팔 형제를 났다 팔 형제 대 우리 팔 팔 자손 형 거 내가 고 인저 곧 고게 그 감재 오씨게 날 때 내가 출생지 그거래요 대 우리 팔 팔 자손 형 거 내가 인제 거기에 그 감자 옥수수 날 때 내가 출생지 그거래요
내가 내 그 호가 옥처니미라구	내가 내 그 호가 옥천임이라고
구슬 옥 짜 옥씨리라고 또 고 여펟 새물추리라고 샘난다고 새물추리 그래서 내 요 요 이기내 옥천 이리 여게	구슬 옥 자 옥실이라고 또 거기 옆에 새물추리라고 샘 난다고 새물추리그래서 내 요 요 이게 내 옥천
옥천샘물 샘무리 난다고요	옥천샘물 샘물이 난다고요
그래서 그 내 내 호를 그러케 지어나써요 내가	그래서 그 내 내 호를 그렇게 지어놨어요내가
어르시는 여기서 그 지블 지블 제 보셔써요 집	어르시는 여기서 그 집을 집을 지어 보셨어요 집
음음 이거 여 이짜내	음음 이거 여기 있잖아
혼자 아니 그 옌나레	혼자 아니 그 옛날에
내소느로	내 손으로
소느로 지블	예 손으로 집을
소느로 안 제바써	손으로 안 지어 봤어
그래요 그럼	아 그래요 그럼
옌나레 여기는 그 절기에 따라서 세시풍소까튼 게 이써짜나요	옛날에 여기는 그 절기에 따라서 세시풍속 같은 것이 있었잖아요
근데 보통 절기에 따라서 어떤니를 핸는지를 좀 알고시픈데 응 정워레는 주로 뭘하면서 노라써요 정워레는	그런데 보통 절기에 따라서 어떤 일을 했는지를 좀 알고 싶은데 응 정월에는 주로 뭘 하면서 놀았어요 정월에는
농 이 농 이런 농초네는 머 겨우레 저월 음녁쩌월 거진 놀지 저 그 저 겨우레는 정월 딸저레는 시비뤌 시비월 드러가먼 거 새끼 장석쌔끼 어제 바짜내 저 근네 그 메주가주 꼰능거 그느믈 처서 꼬아가주고 방바이 그때는 그 자리를 그 새끼자리를 매 까라꺼든	농 이 농 이런농촌에는 뭐 겨울에 정월 음력 정월에 거의 놀지 저 그 저 겨울에는 정월 달 절에는 월 월 들어가면 새끼 장석 새끼 어제 봤잖아 저 건네 그 메주 가지고 꼬는 것 그놈을 쳐서 꼬아가지고 방방이 그때는 그 자리를 그 새끼 자리를 매어 깔았거든
새끼자리를료	새끼 자리를요
그 꼬고 꽈가주고 자 자리매고 또 부두자리 부두자리라능건 이 부들 이써	어 그 꼬고꽈서 자리 매고 또 부드자리 부드자리라는 건 이 부들 있어
구드리 노네선 농까에선 그 크는데 크먼 끄걸 가주선 부터 잘 인제 매고 거 이 또 하라버지 나마이네 요 꼬고 뭐그 그르매고 아처구로 이때 이 막 이 때먼 가 소주 소주 끼리서 소굴째 여무리라고  여물 소 주굴 여무리라 한다고 여물	소 죽을 여물이라 한다고 여물
여물 이 퍼 매기고 그 딴새문 또 식싸하고 고다메 소 인젠 마 마작 마우에 끄는 마자기 바께내며는 걸 마자기라고 한다고 마장 마장 마장에 내 매고 또 올 겨우레는 해가 짜르거든 시가니 업짜뇨 그럼 또 나제다 이 뭐 자리매 업꼬 그 겨우레도 요 잘 이 장석짜리 뭐이 이 꽈매고 이러먼종꾹  요 또 꼬다가 시름 고만 두고또 꼬고 매고 인제 그기 장석짜리 하루씩 일 매 자먼 일뭐 이틀 구든 사람 한 닫 안 대 여쌔 이러케 매고 이럴때며 거기 인제 겨울 겨우레는 소 일꺼리지 시방은 모 그렁 게 하나꺼두 업쓰니까 나도 이리 안자 까기 저네 업씨니까 쉬지만 뭐 이게 써모 병워네 가서 여기 고스돕또 치고 유또 치고 시바는 그래 시골 보내조 옌나레는 그걸 가지고 옌나레는 그 화토라능 건 돈따 머꼬 할 쩌게 그 투정이랑 게 이찌 그 외에는 업써꺼등 그릉기 옌날 안 조아 보통 이제 정워리 되며는 정워레 인제 하루가 고로케 가자나요	보통 이제 정월이 되면 정월에 이제 하루가 그렇게 가잖아요
그러며는 보통 메 씨 옌나레는 메 씨 이러나씀니까 보통	그러면 보통 몇 씨 옛날에는 몇씨에 일어났습니까 보통
옌나레도 이땜 다 인나지	옛날에도 이때가 되면 다 일어나지
일 때무네 일곱 마냐게 뭐 그 전날 뭐 겨우레도 된니를 해따던지 또 술 천 마니 머거따던지그래먼 뭐 아침 일고 여덜 씨 때 인나든지 그러치마는 보통에 인제 보며는 여서 씨먼 그 가정농사 농가찌븐 여서 씨면 다 인나가 소 죽 소주 끄려 소는 그때 다 이써 그 집찌마덤	일 때문  에 일곱 만약에 뭐 그 전날 뭐 겨울이래도 된 일을 했다든지 또 술을 엄청 마니 먹었다든지 그러면 뭐 아침 일곱 여덜 씨 때 일어나든지 그렇지마는 보통에 이제 보면 여섯 씨면 그 가정 농사 농가집은 여섯 씨면 다 일어나 소 죽 소죽 끓여 소는 그때 다 있어 그 집집마다
다 이꼬 할머니 할머니네는 바메 물레 이 삼 삼짜내요 요 대마	다 있고 할머니 할머니네는밤에 물레 이 삼을 삼자네요 이 대마
이거 인제 이케 삼따가 아이 열뚜씨 까지 사믄 다 이꼬 고 어데 고 다음여덜 열한 시까지 사믈 때도 이꼬 뭐 열 뚜 씨 반까지 사믈 때 이꼬 그램 주무시따가 또 이때 인나가지고 또이래 상꼬 다 사므문 이 물레 저처네 물레	이거 이제 이렇게 삼다가 아이 열두 시 까지 삼은 다 잇고 그 어디 그 다음여덟 열한 시까지 심을 때도 있고 뭐 열두 시 반까지 삼을 때있고 그럼 주무셨다가 또 이때 일어 나가지고 또 이렇게 삼꼬 다 삼으면 이 물레 저처네 물레
그 이 때 함 인나가지고 물레 더렁더렁더렁덩 짜가지고	그 이때 한 번 일어나 가지고 물레더렁더렁더렁덩 짜가지고
아치메 일찍 이러나써요	아침에 일찍 일어났어요
그럼	어 그럼
밥 해야 되자나	밥을 해야 되잖아
그래 이제 시방 이때 해 가주고 여섣 씨 안 쉐자네 일곱 씨 되니 쉐자네	어 그래 이제지금 이때 해 가지고 여섯 시  안 쇠잖아 일곱 시 되니 쇠잖아
일곱 씨쯔미요	일곱 시 쯤이요
그래이머는 그 남자는 소주 끼리여 호조글 먼저끼리 퍼주지	그러면 그 남자는 소죽을 끓여서호족을 먼저끼리 퍼주지
제일 먼저 하능 게 그거네요	제일 먼저 하는 게 그거네요
소주 그래 고 다메 인제 소주 끄리고 소주 끄리나 부어케 큰 부억 가매 소테 무를 처서 앙까메다가 가따 주며는 거기에 불 너 가지고서는 인제 거 조반 조반 식싸하고 그래치	소주 그래그 다음에 이제 소죽 끓이고 소죽 끓이나 부엌에 큰 부엌 가마니 솥에 물을 처서 안감에다가 갔다 주면 거기에 불을 넣어 가지고서는 이제 그 조반 조반 식사하고 그렇지
그래요	아 그래요
그래니까 소가 마삐 춥따고	그러니까 소가  춥다고
이 찍쑤 뜨심 물 머거라	이 직수 뜨신 물 먹어라
이런 이런 의미로 소주기 소죽 퍼서 소가 인제 머거써 시자캐 머그머는 사라믄 인제 사람 밥쏘세 바블 진능거야 진는다	이런 이런 의미로 소죽이 소죽을 퍼서 소가 이제 먹어써 시작해 머그면 사람은 이제 사람 밥솥에 밥을 짓는 거야 짓는다
여따 바블 인제 하능 거이지 바블 진는다 이래지	여기에다 밥을 이제 하는 것이지 밥을 짓는다 이러지
네 소죽 끄려서 인제 소죽 주고	네 소죽 끓여서 이제 소죽 주고
주고 남잔 주고 그 물로 그 부릐 잉거리 부를 처서 소테다가 너어가주 소테 뿌를 그 타며는그 아주머네가 소테다 밥싸를 이러 너어서 바블 시자칸다	주고 남자는 주고 그 물로 그 불의잉거리 불을 처서 솥에다가 넣어 가지고 솥에 부를 그 타면 그 아저머니네가 솥에다가 밥쌀을일어 넣어서 밥을 시작한다
이러케 이제 바블 해 하고 나며는 바블 바블 할 똥안 남자는 뭐하나요	음 이렇게 이제바블 해 하고 나면 밥을 밥을 할 동안 남자는 뭐하나요
남잔 또 이 뭐 저 바께 모 시껴네 가서 마리야 뭐 대게 춥찌 안하먼 채리고 가서 또 나무 쪼개고 또 드러와서 또 모짜리 좀 매고 고담 필싸 도라오는 며네 식싸하능게 가치면 여덜 씨 여덜씨 반 겨우레 느께 먹찌	남자는 또 이 뭐 저 밖에 뭐 식견에 가서 말이야 뭐 대게 춥지 않으면  채리고 가서 또 나무 쪼개고 또 들어와서 또 못자리 좀 매고 그 다음    식사를 같이 하면  시 시 반 겨울에 늦게 먹지
인제 아침 식싸를 하고 나며는 이제 겨우리 되면 그래도 쫌 이제 해가 뜨자나요	이제 아침식사를 하고 나면 이제 겨울이 되면 그래도 좀 이제 해가 뜨잖아요
그럼 그 다으메는 뭐하나요	그럼 그 다음에는 뭐 하나요
겨우레 그닥 그에 뭐 인제 그	겨울에 그닥 그에 뭐 이제 그
아까 얘기 해떵 거처럼 계속 자리 매고	아까 얘기 했던 거 처럼 계속 자리 매고
매고 이제 그다 그거또 뭐 언제 어제 뭐 정월 되면 하능 게 아니고 하먼 십이뤌 시비월 드러가면 일찍 새끼 좀 매가지고 이뤌 딸 다 매치우머는 고담 부터능 그냥 놀지 모	매고 이제 그다 그것도 뭐 언제 어제 뭐 정월 되면 하는 게 아니고 하면 월 월 들어가면 일찍 새끼 좀매가지고 월 달 다 매서 치우면 그담 부터는 그냥 놀지 뭐
오저네는 오저네두	오전에는 오전에도
오저니고 오후고 그담 이우제 서로 놀러 가 가주고 이우지 가서 인제 옌날 얘기두 재무로 하고 나즈로도 뭐 서로 인제 사라간 얘기도 하고 그건 그러 놀다가 지부로 오구	오전이고 오후고 그 다음 이웃에 서로 놀러 가 가지고 이웃에 가서 이제 옛날 얘기도 재미로 하고 낮에도 뭐서로 이제 살아간 얘기도 하고 그건 그렇게 놀다가 집으로 오고
겨우레 한창 인저 그러요 노지	겨울에 한창 이제 그래요 놀지
놀다가 보메 인지 그 사월 십오일 경이며는 싱목 싱모기린 싱목 뭐 사네 가 인제 싱모카고뭐 고 다메 청명한시기 사월 오이리 청명한시기 아니여	놀다가 봄에 인제 그 월 일 경이면 식목 식목일인 식목 뭐 산에 가 이제 식목하고 뭐 그 담에 청명한식이 월 일이 청명한식이 아니야
그래이머는 우리 조상드리 인는 묘 산소 어디 이장을 한다 다시 딴 데 모신다 그래먼 그런그날 가서 그거 하고	그러면 우리 조상들이 있는 묘 산소 어디 이장을 한다 다시 다른 데에모신다 그러면 그런 그날 가서 그거 하고
왜 그날 모심니까	왜 그날 모십니까
우리 인제 그 가마써봐 오일 라른 그 공명이리여	우리 이제 그 가만히 있어 봐 일 날은그 공명일이요
공명이리 마는 일련 삼백 육씹 오이레 최고에 조은 나리다	공명일이 많은 일년 일에 최고의 좋은 날이다
응 거 인제 조상에 뼤고리라든지 이러케 이러케 이 모시고 댕겨도 무해무드미다	응 그 이제조상에 뼈골이라든지 이렇게 이렇게 이 모시고 다녀도 무해무득이다
무해무등 아무 지장이 업따	아 무해무득 아무 지장이 없다
그런 의미고	그런 의미고
또 싱모기른 낭가라 신 여게 가 싱꼬또 뭐 여러 찝 그러케 하고	또 식목일은 나무 가지고가 신 여기에 가서 심고 또 뭐 여러 집이 그렇게 하고
어떤 낭구를 시먼나	어떤 나무를 심었나
나무 모 뭐 옌나레도 그 뭐 조은 마래기는 모 그 무궁화를 가따가 싱꾸 어데에 가따 산소까 씸는 다든지 매마다 가 심는 다든지 또 보자먼 또 그 조은 마리 모 짠나무 가틍 거 무하능 거멛 꾸루 가따가 일 시꼬 또	나무 뭐 뭐 옛날에도 그 뭐 좋은 마래기는 뭐 그 무궁화  를 갔다가 심고 어디에 갔다 산소 가에다 심는 다든지 매마다 가에 심는 다든지 또 보자면 또그 좋은 마리 뭐 잣나무 같은 거 뭐 하는 거 몇 구루 갔다가 이렇게 싣고 또
무슨 장사요	무슨 장사요
잉여짱사	잉여장사
잉여장사	아 잉여장사
요거를 다시 가따 앵겨 하능 거 잉여짱사라고	이거를 다시 갖다가 옮기는 거 잉여장사라고
그래노코 이거또 그 집 그 집 까서 하루 가서 친정에를 가서 그럼 아주 귀처네 잉묘가 또 묘로 시방은 코푸레미 파지마는 사 사라미 가서 호미 광이로 사부로 전소가 이 이런 큰 봉구늘헤쳐가주 거 다 이래가주 거게 또 거 뻬고를 수지패가지고 그 다 해서 인제 또 이쪼그로 와서어 청마리라 하지	그렇게 놓고 이것도 그 집 그 집 가서 하루 가서 친정을 가서 그럼 아주귀찮어 잉묘가 또 묘로 지금은 포크레인이 파지만 사 사람이 가서 호미 광이로 삽으로 전소가이 이런 큰 봉군을 헤쳐 가지고 그거 다 이래 가지고 거기에 또 그 뼈골을 수집 해 가지고 그다 해서 이제 또 이쪽으로 와서청말이라 하지
재워 논는데 청광을 해가조 또 묘 이쓰면 진저인제 사라미 요리 이쓰면 우리 동생 모여 가주고 그러케 하지 인제 그걸 잉여 장사를 치는 거지	재워 놓는데 청광을 해 가지고 또 묘가 있으면 진저인데 사람이 이렇게 있으면 우리 동생 모여 가지고 그렇게 하지 이제 그걸 잉여 장사를치는 거지
청명인는 안크러지	청명 있는 안 그러지
그러케 인제 그 때가 되면 인제 그러케 하고 고 다메 인지 이참 한시게 지내며는 전소가 땅이 다 노꼬 고 다메 인제 대마 삼그거 인제 그래서 사믈 파종하지 시방	그렇게 이제 그때가 되면 이제 그렇게 하고 그 다음에 이 참 한식에 지내며는 전소가 땅이 다 녹고 그 다음에이제 대마 삼 응 그거 이제 그래서 삼을 파종하지 시방
시방은 파종 하능데 옌나른 사믈 푼다 그론다구	지금은 파종을 하는데 옛날은 심을 푼다 그런다고
그담 소를 가주 갈고	그 다음 소를 가지고 갈고
삼을 푼다고요	삼을 푼다고요
푼다고	푼다고
그게 무슨 마리에요	그게 무슨 말이에요
그 파종이 시방은 파종한다	그 파종이 시방은 파종한다
땅에 인능 걸 파종한다 해 옌나렌 삼 푼다 이래써요 그걸	땅에 있는 거를 파종한다 해 옛날엔 삼 푼다 이랬어요 그걸
사믈 푼다	삼을 푼다
땅 파능 거를	아 땅 파는 거를
사믈 푼다 이래써요	어 삼을 푼다 이랬어요
옌날 우리 그거 마른 삼 오늘 삼 푼다	옛날 우리 그거 말은 삼 오늘 삼푼다
땅이 마니 노가 쓰니까 땅갱 노 노가쓰니까 땅을 함 번	땅이 많이 녹아 쓰니까  노녹았으니까 땅을 한 번
가라 어퍼 가주고 인저	갈아 엎어 가지고 인제
가라 엄능 거네요	갈아 엎는 거네요
그래 가라 어퍼 가주고 인제 씨를 파종 하능 걸 사믈 푼다 그래따고	그래 갈 엎어 가지고 이제 씨를 파종 하는 걸 삼을 푼다 그랬다고
가리하는 얘기까	갈이하는 얘기가
그거는 삼 그거는 삼 대마를 파종 그 고려 때 해떤 실라 때 해떤 그때 그 풀면서 파종을 하면서 시작 얘기가 푼다 이러케 내려옹 거요	그거는 삼 그거는 삼 대마를 파종 그 고려 때 했던 신라 때 했던 그때 그 풀면서 파종을 하면서 시작한 얘기가 푼다 이렇게 내려온 거에요
그러케 인제 그러다 보머는 받 끄 그거또  하다 보머는 인제 또 감자 감자 또 싱꼬 또감자 시문 다으메는 또 봄보리 봄보리 갈고 또 모 귀리 갈고 고 담 옥쑤수 갈고 조이 콩당콩 당콩이랑 게 이써 당콩	그렇게 이제 그러다 보면 밭 그  그것도  하다 보면 이제 또감자 감자 또 심고 또 감자 심은 다음에는 또 봄보리 봄보리 갈고 또 뭐 귀리 갈고 그 다음에옥수수 갈고 조 콩 당콩 당콩이란 것이 있어 당콩
뭐 적뚜 팥 그렁거지	뭐 적두 팥 그런거지
어이 가지 가지 수이 연차저그로 쭉 하며는 으 최고 느께까지 하능 거시 망종까지 해 망종	이 가지 가지 수가 연차적으로 쭉 하면 최고 늦게 까지 하는 것이 망종까지 해 망종
소 그 인제 입 그 하고 뭐이야	소 그 인제 입 그 하고 뭐야
저 한식 고 다메 이파 소만 망종 으 뭐 저로 완 버름 만큼 시골 막 들자네	저 한식 그 다음에 입하 소만 망종 으 뭐 저로  벌은 만큼 시골로 막 들어오잖아
그래먼 개인저그로 한 달반 달반 또 한 두어 달 거이 뭐시끼라 하지	그러면 개인 적으로한 달 반 달반 또 한 두어 달 거의 뭣이라 하지
파종을 하지	파종을 하지
농사를	농사를
끈나먼 또 하먼 또 먼저 가릉 건 사미 막 이만씩 올러 오자네요	끝나면 또 하면 또 먼저 갈은 것은 삼이 막 이만큼씩 올라 오잖아요
대마가 오라오먼 또 함 마리 삼 매야지	대마가 올라오면 또 한 번 삼 매야지
또 그거 매고 나먼 좀 이쓰먼 또 감잘 로이로	또 그거 매고 나면 좀 있으면 또 감자 올라오지
감자 함 번 매야지	감자 한 번 매야지
또 고담 옥쑤수 방 매야지	또 그 다음 옥수수 밭 매야지
조이 밤 매야지	조이 밭 매야지
군 밤 매이지 삼촌 그 드레가 일 하능거지	군 밭 매야지 삼촌 그 들에가 일 하는 거지
그래 가트먼 갈게 추수동장이 요 천자 이짜나 천자	그래 같으면 가을에 추수 동장이 이 천자에 있잖아 천자
천자에 추수 동장이요 갈 추 짜 겨울 동 짜 고써글 거둬 키우능 기 고써글 다 거둬 드려 가주고 마당에 타추 짜 타 떠능 거 돌깨로 떠능거	천자에 추수 동장이요 가을 추 자 겨울 동자 곡식을 걷어 키우는 게 곡식을 다 걷어 드려 가지고 마당에 타추 짜 타 떠는 거 돌깨로 떠는 거
시방 옌나렌 베로 떠러짜네	시방 옛날엔 벼로 떨었잖아
거따가 도르며는 인제 이리 곧 끄나지	거기에다가 돌리면 이제 일이 곧 끝나지
끈나먼 함 버니나 남자들 갈 김장	끝나면 한 번이나 남자들 가을 김장
갇 갇 가 낌장 하고 배추 배추 짐장하고 갈게 마늘 마늘 노코 갈보리 갈고 갈보리 갈보  리 갈고 고 다메는 다 끈나 끈나먼 저장해 노먼 뭐하냐	갓 갓 갓 김장 하고 배추 배추 김장하고 가을에 마늘 마늘 놓고 가을보리 갈고 갈보리 갈보리 갈고 그 다음에 다 끝나 끝나면 저장해 놓으면 뭐하냐
겨우레 연탄 겨우레 나무 낭갈 눈 올 때 까지 계소카능기어	겨울에 연탄 겨울에 나무 나무 눈 올 때 까지 계속 하는 거야
눈 올 때 까지요	음 눈 올 때 까지요
바패 먹찌	밥 해 먹지
이 가매 소테 이거 소죽 끄리능 거는 그 무리 초롱으로 한 네청씩 드러가요	이 가마니 솥에이거 소죽 끓이는 거는 그 물이 초롱으로 한 청씩 들어가요
그러면	그러면
초롱은 어트케 생겨써요	초롱은 어떻게 생겼어요
초롱 이짜네 이 초롱 뭐시 함청으로 됭 게 초롱	아 초롱 있잖아 이 초롱 뭐 함청으로된 게 초롱
거리 먼 사 라믄 그걸 무지게라 그래써  무지게	거리 먼 사람은 그걸 물지게라 그랬어  물지게
물 지고 댕기능 거	물 지고 다니는 거
그걸 지고 댕겨 가 가주고드로 또 아주먼네는 동이 동이	그걸 지고 다녀 가지고 또 아주머니네는 동이 동이
초롱이 업쓸 때 우리 저 옥똥이라 이써	초롱이 없을 때는 우리 저 옥동이라 있어
흘그로 맨드는 또 동이 이상항 거	흙으로 만드는 또 동이 이상한 거
거기 보다감 거러체 어퍼지면 퍽 깨지먼 건 건 돼	거기 보다가 걸려서 엎어지면 퍽 깨지면그게 돼
아니 그래니까 아주 잘 조심히 댕겨야지 시골써 가주고	아니 그러니까 아주 잘 조심히 다녀야지 시골에서 가지고
그 무리여 무리 여드레기 뭐이 저 어떠카나 그래가주고 소죽 밥 해주구는 나주른 그럼 거기이 장자기라 장작	그럼 물이 물이 여드레기 뭐 저 어떻게 하나 그래 가지고 소죽 밥 해주고는낫으로 그럼 거기 이 장작이라 장작
나무 장작	나무 장작
그렁거는 그 근때만 하더래도 그러케 내 산 업씨머는 나메 막 모삐자네	그런 거는 그 그때만하더라도 그렇게 내 산 없으면 남의 막 못 베잖아
우카네 가만 데도 비고 모 자여니 주먼 또 비고 장작 해랑 건 건 비상용으로 해노코 고 다메 이 뭐이야 잡똥생이 나무	그 다음에 이 뭐야 잡동사니 나무
송까락 이렁걸 그 빈하니라 하지	손가락 이런걸 그 빈한이라 하지
그렁걸 가따 한 뻬개진 칠십쯤 뫄다가 하루 모 두 짐도 하고 석 찜도 하고 그래행 쟁여 노코는 겨우레 그걸 장작 푸어케다가 가따 놔서는 때먼 하루 한 짐씩 드러 한 짐씩	그런 걸 갔다한  칠십 짐 모아다가 하루 뭐 짐도 하고 짐도 하고 그렇게 해서 쟁여 놓고는 겨울에 그걸 장작 부엌에다가 갔다 놔서는 때면 하루에 한 심찍 들어 한 짐씩
하루 한 지미먼 석 따리머는 석딸 러문 아홉 찌미먼 구십 찌믈 해야 되자나	하루 한 짐이면석 달이면 석 달 넣으면 아홉 짐이면 구십 짐을 해야 되잖아
보통얼마나 듬니까 겨울라레	보통얼마나 듭니까 겨울날에
겨울 낭기 낭기 함 배기면 되지	겨울 나무 나무 한 백이면 되지
백찜	백 짐
그래 고걸 그걸 보라고	그래 그걸 그걸 보라고
백찌미먼 하루 석 찜씩 세면 얼마 돼	백 짐이면 하루 석 짐씩 세면 얼마 돼
한 다레 한 다레  한 달	한 달에 한 달에  한 달
그거또 하나또 안 넌능가	그것도 하나도 안 넣는가
그러케 그 겨울래내 그 할 때 누니 뿌익 누니 막 요 아페 사네 이러케 오먼 몯 까자나 추와서	그렇게 그 겨울내내 그 할 때 눈이 뿌옇게 눈이 막 이 앞에 산에 이렇게 오면 못 가잖아 추워서
그냥 보리처 엄마하머는 한다고 그러치 안음 운다레 가먼 해가 안 들자네	그냥   한다고 그렇지 않으면 윤달에 가면 해가 안 들잖아
양재 가먼 사라미 한 이 동네 사시포가 살며는 사시비 나무꾸니라고	양지에 가면 사람이한 이 동네 호가 살면 이 나뭇꾼이라고
한 지베 둘또 이꼬	한 집에 둘 도 있고
그럼 나무가 여기는 거의 업껜네요	그럼 나무가 여기는 거의 없겠네요
시방은 연탄 때고 지름 때니까 좀 나그로 아이고 뭐 그 잡똥 잡똥하니 꽉 차찌	지금은 연탄때고 기름 때니까 좀 나무가 아이고 뭐 그 잡동 잡동하니 꽉 찼지
그저네는 해마다 들 비지	그전에는 해마다 다들 베지
올해 여거 비무는 거기는 한 해 미뤄가지고 저 비고	올해 여기 베며는 거기는 한 해 미뤄가지고 저기에 가서 베고
내녀네 여 비고 또 후녀네 저가 비고먼저 얘기 해짜나 정오년	내년에 여기 베고 또후년에 저기가 베고먼저 얘기 했잖아 정오년
내년 후며는 정오년	내년 후면 정오년
이 근처 한 마니  하는 사십 호 사라써요	이 근처 한 많이  하는 호 살았어요 사십 끄럼  그럼
그러며는 그 정도 살며는 이 가까운 데 모타고 쪼끔 더 멀리와서 나무 해 오고 그러겐네요	그러면 그 정도 살면 이 가까운 데 못 하고 조금 더 멀리와서 나무 해 오고 그러겠네요
요즘 가차운 놈 보다 먼저 하지 가도 업쓰니까	요즘 가까운 놈 보다 먼저 하지 가도 없으니까
나하고 가차운 데 내래도 할라고 욕씸차리고 가 하머는 업씨먼 자꾸 자꾸 멀리 가능기여	나하고 가까운 데 나라도 할라고 욕심차리고 가 하면 없으면 자꾸 자꾸 멀리 가는 거야
여기여 그 이 키로먼 오 리요 오 리	여기가 그 키로면 리야 리
이크로 바지 간다 이 키로	키로  간다 키로
이키로 까진 가서 해지 왜	키로 까지는 가서 하지 왜
해 지게로 질머지고 오능거여	해서 지게로 짊어지고 오는 거야
옌나렌 또 뭐 시니 미투리 이짜나 미투리 미투리 여 짚	옛날에는 또 뭐 신발이 미투리 있잖아 미투리 미투리 여 짚
신 미투리	신 미투리
네 네	네 네
뭐 여 뭐이 시방은 그거는 조은 발 뭐 시니써	뭐 여기 뭐 시방은 그거는 좋은 발 뭐 신있어
시방은 또 옌날 그러쿠 요즘 와서는 그 해방이후 후로 여기에서 사벼니 쪼끄 나써 농구화 뭐운동화고 나오고 털신 나오고 이래먼  그저네는 미투리 그거 이 감발	시방은 또 옛날 그렇고 요즘 와서는 그 해방이후로 여기에서 사변이 조금 났어 농구화 뭐 운동화도 나오고 털신 나오고 이러면  그전에는 미투리 그거 이 감발
감바리란 거 아라 감발	감발이란 거 알아 감발
네 네	네 네
미테 쩌 나와짜나요 여기 감발 나와씀니다	밑에 저기 나왔잖아요 여기 감발 나왔습니다
감발 감발	음 감발 감발
그럼 그렁 걸 해 가주고	그럼 그런 걸 해 가지고
그럼 그 감발하고 미투리 신 씽고	그럼 그 감발하고 미투리 신 신고
여게 속 내봉이 업써 내봉	여기에 속 내복이 없어 내복
그 옌날 싸라미 얼마나 가난하냐 이기야	그 옛날 사람이 얼마나 가난하냐 이거야
그쵸 네	그렇지요 네
내복 업꼬 여기에 베집 어뜽 거는 광목 명 홍명 그렁 거 호껍때기씩 하나씩 해 입꼬 사진 여게 절먼 절머쓸 쩌 아들 청년씨나는 코트만하나 씩 입꼬도 사네 가서아 춥꺼등 그래 여리 가라 그러지	내복 없고 여기에 볏짚 어떤 거는 광목 명 홍명 그런 거 홑껍대기씩 하나씩 해 입고 사진 여기에 젊은  젊었을 적 아이들 청년는 코트만 하나 씩 입고도 산에 가서아 춥거든 그래 이쪽으로 가라 그러지
어떤 데는  미테 뿌라리 뿌라리 빠짝 어러요	어떤 데는  밑에 불알이 불알이 바짝 얼어요
추워서	추워서
그러먼 그 사네 가서 추우며는 어트게 함니까	그러면 그 산에 가서 추우면 어떻게 합니까
추워 추워도 해야지 추워도 뭐	추워 추워도 해야지 추워도 뭐
그러 그러니까 여 여 장갑또 아니야 시방은 장갑 찌자네요	그러니까 이 이 장갑도 아니야지금은 장갑을 끼잖아요
뭐 불평은	뭐 불평은
만치모네 장갑 업씸매 맨쌀 하면 여 여 까시가 드러가 가주고  그래 찔리고 여 피가 나고나처 끌미 지고 하이고	많지모 장갑 없으니까 맨살로 하면 여기 여기에 가시가 들어가 가지고그래 찔리고 여기에서 피가 나고  끌면서 지고 하이고
얼마나 그 참 사능기 그래도 그기 옥쑤수 바비나 실컨 머꼬 응	얼마나 그 참 사는 게 그래도 그게 옥수수 밥이나 실컨 먹고 응
겨우레 솜니부래 뜨꼬 부드자리 깔고 자능 거또 큰 행보기래 해따고	겨울에 솜이불 뜯고부드자리 깔고 자는 것도 큰 행복이라 했다고
그 그러게 사는 사람들또	그 그렇게 사는 사람들도
그러게 모싸람도 꽉 차꼬	그렇게 못 사는 사람도 많아고
나무는 보분 인는 사라믄 보메 아처글 밥 머꼬 저녀그론 죽 쒀 먹 끄런데 엄는 사라믄 아침지어 오르먼 주글 머거요	나무는 보분 있는 사람은 봄에 아침으로 밥 먹고 저녁으로는 죽을 쒀먹고 그런데 없는 사람은 아침 지어 오르면 죽을 먹어요
그 싱냥이 흉녀니 지머는 싱냥이 겨울 머꼬 봄 까지 해꼬글 핻 핻 꼬기 날 때 까지 먹찌 아느며는 이러까 옥쑤수도 멛 까마이 감자도 멛 까마이 파또 멛 까마 이써야 될 께 아니요	그 식량이 흉년이 지면 식량이 겨울 먹고 봄 까지 햇곡을 햇 햇 곡이 날 때 까지 먹지 않으면이렇게 옥수수도 몇 가마니 감자도 몇 가마니 팥도 몇 가마니 있어야 될 거 아니요
그래이머는 흉녀니 지며는 자 감자도 잘 안 돼찌 보리도 안 돼찌 청밀도 안 돼찌 옥쑤수도안 돼지 하머는 여 멛 까마니 안 되머는 그 내녀네 새로 나온 곡써글 머끼 위해서는 싱냥을 먹짜 하머는 바블 해 먹  해 먹따 보머는 여르메 다 떠러지게꺼든	그러면 흉년이 지면 자 감자도잘 안 됐지 보리도 안 됐지 청밀도 안 됐지 옥수수도 안 돼지 하면 이 몇 가마니 안 되면 그내년에 새로 나온 곡식을 먹기 위해서는 식량을 먹자 하면 밥을 해 먹 해 먹다 보면 여름에 다  떨어지겠거든
그러면 겨울부텀 주굴 쑤구 주굴 매똘로 가라 가주고 콩조 콩게랑 거 그렁 건 무를 부니깐드로 바블 해서 한 때무니 이머는 한 때 주굴 쑤머는 이틀 머꺼든	그러면 겨울부터 죽을 쑤고죽을 맷돌로 갈아 가지고 콩조 콩게라는 거  그런 거는 물을 붓고 밥을 해서 한 끼를 때우면한 때 죽을 쑤면 이틀 먹거든
그러게 사라미 매글 쓸 쑤 인나	그렇니까 사람이 맥을 쓸 수가 있나
사라미 그 겨우레도 지릉끼가 업 그렁 걸 몸 머꼬 이러니까 시방은 고기 머끼 위해서  그래도 사리 조쿠 옌나레는 노인들도 패래꼬 아들또 성장유리 크지 모타고 그런 그러케 사능 거이요	사람이 그 겨울에도 기름기가 없 그런 걸 못 먹고 이러니까 시방은 고기를 먹기 위해서 그래도 살이 좋고 옛날에는 노인들고 패랬고 아이들도 성장율이 크지 못하고 그런 그렇게사는 거에요
싸리 업쓰며는 주로 어트케 그러니까	쌀이 없으며는 주로 어떻게 그러니까
주굴 주굴 마니 먹찌	죽을 죽을 많이 먹지
어떤 싸를 주글 머글 때 쌀하고 서꺼 먹짜나요	어떤 쌀을 죽을 먹을 때 쌀하고 섞어 먹잖아요
쌀하고 뭐 주로 뭐	쌀하고 뭐 주로 뭐
그 깡냉이 옥쑤수 갈면 옥쑤수 주기여	그 강냉이 옥수수 갈면 옥수수 죽이여
파틀 갈면 팓쭈기라고 파까른 주기라고 그 물 부우문 주기지	팥을 갈면 팥죽이라고 팥 갈은죽이라고 그 물을 부으면 죽이지
그러면 옥쑤수 가튼 경우 요즘 모 강냉이 이짜나요	그러면 옥수수 같은 경우 요즘 뭐 강냉이 있잖아요
그게 이쓰며는 그걸 어트게 보과늘 함니까	그게 있으면 그걸 어떻게 보관을 합니까
저 옌나렌 그 두 두지랑 게 이써써 낭갈 짜가주고	저 옛날엔 그 두 두지라는 것이 있었어나무를 짜가지고
큰 통낭 걸 아지 이러 캐 가주고 뚜껍끼 메씸년 됭 거를 요러 짜요 요러케	큰 통으로 난거를 이렇게 캐 가지고 두껍게 몇 십년 된 거를 이렇게 짜요 이렇게
짜서 인제 그게 옥쑤수 넌 카니 옥쑤수 다섣 까만 열 까마니 여덜 까만 메물 르 메물 두가마니 넌는 데 뭐 이러케 해서 거러 짜능가치	짜서 이제 그게 옥수수를 넣은 칸이 옥수수 다섯 가마니 열 가마니 여덟 가다니 메물을 넣어 메물 두 가마니 넣는 데 뭐 이렇게 해서 걸어짜는 거 같이
그런데 너코 그 다음 단지 동이 동이짜나 동	그런데 넣고 그 다음 단지 동이 동이 있잖아 동
항 가마니 두 가마니 짜는 데 거 다 내 주반 안 드러가지	한 가마니 두 가마니 짜는 데 거기에 내 주반 안 들어가지
옌나레 쥐가 얼마나 만나	옛날에는 쥐가 얼마나 많나
그 가마니대로 문 가마니다 그냥 바께 놔두머는 쥐가 구녕 다 뚤차네	그 가마니대로 문 가마니다 그냥 밖에 놔두면 쥐가 구멍 다 뚫잖아
다 다 먹짜네	다 다 먹잖아
그래서 도기라 하던가	아 그래서 도기라 하던가
그리고 그럼 도기라 하는데	그리고그럼 도기라 하는데
그뿌니요	그뿐이요
요요요요 옌나레는 뭐 그런 쥐약또 업꾸 그타 보니깐 쥐가 옌나렌 주 주가 옌나렌 주가 참  마니 깨써 왜냐먼	요요요요 옛날에는 뭐 그런 쥐약도 없고 그렇다 보니까 쥐가 옛날엔 쥐가옛날엔 쥐가 참 많이 깨서 왜냐하면
저 이런 사랑빵	저 이런 사랑방
인제 하라버지네 사고 할머니네 여페서 사는 방 자고 뭐이 그런데는 이 저 저 쥐가 구녕을 뚤쿠 무늘 뚤쿠 방에 드러와 가주고 저 미리 다 달자네요	이제 할아버지네 사고 할머니네 옆에서사는 방 자고 뭐 그런데는 이 저 저 쥐가 구멍을 뚫고 문을 뚫고 방에 들어와 가지고 저 밀이다 달잖아요
그럼 메주꼴로 올라와 가주고 그 메주를 다 파 머그면 바메 나 드러 불러내 잡꼬 마리야	그럼 메주꼴로 올라와 가지고 그 메주를 다 파 먹으면 밤에 나 더러 불러내 잡고 말이야
메주 메주꼴로 올라 가능 게 뭐에요	아 메주 메주꼴로 올라 가는 게 뭐에요
메주꼴대로 한다고 메주 메주 다릉 걸 메주꼴배라 한다고	메주꼴대로 한다고 메주 메주 다른 걸 메주꼴배라 한다고
메주 당 거를	아 메주 단 거를
메주꼴배	메주꼴배
방에 달면 메주꼴배 우리 저 어제 단게	방에 달면 메주꼴배 우리 저 어제 단게
메주꼴배 그 끄럼 장개요 메주꼴배가	메주꼴배 그 그럼 장개요 메주꼴배가
옌나레지 이뿌로 그 침 침냥 그래해짜냐요	옛날에지 이불로 그 침 침낭 그렇게 했잖아요
바 바다게 이러케	바 바닥에 이렇게
옌나레는 저러케 짜 저러케 단다고 저거 져다가	옛날에는 저렇게 짜 저렇게 단다고 저거져다가
져다가 인제 쇠꾸래 내 꿍 거 이 장때 내 끼워서는 거다 그 매써요	져다가 이제 쇠꾸래 내꾼 거 이 장대를 내가 끼워서는 거기에다 그거를 맸어요
다시 하면 달고	다시 하면 달고
단다 그 메주꼴배	단다 그 메주꼴배
베주꼴배 메주 다라꾸나	베주꼴배 메주를 달았구나
쥐가 쥐가 거까지 드러오네요	아 쥐가 쥐가 거기까지 들어 오네요
끄럼	그럼
아이 옌나렌 쥐가 아이구 말또 마러	아이 옛날엔 쥐가 아이구 말도 말어
시방은 쥐야그로 마니 잡꼬 으 저 사격쑤 잡꼬 해찌만 옌나렌 쥐 잠는 고냥이 배끼 더 이써뭐 고양이	시방은 쥐약으로 많이 잡고 으 저 사격수가 잡고 했지만 옛날엔 쥐 잡는 고양이 밖에 더 있어 뭐 고양이
고양이 집찜마다 키운다 그러면 고양이 다 몯 짜바 먹짜네	고양이 집집마다 키운다 그러면고양이 다 못 잡아 먹잖아
그 고양이 고양이가 뭐 쥐를 다 자바멍나	그 고양이 고양이가 뭐 쥐를 다 잡아 먹나
쥐가 하도 마나서	쥐가 하도 많아서
끄럼	그럼
그러쿠나 네	그렇구나 네
어르신 여기 이짜나요 예저네는 그러며는 약초 가틍 거나 그렁거 캐 보신 저기	어르신 여기있잖아요 예전에는 그러면 약초 같은 거나 그런 거 캐 보신 저기
이찌	있지
여기선 약초는	여기선 약초는
약초여 캐능 게 뭐 사네 가먼	양초여 캐는 게 뭐 산에 가면
어떵 거 이써요	어떤 거 있어요
저 씨호랑게 씨호	저 씨호랑게 씨호
산시호	산수유
산시호	산수유
또 자약 산짜약 자약 또 뭐 그런 그렁거 인제	또 자약 산 자약 자약 또 뭐 그런 그런 거이제
산또라지 산또라지 야기거든	산도라지 산도라지 약이거든
시호 자약	시호 자약
산또라지	산도라지
산또라지	산도라지
그럼 그렁게 약초 캐지 뭐	그럼 그런게 약초 캐지 뭐
캐가지고 인제	캐가지고 이제
언제쯤 감니까	언제쯤 갑니까
봄 봄부턴 가지 뭐	봄 봄 부터 가지 뭐
보메 가먼 인제	봄에 가면 이제
혼자 가세요 아니면 가치	혼자 가세요 아니면 같이
아니 여러기도 가능데 이 이 내 장년 싸기 바싹 말라쓸 께 아니요	아니 여럿이도 가는데이 이 내 작년 싹이 바싹 말랐을 거 아니요
그러먼 거 싹 고렁 걸 대공복 캐고 쪼금 인제 그러먼 또 싸기 올라오자네	그러면 그 싹 그런 걸 대공복 캐고 조금 이제 그러면 또 싹이 올라 오잖아
그 새 새싸글 새로 나온 새싹 꼭 캐고 아이 뭐 둘도 가고 혼저도 가고 뭐 세또 가고 뭐	그새 새싹을 새로 나온 새싹 꼭 캐고 아이 뭐 둘도 가고 혼자도 가고 뭐 셋도 가고 뭐
긍데 우리 나는 마니 앙 캐봐써	근데 우리 나는 마니 안 캐봤어
그런데 그 약쨍이랑 게 이써 그 동네 또	그런데 그 약쟁이라는 게 있어 그 동네 또
야글 잘 캐는 야글 사네 가서 잘 캐가지고 파는 사라미 이써	약을 잘 캐는 약을 산에 가서잘 캐 가지고 파는 사람이 있어
그럼 인제 해서 말려노면 또 인제 산 산 약 약 짱사가 오지 사러	그럼 이제 해서 말려 놓으면 또 이제 산 산약 약 장사가 오지 사러
그래 주로 나물 뜨더 나물	그래 주로 나물 뜯어 나물
나물 중에는 어떤 나물	나물 중에는 어떤 나물
곤두레 곰추 사네이 저 곤두레가 사네 곤두레 씨를 바다 가지고 지금 재배하는 거이요	곤드레 곰추 산에 이 저 곤드레가 사에 곤드레 씨를 받아 가지고 지금 재배하는 거에요
아이 지베서 자성해서 키웅 게 아니고 사네서 씨를 바다 가지고서는 이러케 퍼져 퍼진다 그러지 여기 싸람 농초네 싸람드른	아이 집에서 자성해서 키운 게 아니고 산에서 씨를 받아 가지고서는 이렇게 퍼져 퍼진다 그러지 여기 사람 농촌에 사람들은
저 장게에서 늘그니가 지금 이러케 화구살 재배할 트들 갈지	저 장게에서 늙은이가 지금 이렇게 화구살 재배할 트들 갈지
이 더덕또 더덕또	이 더덕도 더덕도
더덕또 사네서 씨를 바다가지고 그 씨가 자꾸 번성해 가주고 이리 됭거야 그거	더덕또 산에서 씨를 받아 가지고 그 씨가 자꾸 번성해 가지고 이렇게 된거야 그거
어디 뭐 씨를 여 어디써 뭐 이 농초니 맨든 줄 아리요	어디 뭐 씨를 여기 어디서 뭐 이 농촌이 만든 줄 알아요
곰추 곤추 곰추 씨도 그러코 곰추	곰추 곰추 곰추 씨도 그렇고 곰추
곰추도 지금 사네 가먼 사네가 뜨더 머거따고 옌나레는 사네	곰추도 지금 산에 가면 산에가뜯어 먹었다고 옛날에는 산에
곰추 뭐 더덕 쫌 서래가 캐고 도라지 곤드레 나물취 취 이두압치 산 언능 거또 마너	곰추뭐 더덕 좀 서래가 캐고 도라지 곤드레 나물취 취 이두압치 산에는 얻는 것도 많아
그다메 버섣 까틍 거또 마니 해써	그 담에 버섯 같은 것도 많이 했어
버섣 쪼 사네 가먼	버섯 저 산에 가면
그 자연버섯 이찌 사네 가문	그 자연버섯 있지 산에 가면
편낭게  고모기 돼가 써거꺼 이래문 이러케 나능거	편나무  고목이 돼서 썩으면 이렇게 나는 거
고다메 땅 위에 난는 그루쿠라 이써 그루쿠	그 다음에 땅 위에 났는 그루쿠라 있어 그루쿠
그루쿠라는 그거또 버섣	그루쿠라는 그것도 버섯
버서시지	버섯이지
그 낭게 써거서 요 개운 나무 거 이짜나 개운 나무 거 가틍 게 이찌	그 나무 썩어서 이 개운 나무 그거 있잖아 개운 나무 그거 같은 게 있지
써거서 이 자연히 죽 주구문 낭게 주구문 땅에 따저 가주고 거서 인제 썩 짜네요	썪어서 이자연히 죽 죽으면 나무 죽으면 땅에 떨어져 가지고 거기서 이제 썩잖아요
거서 곰팡이가 피문 또 올라지지 이 버서시 그게 흘쿠래 흘쿠	거기서 곰팡이가 피면 또 올라오지 이 버섯이 그게 흘쿠래 흘쿠
글쿠	글쿠
글쿠	글쿠
그 다메 참낭게 인	그 다음에 참나무 있는 건
참 버섣	참 버섯
참낭게 이는 버서슨 어떤 이르미 이씀니까	참나무에 있는 버섯은 어떤 이름이 있습니까
그 참 참나무 버스게 참버습쎄 이르게 해찌 우리가	그 참 참나무 버스게 참버습세 이렇게했지 우리가
참버습 따 머꾸요	참버습 따서 먹고요
버서또 종류가 만차나요	버섯도 종류가 많잖아요
만치마는 여게 사네나능 건 시세가 뭐 잘모뙹 거 안 따먹찌	많지마는 여기에 산에 나는 것은 시세가 뭐 잘못된 거는 안 따먹지
위험하다구	위험하다고
머글 수 이는게	먹을 수 있는 것이
참 참나무 버서타고 여기 그걷 땅 땅에 그 그루쿠	참 참나무 버섯하고 여기 그것 땅 땅에그 그루쿠
거 뭐 능이나 송이 가틍 건 업썬나요	거 뭐 능이나 송이 같은 것은 없었나요
송이 이찌 송이 이찌마는 여 지금 강원도가 양양에 젤 만차나 양양	아 송이 있지 송이있지만 여기 지금 강원도가 양양에 제일 많잖아 양양
강원도는 양양이 젤 만타고 양양	강원도는 양양이 제일 많다고 양양
양양 송이 축쩨하자네요 송이는	양양 송이 축제하잖아요 송이는
시방 고럼	지금 그럼
그러면 능이버섯 까튼 거도 키워보셔써요	그러면 능이버섯 같은 것도 키워보셨어요
능이버섣 아니요	능이버섯 아니요
그 왜 송이는 송이는 여게 이 호명 쭉 까느네나머 그 송이 나는 바치 따로 사니 따로 이써	그 왜 송이는 송이는 여기에 이 호명 쭉 가면 그 송이가 나는 밭이 따로 산이 따로 이써
쩌거 마너씩	저거 만원 씩
그럼 우리 송이 따러 가지 송이 따 봐써 마니 따 봐찌	그럼 우리 송이 따러 가지 송이 따봤어 많이 따 봤지
그러며는 어르신 산삼도 캐보셔써요	그러면 어르신 산삼도 캐보셨어요
산삼 앙 캐 봐써	산삼 안 캐 봤어
왜 산삼 캐러 사람드리 가고 막 그러자나요	왜 산삼 캐러 사람들이 가고 막 그러잖아요
산삼 캐러 가는 사라므는 산삼 그 사네가 뭐 칠썽 드리고 캐 본 사라미 좀 캐지 캐봐짜네요	아 산삼 캐러 사람은 산삼 그 산에가 뭐 칠성 드리고 캐 본 사람이 좀 캐지 캐봤잖아요
자기 뭐 요 우 재수가 조아서 그 조타 그러지 아네요	자기 뭐 요 우 재수가 좋아서 그 좋다그렇지 않아요
캐 본 사라미 사네 그 댕기미 하다 보먼 캐고 그기 사므는 그 그러케 사람마다 다 안 때이고혹씨 끄게야 한 두 뿌리 그 사람 그 사라미 캐도 되지	캐 본 사람이 선애 그 다니며 하다 보먼 캐고 그 삼은 그 그렇게 사람마다 다 안 띄이고 혹시 그게 한 두 뿌리 그 사람 그 사람이 캐도 되지
그럼 어르신 나무를 캐며는 주로 나물로 뭘 함니까	그럼 어르신 나물을 캐면 주로 나물로뭐를 합니까
나물 가주 와서는 쌀마 가주고서는 된장에 무쳐 가주구선 바파고 이르걷 삐벼 머꼬 그래찌 근데 건	나물을 가져 와서는 삶아 가지고서는 된장에 무쳐 가지고선 밥하고 이르게 비벼 먹고 그랬지 근데 그건
이 흉녀네는 나무를 이 이 이 이 배를 채운다고	이 흉년에는 나무를 이 이 이 이 배를 채운다고
밥 한 두 수까락 머거 가주 배 부르게씨요	밥 한 두 숟가락 먹어 가지고 배 부르겠어요
그 나물 늘 쌀머 가주고 그 바블 거다가 그르세 비벼 가주고 그래 머거 머그먼 이 속 소게 그게 아니지 상호 고담 나물쭉 죽 쒀가 나물 또 나물 쏘글 너차네 주게다가	그 나물 늘 삶아 가지고 그 밥을 거기에다가 그릇에 비벼 가지고 그래 먹어 먹으면 이 속 속에 그게 아니지  그다음에 나물 죽 죽 쒀서 나물 또 나물 속을 넣잖아 죽에다가 우동 나물쭈기라 그기 우동 나물쭉이라 그게
그럼 어르신 그 야그로 그 사용하능 경우는 업씀니까 고거 약초 가틍 거	그럼 어르신 그약으로 그 사용하는 경우는 없습니까 고거 약초 같은 거
야그로	약으로
여게선 그저 그러치 모	여기에선 그저 그렇지 모
사네 이  캐  이러게 캐오먼 때려 멍는다고	산에 이 를 캐  이렇게 캐 오면 때려서 먹는다고
뭘 때려 먹씀니까	뭘 때려 먹습니까
야글 때려 멍는다고 그런다고 때려 멍는다고 조걸 멍는 걸 때려 멍는다 그런다구	약을 때려먹는다고 그런다고 때려 먹는다고 저걸 먹는 걸 때려 먹는다 그런다고
어떤 어떵 걸 주로 쭐 꺼 먹씀니까	어떤 어떤 거를 주로 쭐 거 먹습니까
어려 멍는거는	어려 먹는 거는
아이 아무거또 이 약 탕광이라고 이짜나 이러케	아이 아무것도 이 약탕광이라고 있잖아 이렇게
그 탕광이라고 물 한 되도 만치 아는데 그기 토긴데 토긴데 거다가 너어서 화아레다 안 너가주고 시나메 시나 이제 버글 버글 처메 아이 끼려가주 고 다메 거 노코 새나 쫄구지 그차  네요	그 탕광이라고 물 한 되고 많지 않은데 그게 토기인데 토기인데 거기에다가 넣어서 화로에다가 안 넣어 가지고 시나메 시나 이제 버글 버글 처음에 아이 끓여 가지고그 다음에 그거놓고 새나 쫄구지 그렇지 않아요
쫄구능 게 이제 그 때린다고 해따고 때린다고 약 때려	조리는 거를 이제 그 때린다고 했다고 때린다고 약 때려
약제는 제 여러가지지 그 여게 이런 초워네는 그 약 야꾸기랑 게 이써 탕약	약제는 제 여러가지지 그 여기에 이런 초원에는 그 약 약국이란 것이 있어 탕약
탕야꾹 허가도 안 내고 옌날 그 은지 어른드리 한문 마니 배운 분드른 거 약쩨방 방버베 나오자네요	탕약국 허가도 안 내고 옜날 그 언제 어른들이 한문 많이 배운 분들은 거 약제방 방법에 나오잖아요
그래이먼 뭐 자약 황기 당귀이렁 거는 어떤 다친 데 조타	그러면 뭐 자약 황기 당위 이런거는 어떤 다친 데 좋다
또 어떤 여르메 그 더위에 머근데 배아래 조타	또 어떤 여름에 그 더위에 먹은 데 배알른 데좋다
또 뭐 어트게 아느먼 그 사람 먼 이 이정배아리다	또 뭐 어떻게 아는 그 사람이면 이 이정배아리다
그사람 또 어트다 이 그 그부니 이러케 짐매글 해 가주 그부니 이게 화제를 내서 야글 제줘요	그 사람 또 어떻다 이 그 그분이 이렇게 짐맥을 해 자기고 그 분이 이게 화제를 내서 약을 지어 줘요
그럼 한 처베 뭐 마너니먼 마넌	그럼 한 첩에 뭐 만원이면 만원
다서 채먼 오 마넌 주고 내가 인제 아푸면 사 가주 와 가주고 지베 와 때려 때려 가주고 먹찌	다섯 채면 오 만원 주고 내가 이제 아푸면 사 가지고 와 가주고 집에 와 때려 때려 가지고먹지
옌나레 옌나레 그런 옌나렌 그런 식 이찌	옛날에 옛날에 그런 옛날엔 그런 식 있지
뭐 사람마담 다 캐 가주고 다 때려 멍는 건 업찌	뭐 사람마다 다 캐어 가지고 다 때려 먹는건 없지
보보야그로 멍는 건 업꼬 저런	보 보약으로 먹는 건 없고 저런
아품 먹찌 옌나레 보약 업찌	아푸면 먹지 옛날엔 보약 없지
시방은 뭐 보약 이찌만 보약 저기에는 그렁 건 업써	지금은 뭐 보약 있지만 보약 저기에는그런 거 없어
옌나레는 옌나레는 옌날또 아니지 내 그래이머는 지금 말해지마는 유기오 사변 전까지만 해도 인제 한 오십 육씸년 육씹 오래 에 지금 연세라는데	옛날에는 옛날에는 옛날도 아니지 내 그러면 지금 말하지만 육이오 사변 전까지만 해도 이제 한 오십 육십 년 육십 올해 에 지금 연세라는데
해방 된 일본 시대 때 일본 사람드레 정치 하고 삼십 녕 해도 그건 우리 대함민구기 어디 전국쩌그로 어디 다 그러치마는 그 압빠글 받꼬 그래도 그 대도시는 그 농사를 지어가지고 그 사람드를 공청을 하고 백 백 까마니를 지어쓰면 삼 세 까마를 공초를 해도 나머지는 지가 실컨 머꼬 파라서 용돈 쓰고 그러지마는 이런 시고레 이러케 사는 사람드른 아직 짐승만 모타지	해방된 일본 시대 때 일본 사람들의 정치하고 삼십 년 해도 그건 우리 대한민국이 어디 전국 적으로어디 다 그렇지마는 그 압박을 받고 그래도 그 대도시는 그 농사를 지어가지고 그 사람들을 공청을 하고 백 가마니를 지었으면 삼 세 가마를 공초를 해도 나머지는 자기가 실컨 먹고 찰아서용돈 쓰고 그러지마는 이런 시골에 이렇게 사는 사람들은 아직 짐승만 못하지
시방 시방 소 응 소도 고썩 마이 매기고 이 개도 지금 쌀밤만 매기자네요	시방 시방 소  응 소도 곡식을 많이 먹이고 이 개도 지금 쌀밥만 먹이잖아요
클 때는 옥쑤수 받 개 가틍 거 몯 머꼬 개는 똥을 머거 똥	클때는 옥수수 밭 개 가튼 거못 먹고 개는 똥을 먹어 똥
사람 똥 머꼬 산다고 아들 누운 똥 똥	사람 똥 먹고 산다고 아이들이 누운 똥 똥
그래서 그렁 거를 머끼 때미네 개 개고기를 이르게 응열 사람 다친 데 개고기 야기라고 그래그래 옹 거이요 그 야글	그래서 그런 거를 먹기 때문에 개 개고기를 이렇게 응얼 사람 다친데 개고기가 약이라고 그래 그래 응 그 약을
그걸 머끼 때미네 그러니 사라미 사라믄 멍는 거시 나물 엄는 사람 나물 쭉 이런 그 소나무껍때기 빼께 머그면 송피라고 해 송피	그걸 먹기 때문에 그러니 사람이 사람은 먹는 것이 나물없는 사람은 나물 죽 이런 그 소나무 껍대기 버껴 먹으면 송피라고 해 송피
그렁 걸 또 막 머꼬 별 껄 다 멍는 거요	그런 걸 또 막 먹고 별 걸 다 먹는 거요
응 그러니 사네 예를 드러서 도라지 나물 곰추 더덕 곤드레 그렁 걸 자생낭 그렁 걸 머그니까 시른 사람 사른 안 저도 소 야글 멍는 거이요	응 그러니 산에 예를 들어서 도라지 나물곰추 더덕 곤드레 그런 걸 자생낭 그런 걸 먹으니까 실은 사람 살은 안 쪄도 소 약을 먹는거에요
그래 가지고 인제 옌날 노인드리 병이 그런 병이 업써요	그래 가지고 이제 옛날 노인들이 병이 그런 병이 없어요
그러게 사러 그러게 사라따고	그러게 살아 그렇게 살았다고
사람 사능 기	사람 사는 것이
마니 배원는디	많이 배웠는데
우어실 요 쓰는 걸 몯 뽜찌만 나는 내 자동 써 그래요	우어실 이거 쓰는 거를 못 봤지만 나는 내 자동으로 쓰고 그래요
이 저	이 저
어트게 배우셔써여	어떻게 배우셨어요
아이 내가 그 학 그 천자를 호동 파려이 요 가겁 씨저레 그으레 끄지 지게하고 여덜 팔 고이 딱 바민데 그래 오백짜를 내가 배우고 나무 지르 그 자 자동으로 하구 그래 인제 핸는데전조가 난 자동으로 핸거래요 이 지여으로 이리 배우짜네요	이  이렇게 배우잖아요
예를 들서 뭐 한문짜를 해머	예를 들어서 뭐 한문자를 하면
뭐 가지고 배워 천자만 가지고 배우	뭐 가지고 배워 천자만 가지고 배우나요
천자만뇨	어 천자만요
예를 들어 껍짜네요	예를 들어 껍 자네요
이 기연 기역짜에 오머는 이케이케 이케 그럼 넉짜를 지어그로 주 저꾹	이 기연 기역자에 오면 이렇게이렇게 이렇게 그럼 자를 지억으로 주
기르미 이낄 아니고 이끼요	기름이 이낄 아니고 이끼요
아니 그래 그게 인제 학 천자 이 끄트마리 짜리라고	아니 그래 그게 이제 학 천자 이 끄트머리 자리라고
네 네 그러쵸	네 네 그렇지요
그래간드루 하늘 천 따 지 가물 현 누룬 황 아니요	그러니까 하늘 천 땅 지 검을 현 누룰황 아니요
그래 그건 제 부체 일그먼 천지현황이라 이 천지현황	그래 그건 이제 붙여 읽으면 천지현황  이라 이 천지현황
그러쵸	그렇지요
우조홍황은 요런데 그래 옌날 그 그 얘기 이짜뇨	우주홍황은 이런데 그래 옛날 그 그 얘기 있잖아요
천지현황을 삼 년 도커니 천지현황을 삼 녀늘 일그니 언제 황야라 할씨도 업꼬 그래 재조가하도 엉뚱하는 거태	천지현황을 삼년 독 하니 천지현황을 삼 년을 읽으니 언제 황야라 할 수도없고 언제 황야라 할 수도 없고 그래 재조가 하도 엉뚱한 거 같아
그니깐드루 천지현황이요 우조홍황이라 하는데 천지현황은 삼년 독 하니 천지현황을 하늘 천따지 가물 현 누룬 황 삼 녀늘 일 일 일거되	그러니까 천지현황이요 우주홍황이라 하는데천지현황은 삼 년 읽으니 천지현황을 하늘 천 땅 지 검을 현 누룰 황 삼 년을 일 일 읽어되 또 인제 호야라 할 쑤도 이꼬 이끼연 이끼제 오누이끼야 그걸 언제 일르냐 이기여 또 이제호야라 할 수도 있고 이끼연 이끼제 오누이끼야 그럴 언제 읽느냐 이거야
저 그카네 머리가 둔해가지고 그래 인지 나는 내가 그 이 농사 지꼬 내가 전소 아께에 해짜나 하꾜도 내가 그 야간 중하꾜 광선지대가서 그 심부름 하고 경오나 좀 배우고 해따는 거슨참 그 기가 매킨 이리에요	저 그렇게 머리가 둔해가지고 그래 이제 나는 내가 그 이 농사 짓고 내가 전속 아까 했잖아 학교도 내가 그 야간 중학교 광선지대 가서 그 심부를 하고 경오나좀 배우고 했다는 것은 참 그 기가 막힌 일이에요
그 그 다 그 시저레 이 고재시기란 인가니 우리 오 사 형제 컨는데 내만 하꼬를 댕견는데우리 아버님 시저레 아무 가난하고 가난하고 모 싸라가주고 내가 그런 그리 포구니 저가주 그러는데 내 사실 자랑이 아니라 그 당씨에 내가여 곽 뭐야 궁민하꾜 그때 궁민하꾜 열 딸 댕기고 궁민하꾜 조럽 핸는데 내 정선 농업 중하꾜만 내 조럽해따 하더래도 솔찍한 얘기로 내 이농사 안 찌씀니다	그 그 다 그 시절에 이 고재식이란 인간이 우리 형제 컸는데 나만 학교를학교를 다녔는데 우리 아버님 지절에뭐 가난하고 가난하고 못 살아 가지고 내가 그런 글이폭운이 져가지고 그러는데 내 사실 자랑이 아니라 그 당시에 내가요 뭐야 국민학교 그때 국민학교 열 달 다니고 국민학교 졸업 했는데 내 정선 농업 중학교만 내가 졸업했다 하더라도 솔직한 얘기로 내 이 농사 안 짓습니다
뭐 어데 머 시험 공부해 시험 쳐 가주고 훨씬 뭘 해두 뭘 해두 머 벼루 내가 공직 공직 쌩활하던지 그래두 인데 그 그 그 당시에 뭐 사는데 그 아네 그 어려우미 도넏 도넌해 아주 이래서그래 인제 이르케 결혼씨글 딱 하면서 농사를 지며 가마니 생강니 그리 글 포구니 드러따고 그래꺼등 섀서	뭐 어디 뭐 시험 공부해 시험 쳐 가지고 훨씬 뭘 해도 뭘 해도 뭐 별로 내가 공직공직 생활 하던지 그래도 인제 그 그 그 당시에 뭐 사는데 그 안에 그 어려움이  해 아주 이래서 그래 이제 이렇게 결혼식을 딱 하면서 농사를 지며 가만히 생각하니 글이 글 폭운이 들었다고 그랬거든 해서
그리 포	글이 포
포 포운	포 포운
포운 이요	포운이요
그리 그리 한 하니 매친다 얘기여	글이 글이 한 한이 맺힌다 얘기야
그 당시에도 농사 지은지 내가 며 태가 됀는지 지금 짐 모리지먼뇨 자뚜해 배워 가주고 면서기 시험 치던지 뭘 좀 해야 되게따 이런 생가기 이써따고	그 당시에도 농사 지은지 내가 몇 해가 됐는지 지금 지금은 모르지만요  배워 가지고 면서기 시험 치던지 뭘 좀 해야 되겠다 이런 생각이 있었다고
그랭게 그기 뭐냐하먼 주색 잡끼라 이기여	그런데 그게 뭐냐 하면 주색 잡기라 이거야
주새기 이게 뭐냐하머는 우선 장개를 가니까 우선 여자에 하문 관씨미 바끼 아니요	주색이  이게 뭐냐 하면 우선 장가를 가니까 우선 여자에 하면 관심 밖이 아니요
둘째는 두 수 술 배우자네요	둘째는 수 술 배우잖아요
담밸 배우자네요	담배를 배우잖아요
또 어딜 모이먼 화토치고 놀자내요	또 어디를 모이면 화토치고 놀잖아요
그 쥐색 잡끼라는 기요	그게 쥐색잡기라는 거에요
그런 머리가 하나레 읍씨야 그를 배우는데 그램서도 인제 지부로 좀 신문도 좀 보고 그래 머언데 천자 한 줄 봐서 머 인제 하눌 천 따 지 가물 현 누를 황 또 일꼬도그다 보먼 메뻐늘 어려부니 지느러 자면서 우리 생활하먼 뭐 하늘 천 짜는 어터타 뭐 따지 짜는 딱 이 아자네요	그런 머리가 하나도 없어야 글을 배우는데 그러면서도 이제 집으로 좀 신문도 좀 보고 그래뭐 언제 천자 한 줄 봐서 뭐 이제 하늘 천 땅 지 검을 현 누를 황 또 읽고도그러다 보면몇 번을 어려우니까  자면서 우리 생활하면 뭐 하늘 천 자는 어떻다 뭐 땅 지 자는 딱 이 알잖아요
그 사네 가서 바틀 간다고 서 가주고 갈다가 쉬거든	그 산에 가서 밭을 간다고 서 가지고갈다가 쉬거든
찬차레 한 한 삼십 뻔 갈다가 한 십뿐 쉐야될 꺼 아니요 저 사라미	천천히 한 한 삼십 번갈다가 한 십 분 쉬어야 될 거 아니요 저 사람이
그래먼 가까에 이런 돌메이 돌미이 돌멩이라 하지 돌망구라 하기두 하구	그러면 가까이에 이런 돌멩이 돌밍이 돌멩이라 하지 돌망구라 하기도 하고
돌망구요	돌망구요
고등 기 이써 그 그걸 딱 땅파네 노코 언쩌네 배운 구상아로 배운 그걸 쓰는 거유	곧은 게있어 그 그걸 딱 땅판에 놓고 어제 저녁에 배운 로 배운 그걸 쓰는 거에요
이 이쩌게 돌미떡 떡 뜨구 돌메이 왜 돌미 써궁차 재미나요	이 이쪽에 돌멩이 떡 떡 뜨고돌멩이 왜 돌멩이  재미나요
그리먼이 따이 가물 현짜에 까물 까물해또 생가기 안나	그러면이 땅이 검을현 자에 까물 까물해또 생각이 않나
그래이머는 언쩌배우고 아처게 생가카구 나제 가서 저 일 하이면서 쓰느거는 건 그거는 하무는 넉 짜란 이 머리에 꽉 이짜나 내일 가먼	그러면 어제 저녁에 배우고 아침에 생각하고 낮에 가서 저 일 하면서 쓰는 거는 건 그거는 하며는 넉 자는 이 머리에 꽉 있잖아 내일 가먼
체조는 그거또 하제뇨	체조는 그것도 하잖아요
그래서 내가 이 배운거요	그래서 내가 이걸 배운 거에요
그래 배우머는 고 다메 글 진능 거또 배워 글 진능 거또 촌쑤에 따라서 그 자리가따 보태가주 지면 되는 거요	그래 배우면 그 다음에 글 짓는 것도 배워 글 짓는 것도 촌수에 따라서 그자리갔다 보태가지고 지으면 되는 거에요
며까지 안해유	몇 가지 안 해요
그래 가주고 그래다 보먼 인제 그여 수학 까튼 거는 뭐 이 뭐 짜릉 거 쪼까 알고 나눌 쎔 곱쎔 아료 그차네요	그래 가지고 그러다 보면 이제 그 여 수학 같은 거는 뭐 이 뭐 자른 거 조금알고 나누기 곱셈 알아요 그렇찮아요
그거 건제 으 하먼 대충 일하고 그 당시에도 그 당시에는 그 우리 잘던 시전 시저네는 요 언성이 가틍 엄청 시머요	그거 거 인제 으 하면 대충 일하고 그 당시에는 그 우리 잘던 시전 시전에는 이 언성이 가튼 거 엄청 심어요
한문 좀 알구 알구 요 얼마읻 글씨만 지꺼려 버리문 그 면소에 드러 가거든	한문 좀 알고알고 요 얼마 글씨만 짓거려 버리면 그 면소에 들어 가거든
그러는데 노름 하다 보니 머 망해 망하구 그래쪼	그러는데 노름 하다 보니 뭐 망해 망하고그랬죠
울다가 행교에 끄래 머 저는 청년 시저레 이런 저런 이런 청년 청년 회장청년 회장을그렁거 마타 가주고 또 내가 그 노능 거 조아해유	울다가 행교에 그래 뭐 저는 청년 시절에이런 저런 이런 청년 청년 회장청년 회장을 그런거 맡아 가지고 또 내가 그 노는 거 좋아해요
노능 거 당체 맨드러 이러케 뭐 당체 가주고 맨드러 하능 거	노는 거 당체 만들어 이렇게뭐 당체 가지고 만들어 하는 거
그 전세 찌여게는 참 회장을 부터 하다 얘들 하꾜 드러가지 머 하꾜 동년 위원하다가 고 다메 인제 하꾜 육썽회 회장 체육 진흥 회장 시방 홀레 짐미 육썽회 회장 그 부트문 초등하꾜하고 그 애들 중하꾜 감 중하꾜 가도 가서 또 그거또 회장 그럼 회장만 삼년 사먼뇨 농초네송아지 함 마리씩 파라 머거야 돼요	그 전세 지역에는 참 회창을 붙어 하다가 얘들 학교 들어가지 뭐 학교 동년 위원하다가 그 다음에 이제 학교 육성회 회장 체육 진흥 회장 지금 홀레 진미육성회 회장 그 부터는 초등학교 하고 그 애들 중학교 가면 중학교 가도 가서 또 그것도 회장그럼 회장만 삼년 하면요 농촌에 송아지 한 마리씩 팔아 먹어야 돼요
시방 똔 한 오거 사 오뱅만 내삐러야 돼요	지금 돈 한 오거  만원 내버려야돼요
왜냐 그리고 회장이 마리먼 애들 체육 때회 가머는 가서 점시미나 한 근 사야지	왜냐 그리고 회장이면 애들 체육 대회 가면 가서 점심이나 한 근 사야지
한 도처이 해문 가머는 후원회 회장이 교장하곤 가서 대도 뭗 경비 써야지 그차네요	한도청이 하면 가면 후원회 회장이 교장하고 가서 그래도 뭐 경비 써야지 그러찮아요
또 우승해 가주 오머는 또 회 학뿌형 대표 아니요 오먼 또 그놈들 치다꺼리 해야지	또 우승해 가지고 오면 또 학부형 대표 아니요 오면 또 그놈들 치닥거리 해야지
그또 고등하꾜 또 내가 까지 거 이사꺼리 내가 청소 다 하고 나오고 그러다 보니까 농사 져가주고 다 떠러바쳐가 아들 문데고 술 이렁 거도 어디 갈 때 마터 이 조아하거든 내가	그 또고등학교 또 내가 가지 거 이사꺼리 내가 청소 다 하고 나오고 그러다 보니끼 농사 지어 가주고다 떨어 바쳐서 아들 문데고 술 이런 것도 어디 갈 때 맡어 이 좋아하거든 내가
그 중 이래 그래 가주 마흔 내가 일꼬배 항교 장에 해써요 마흔 일꼬베	그 중 이렇게 그래가지고 마흔 내가 일곱에 항교 장에 했어요 마흔 일곱에
일찍 하션네요	아 일찍 하셨네요
장에 하고 내가 발구 기어드러씨요 요기요 이게 나치래요	장에 하고 내가 발구 기어 드렸어요 요기 요 이게 낯이래요
오기워네 내가 이 년 때 이 년 저네 마꾸 행교 싸움 또 드러와따고 드러가주 이래가지고 내가이 그래깐 마흔 일고베 자에 하고 육씨베 지금 또 지부장을 해따고 지부장	오기원에 내가이 년 때 이 년 전에 맡고 행교 싸움 또 들어왔다고 들어가지고 이래가지고 내가 이 그러니깐마흔 일곱에 장에 하고 육십에 지금 또 지부장을 했다고 지부장
저 정선 행교 지부장을 해따고	저 정선 행교 지부장을 했다고
지부장 하고 요즘 정교 하는데 아이 인제는 기운도 업꼬 시방 하자먼 정교 하자먼 돈 천마 넌이써야 할터인데 아이 그 그거 가주 천마넌 그리 내가 어데 요 불떡 해먼 내가 또 차건지 그건지 그 우러네 정교 허머는 하먼 다 그게 외지긴데 저거 조치마는 내가 지 군 지부장 행거 매데루 결구게는 지부장 차링 거 정교를 삼 년짜리 해따고 삼문녀네	지부장 하고 요즘 정교 하는데  아이 이제는 기운도 없고 지금 하자면 정교 하자면 돈 천만 원 있어야 할텐데 아이 그 그거 가지고 천 만원 그걸 내가 어디 요 불덕을 하면 내가 또  그건 지 그 우리네 정교 하면 하면다 그게 외직인데 저거 좋지만 내가 지 군 지부장 한 거처럼 결국에는 지부장 차린 거 정교를삼년짜리 해따고
돈 오뱅마넌 등록끔 내고 금 자라래요	돈 오백 만원 등록금 내고 그럼 잘 하래요
하능 거 판교 감 서로 조아하고 그러지	하는 거 판교 가면 서로 좋아하고 그러지
근데 정교 할 타는데 인제 저님 하시는 부니 추처늘 한다고 하더라고요 추처림	근교 정교 하는데 이제 전임 하시는 분이 추천을 한다고 하더라고요
아니 그러니까 그 추천 아니 추처늘 바더가주고 바더가지고쓰리 불러글 쐬가주고 될 쩌글지금 선걸 해야조	아니 그러니까 그 추천 아니 추천을 받아가지고 받아가지고 불럭을 쏘여가지고 될 쩍에는 지금 선거를 해야지요
성거를 하능 거	아 선거를 하는 거
아이메푸 그땅 거는 인제 달려 뿌른다 한 사라미먼 낙 출말 하니까 달리 부르건 이트로 당선되지마는 마냑 두 사람에문 선걸 해서 득쩜 득쩜자가 정교허지요 그전 그러케 해따고요	아이메푸 그딴 거는 이제그러셔꾸나그러셨구나
그래가지구 그리키 해서 이 저 사니다 찌게 장 그런 걸 마트머는 돈 쓰러 되는 이리 사회 다지나먼 돈 쓰기 임니다	그래가지고 그렇게 해서 이 저 산에다 지게 장 그런 걸 맡으면 돈 쓰러되는 일이 사회 다 지나면 돈 쓰기 입니다
그 동면 구아미랑기 옌나레 이썬는데	그 동면 구암이란 것이 옛날에 있었는데
동가간	동가간
응 동면 구 구아미	응 동면 구 구암이
거북 구 짜 바우 암 짜 구아미란 사단치를 그런 며 뭐시 링게를 따가주고 이르믈 부쳐가주핸는데 그기 지금 한 사 심년 역싸래요	거북 구 자 바위 암 자 구암이란 사단치를 그런 뭐 링게를 따가지고 이름을 부쳐가지고 했는데 그게 지금 한 사 십년 역사래요
건 어떤 이를 하는 건가요	그건 어떤 일을 하는 건가요
그건 인제 구아미라는 거는 인제 그	그건 이제 구암이란 거는 이제 그
구암회	구암회
구암 회 구암회	구암회 구암회
그래 이 면년 면장이나 지소장 고담 하꾜장 마튼 바가 오머는 그 오먼 싹 꺼 그 구암회 인적 두 군데 이씨요	그래 이 면 년 면장이나 지소장 그 다음 학교장 맡은 바가 오면 그 오면싹 그 구암회 인적 두 군데 있어요
그리 귀향을 맨드러 가주고	그렇게 귀향을 만들어 가지고
면장이나 지회장 가튼 분드리 오먼	아 면장이나 지회장 같은 분들이 오면
응 응 오면 그럼	응 응 오면 그럼
그 지방 유지드리 모여가주고 그래 인제 하는데 그 역싸가 지퍼요	그 지방 유지들이 모여가지고 그래 이제 하는데 그 역사가 깊어요
시방도 거 해요	지금도 그걸 해요
내가 거게도 한 이십칠련 하고 그 면회장 구암 회장 하고 나와써요 내가	내가 거기에서도한 년 하고 그 면회장 구암회장 하고 나왔어요 내가
그래자녀 거 돈 좀 내삐러쓸 꺼 아니요	그래서 거 돈 좀 내버렸을 거 아니요
그러다가 뭐 교장들하고 식싸를 한 번 하자먼 다음 씨방도 돈 한 이삼심마넌 써야지 어데	그러다가 뭐 교장들하고 식사를 한 번 하자면 다음 지금도 돈 한 이 삼십만원 써야지 어디
안 갈려면 또 똔 시번 내놔야지	안 갈려면 또 돈 십 만원 내놔야지
차 한 대 불러까 댕기야지	차 한 대 불러 다녀야지
그러지 또 정선 우리 대종회 우리 십칠 때 대종회 우리 친구가 거 먼저 회장을 먼저 회장을내가 또 삼 년 해 가주고 정서는 입쩡선 하라버지 신도비 신도비 천만 개를 가주고 하낟 해 걸립 해 세워꼬	그렇지 또 정선 우리 대종회 우리 십칠 대 대종회 우리 친구가 그거 먼저 회장을 먼저 회장을 내가 또 삼 년 해 가지고 정선은 입정선 할아버지 신도비 신도비 천만 개를 가지고 하나를 해 걸립 해 세웠고
뭐 사회 활똥을 또 마니 하션네요	예 뭐 사회 활동을 또 많이 하셨네요
내 노요 정선 우리 메사도니 거또 여든 해꼬 그래 군데 군데 거 그래 가주 인제 대한노인회어 동면호 부뇌장을 내 장녀네 해 놔써요	내  정선 우리 메사돈이 그것도 여든 했고 그래군데 군데 거 그래 가지고 이제 대한노인회동면호 부뇌장을 내가 작년에 해 놨어요
그래 요 이 미테 품 저근 디 그 미술관 하꾜 아페 그 우에 이친데 우엔 마을 회관이고 미테아래층에는 거 사십 평인데 거 경로당 내가 초대 회장으로 내가 그 그 노인회를 육씹오 세 이상 우리 정회원 육씹 쎄 이상은 준회원 맨드러서 칠씸 명을 아래똥에 맨드러 가주고 내 초대회장을 해서 그게 군수한테 내가 쫄라 가주고 경로당 하나 한 이럭 이럭 어더 가주고 거다 딱제 노코 나와 나와써요	그래 여기 이 밑에 품 적은 데 그 미술관 학교 앞에 그 위에 이층인데위에는 마을 회관이고 밑에 아래층에는 거기가 사십 평인데 거기 경로당 내가 초대 회장으로 내가 그 그 노인회를 육십오 세 이상 우리 정회원 육십 세 이상은 준회원 만들어서 칠십 명을 아래동에 만들어 가지고 내 초대 회장을 해서 그게 군수한테 내가 졸라 가지고 경로당 하나를 하일억 일억 얻어 가지고 거기에다 딱 지어 놓고 나와 나왔어요
거가메 초대 내 회장 사 사진도 걸려이쪼	거기 가면 초대 내 회장 사 사진도 걸려있죠
그래고 여기는 여이 분교라고 그래도 이거 동리불 시켜따고 또	그리고 여기는 여기가 분교라고 그래도 이거 동립을 시켰다고 또
동리불 시켜 가주 요 요 따 따룯 걸해 가주구 사 이 이 키로 한 오백 뙤거든뇨	독립을 시켜가지고 요 요 따로 그걸 해 가지고   키로 한 오백 되거든요
거레가 머니까 모까꼬 요	거리가 머니까 못 가고 여기
분교를 뒤 따러서는 또 군수헌테 모 이러게 쫄라 가시거난 동리불 시켜서	분교를 뒤 따라서는 또 군수한테 뭐 이렇게 졸라 가지고는 독립을 시켜서
참 거레 가면 또 제 놔짜나	참 거기에 가면 또 지어 놨잖아
그럼 예저네 땅은 어트케 확뽀를 하싱 거에요	그럼 예전에 땅은 어떻게 확보를 하신 거에요
그건 금 모 동네 도느로 사찌 뭐	그건 그 뭐 동네 돈으로 샀지 뭐
동네 도느로 사서  그럼 진능 거는 어디에	아  동네 돈으로 사서  그럼 짓는 거는 어디에
찐능 거는 거주쿠 그래 가주 이럭 저 사먹 드러써 사먹	짓는 거는  그래 가지고 일억 저삼억 드렀어 삼억
군 구네 구네서 제따가 이제 구네서 구	군 군에 군에서 지었다가 이제 군에서 구
지원해 주나요	지원해 주나요
지원해 끄럼	지원해 그럼
일딴 우린 모 궁미네 세그므로 써	일단 우리는 뭐 국민에 세금으로 써
그러케 그럼 그 그러케 하고 인제 면회장을 이 년 마저 마치고 이제는 이제는 한 땐 이젠 아유 고드라고 아푸로 내 여생에 인제 오늘가치루 해가주 이기 뭐 시방 이젠 얼마에 마냑 고기들마해 된다해도그 그 양반 아국싸란 안 할끼 아니요	그렇게 그럼 그 그렇게 하고 이제 면회  장을 이 년 마저 마치고 이제는 이제는 한 때는 이제는 아유 고드라고 앞으로 내 여생에 이제오늘가치 해 가지고 이게 뭐 시방 이제 얼마에 만약  된다고 해고그 그 양반 아국싸란안 할 꺼 아니요
그 양반 뭐 그래도 단단하구만 어제 그제 그 껄껄한데 도라가셔따 이러지	아 그 양반 뭐그래도 단단하구만 어제 그제 그 껄껄한데 돌아가셨다 이러지
고재시기 나꿈서글 안는다고	아 고재식이  안 한다고
그래 인제는 옌나레는 육씨비먼 다 이 씨는다구 칠씹까지가 어려워	그래 이제는 옛날에는육십이면 다 이 쉰다고 칠십까지가 어려워
너무 오래 살때메 고려 고려장이 이써꼬 고려 해라 해따고	너무 오래 살기 때문에 고려 고려장이 있었고 고려 하라고 했다고
그래 인제는 그래서 내 몸 괄리만 하구 사는데 까진 인제 뭐 아들 여위되고 그래 인제 이 정도먼 군제에서만 감사를 감사를 하라 구래찌	그래 이제는 그래서 내 몸 관리만 하고 사는데 까진 이제 뭐 아이들 여의었고 그래 이제 이 정도면 군제에서만 감사를 감사를 하라 그랬지
인처네 군제 채기미 감사 채기미 감사라고 이제 그 그건 가뚜이치	인천에 군제 책임이 감사 책임이 감사라고 이제 그 그건
그거또 인제 내 이르믄 끈나 끈나믄 제 내 그 삭 롤래 롤래 면회장도 해꼬 뭐이 내 내 소느로 다해서 올해 하먼 십 그 진자게 십 올해 시비 년 짼데요	그것도 이제 내 이름은 끝나 끝나면 제 내 그 삭 롤래 롤래 면 회장도 했고 뭐 내 내 손으로 다 해서 올해 하면 십 그 진작에십 올해 십이 년 째인데요
내가 이 집 이 집 진는데 도니 시쪼 저기 저기 저기 이층인도 내 제짜네요	내가 이 집 이집 짓는데 돈이  저기 저기 저기 이층도 내가 지었잖아요
거 고아미 절 이쪼	거 고암이 절 있지요
저 그 그 내가 저 집 지꼬 저거 선사 바든긴데	저 그 그 내가 저 집 짓고 저거 선사 받은건데
그래서 지까 깨끄타네요 시꾸가  엄는데	그래서 집이 깨끗하네요 식구가  없는데
일도 쫌 이거 쩌거 뭐야 농업 주태글 젠는데 이거 이거 서울 싸라미 와 제써요	아 일도 좀 이거 저거 뭐야 농업 주택을 지었는데 이거 이거 서울 사람이 와서 지었어요
그래서 이 전소가 이 전속 뭐이 머 이층 먼때 져	그래서 이 전소가 이 전속 뭐 이층 먼저지어
옹벽 웅벽 치구 옹벼글 하구서는 님깍썬 뭐이 머 좀 해와 벽똘 행거요	옹벽 웅벽 치고 옹벽을 하고서는 님각선 뭐 뭐 좀 해와 벽돌 한거요
그때 마쳐 싱냥 시비 년 저네 연시 이뤌 뜨러와써 이럭	그때 맞혀 식냥 십이 년 전에 연시일월 드러왔어 일억
오 오 단단하게 잘 지어써요	오 오 단단하게 잘 지었어요
그래서 그래서 나 제가 자수성가게 자수	그래서 그래서 나 제가 자수성가야 자수 스스로 여 짜 성수 짜 성 스스로 소늘 뫄 가주 그래 그래 가주 내가 그 어려서 내가 수물셀 결혼 시글 수물 서에 해 가주고 저 스물 넫 다서세 딸 하나 나코 스스로 여 자 성수 자성 스스로 손을 모아 가지고 그래 그래 가지고 내가 그 어려서 내가 스물 셋 결혼식을 스물 셋에 해 가지고 저 스물 넷 다섯에 딸 하나 낳고
구 년 전	구 년 전
그 그 당시에는 쪼끔 느즈션네요	그 그 당시에는 조금 늦으셨네요
느저 느저찌 그럼 우리 나크 모 그때는 열아홉 열려덜 이십 쓰기면 다 장가가고 시집 깐는데 그래 난 그때 마니 느저찌	늦어 늦었지 그럼 우리 나 크 뭐 그때는 열아홉 열여덜 이십  씩이면 다 장가가고 시집 갔는데 그래 난 그때 마니 늦었지
어르시는 그 형 그 어르시네 형제는 어트게 되세요	어르시는 그 형 그 어르신의 형제는 어떻게 되세요
사형제	사형제
그중에 며째세요	그중에 몇째세요
내가 둘째	내가 둘째
근데 이케 느께 가신 가싱 거에요	아 근데 이렇게 늦게 가신 가신 거에요
끄럼	그럼
그래머는 내 아들 내 아들 하나두 내 수물 아호베 난는데 뭐요	그러면 내 아들 내 아들 하나도 내가 스물 아홉에 났는데 뭐요
올 오시비먼 그차네요	올해 오십이면 그렇잖아요
수물 여덜 그 카먼 마짜네요	스물 여덜 그렇게 하면 맞잖아요
칠씸 여덜	칠십 여덜
지금 이래 생가카머는 메태 저네는 야 열쌀 머거 학꾜 댕길 시절 뭐 어데 뭐 하튼 저레 무네가져 가무 가무는 환하께 어제 그제 거튼데 요새 생가카니까 또 아주 가메	지금 이렇게 생각하며는 몇 해 전에는 야 열살 먹어 학교 다닐 시절 뭐 어디 뭐 하튼 절에 문에 가져 가면 가면환하게 어제 그제 같은데 요새 생각하니까 또 아주 까매
요새 생가카머는 옌나레 학꾜 댕기고 뭘 하고 뭘 하고 청년 시더이 아주 아주그게 꾸민지 어트칠 내 이런 생각해	요새 생각하며는 옛날에 학교 다니고 뭘 하고 뭘 하고 청년 시절이 아주 아주그게 꿈인지  내 이런 생각해
한 심년 심년 저네 한 십 정도 돼쓸 쩌는 칠씹 저네는 내가 열뚜 살 머거선 뭘해따	한 십년 십 년 전에 한 십 정도 됐을 적에는 칠십 전에는 내가 열두 살 먹어서는 뭘 했다
열 따섣 쓰머는 뭘 해따 뭘 해따 그게 아줌 이상하게 머리 떠 오르고 막 어제 그제 행 거테이래게 인제는 그걸 생강 야 내가 그건 핸는지 안 핸는지 생활이씨 그래 그래	열 다섯 이면 뭘 했다 뭘 했다 그게 아주 이상하게 머리에 떠 오르고 막 어제 그제 한 것처럼 이렇게 한게 이제는 그걸 생각 야 내가 그건 했는지 안 했는지  그래 그래
그러케	아 그렇게
그니까 오래 사라딴 얘기야 하먼	그러니까 오래 살았단 얘기야 하면
그래도 뭐 정정하신데요	그래도 뭐 정정하신데요
보먼 보먼 탕제 거기가 하먼 팔 칠씹 한 팔려늘 사라따고 봐서는	보면 보면 탕제 거기가 하면 팔 칠십 한 팔 년을 살았다고 봐서는
네 근데 어르시는 그러며는 거기서 인제 둘째로 태어나셔짜나요	네 근데 어르신은 그러면거기서 이제 둘째로 태어나셨잖아요
그러며는 태어나셔서 어트게 결호는 하싱 거에요	그러면 태어나셔서 어떻게 결혼 하신 거에요
조선 옌나레는 그거지 모 중매 결혼하지 중매	조선 옛날에는 그거지 뭐 중매 결혼하지 중매
누가 중매를 서써요	누가 중매를 섰어요
그새 그러다보먼 저 시방은 자기네찌리 헌재 어데 회사가틍 거 처녀 하 그래 총가카 그르  지 자기네찌리 모 서로가 뭐시 보고 하지만 우리 우리 시저레는 그때만 해도 외 청신 애비라고또 중신애비	아 그새 그러다보면 저 시방은 자기네끼리 현재 어디 회사같은 거 처녀하고 그래총각하고 그러지 자기네까리 뭐 서로가 뭐를 보고 하지만 우리 우리 시절에는 그때만 해도 외청신 애비라고 또 중신 애비
새서 인제 양쪼글 인제 해 주르메 저 실랑 찌비 중신애비가 저쪽 색씨가 이쓰니까두루 색씨가도 실랑짜리가 이쓰니까 또 당신 딸 끄중에 줄라나 뚜리 자꾸 댕기미 열라캐서 준당 거 학 허라기요 허락 허락	사이에서 이제 양쪽을 이제 해 주면 저 신랑 집이 중신애비가 저쪽 색시가있으니까 색씨한테도 신랑자리가 있으니까 또 당신 딸 그중에 줄려나 둘이서 자꾸 다니며 연락해서 준다는 거 허락이요 허락 허락
허락 허락 빧어짜나요 뭐	허락 허락 받었잖아요 뭐
그 그런 사라미 따로 이써요 중신애비가	아 그 그런 사람이 따로 있어요 중신애비가
그럼 이써 따로 이찌	그럼 있어 따로 있지
그럼 중신애비 뭐 친구를 친구 찌비 아치 뭐 이 사라마 우리 아들 장개 보내게 기준네 따네그 지바네 그 머 메춘 딸 이찌 안는가 그거 전 그거 저쪽 찌비서 이써쪼 그래먼 가 중신 해 주구 그래구 그 또 뭐 고 고모 고모 누나 매형 뭐 그이 그런 그럼 또 이러케 줄래줄래 해서 가고 그래 줄래 줄매기라구 주래 줄매기라구 해짜나 중매	그럼 중신애비 뭐 친구를 친구 집이아침 뭐 이 사람아 우리 아들 장가 보내게 기준네  그 집안에 그 뭐 몇촌 딸 있지 않은가 그거 전 그거 저쪽 집에서 있었죠 그러면 가서 중신 해 주고 그리고 그 또 뭐 고 고모 고모 누나매형 뭐 그런 그럼 또 이렇게 줄래줄래 해서 가고 그래 줄래 줄매기라고 주래 줄매기라고 했잖아 중매
그래 요 메천 석 옌나레 쌀 그르주	그래 이 몇천 석 옛나레는 쌀을 그렇게 줘
옌나레는 처녀가 실랑 어데 보고 가써요	옛날에는 처녀가 신랑 어디에 보고 갔어요
지끄 행녀체 행녀 처에 처래에 나가쓸 쩌게	지끄 행례체 행례 처에 처래에 나갔을 적에
행녀초래요	행려초래요
응 잉여들미 상넝쓰구 고 행녜 행녜라구 행녜	응 잉여들고 상넝쓰고 그 행례 행례라고행례
실랑이 그 각씨 찌불 가 가자네 각씨 찌불	신랑이 그 각기 집을 가 가잖아 각시 집을
거 가 가주고 그 각씨가 나와 가주고 사모관대 그 난 난 간 거서 거서 융녜를 하자네요	거기 가 가지고 그 각씨가 나와 가지고 사모관대 그 난 난 간 거기서 거기서 융례를 하잖아요
홀기 부리며서 그래서 저거 부부가 되는 거지 모	홀기 부르면서 그래서 저거 부부가 되는 거지 뭐
옌나레는 그런 모까	옛날에는 그런 못 가
그래 서울 갈 쩍 인저 아라리가 시집 가고 장개 가는 데 홀기는 왜 불러	그래 서울 갈 적에이제 아리랑이 시집 가고 장가 가는데 홀기는 왜 불러
그게 홀게가 이꺼든	거기에 홀게가 있거든
홀게요	홀게요
홀기 부르는 이짜네요 홀기	홀기 부르는 있잖아요 홀기
홀기 부리 뭐에요	홀기 부리 뭐에요
홀기라는 건 말하자면 저 그 어디 제 저 제사 쩐 뭐라먼 뭐 절 해라 향 피우란 시그루 홀기라능 기 그 가머는 그 짐명이라능 게 이써 짐뫼	홀기라는 거는 말하자면 저 그 어디 제 저 제사 전 뭐라고 하면 뭐 절 해라 향 피우란 식으로 홀기라는 게 그 가며는 그 짐명이라는 게 있어 짐뫼
그게 인제 진 사라미 그 시 실랑 입짱 씨겨 가주고 고 담 천선 계배 나와가지구 인제 실랑  이 항녜 아페 인제 손 씨꼬 제배 저를 두 번 한단 말 인제 여게	그게 이제 지은 사람이 그 시신랑 입장 시켜 가지고 그 다음 천선 계배 나와 가지고 이제 신랑이 항례 앞에 이제 손 씻고제배 저를 두 번 한단 말이야 이제 여기에
서로 저 나와서 예를 바침니다 두 번 하고 도로 서 가주고 또 인제 한 번 하먼 신부가 또 함번 하고 고 다멘 또 맏 마쩔 하구 고 다메 또 뭐시 하구 고 다메 서로 담 담례라고 서로 이쪼게 시 신부가따 붜주먼 실랑이 머꼬 또 실랑이 퍼지래먼 요 밸 머꼬 그래 융례라고 저를 여서뻔 한단 얘기여	서로 저 나와서 예를 바칩니다 두 번 하고 도로 서 가지고 또 이제 한 번 하면 신부가 또 한 번 하고 그 다음에 또 맏 맏절 하고 그 다음에 또 뭐시하고 그 다음에 서로담 담례하고 서로 이쪽에 시 신부갔다 부어 주면 신랑이 먹고 또 신랑이 퍼주면 이 밸 먹고 그래 육례라고 절을 여섯 한단 얘기야
그래 시집 시집 소리가 이짜내 노래가 시집까고 장개 갈 쩌게 홀기는 왜 왜 불러	그래 시집시집 소리가 있잖아 노래가 시집가고 징가갈 적에 홀기는 왜 왜 불러
마메 이꼬 뜬만 이씨면 뱅 년 아느로 살지	맘에 있고 뜻만 있으면 백 년 안으로 살지
그래깐두루 홀기를 안 불러도 백 마메 마음만 이씀 사는데 홀기 부른다구 마메 엄는 살겐느냐	그러니까 홀기를 안 불러도 백 마음에 마음만 있으면 사는데 홀기 부른다고 마음에 없는데 살겠느냐
옌날 그러케 지은 노래가 이따고	옛날에 그렇게 지은 노래가 있다고
그 정선 하라버지가 행기 젤 나지	그 정선 할아버지가 지어 놓은 것이 제일 낫지
네 정선 아라리 노래 다 아세요	네 정선 아리랑 노래 다 아세요
알고말고 자라지	아 알고 말고 잘하지
그거 한번	그거 한 번
얘기는 내이거 하능 볼라우	얘기는 내 이거 하는 것 보려우
예 한 번	예한 번
정선아리랑 시집 가고 장개 가는 데 홀기는 왜 불러 어어어어 마메 이꼬 뜬만 이따며는뱅년해로 사알지	시집가고 장가가는데 홀기는 왜 불러 마음에 있고 뜻만 있다며는 백년해로 살지
이거 꼭따마 가시오 이거 가주 오데 가	이게 꼭 담아 가시오 이거 가지고 어디 가
예예아유 고맙씀니다 네	아아예아유 고맙습니다
강원도 아라리	강원도 아라리
이 말고 또 정선아라리 참 머시능게 이따고	이거 말고 또 정선아라리 멋있는 게 있다고
또 어떵게 이써요	또 어떤 게 있어요
꽉차쪼 할라믄	아 꽉 찼지요 하려면
쫌 한번 해주 해주시조 네	아 좀 한 번 해 주 해 주시죠 네
정선아리랑 정선 음내 일백 오시포 한자미 드러 준다며는 공지갈보를 연녀페 찌구 성마려믈 늠짜	정선 읍내 일백오십 호 한 잠이 들어 준다면 공지갈보를 연 옆에 끼고서 성마렴을넘자
그 그 뜨시 멈니까 그곤	그 그 뜻이 뭡니까 그건
그기 정선 으비 시방은 그 이쪽 저쪼그로 이 서 이 역쩐 아푸로 전수가지비 수는 최고아니요 그초	그게 정선 읍이 시방은 그 이쪽 저쪽으로 이 서 이 역전 앞으로 전부가집수가 최고가 아니요 그렇지요
그래 그저네는 정선 으비 정성군 소재지가 백 오시포요	그래 그전에는 정선 읍이 정선군  소재지가 호요
네 네	네 네
지비 백 오시보	집이 호
이로 이오 그래자내요 메토이래자내요	호 호 이러잖아요 몇 호 이러잖아요
백 오시포라고	호라고
그레이 거 거게 인제 자미 그 그 인구가 한잠 폭짜자내 이 전체가	그러니 거 거기 인제잠이 그 그 인구가 한 잠을 푹 자잖아 이 전체가
한참 자몰때	한참 잠 올 때
그럼 그러차너 잠들먼 꽁지갈보라 이찌 꽁지깔보이렁거 이쪼	그럼 그렇잖아 잠들면 공지갈보하고 있지 공지갈보란 게 있지요
꽁지갈보요	공지갈보요
꽁지갈보란 얘기는 색씨라 색씨	공지갈보란 얘기는 색시라 색시
색씨 이 머리 머리 딴 색씨가 이 뒤 꽁 꽁지를 느러 댕기자내요	색시 이 머리 머리 땋은색시가 이 뒤 꽁 꽁지를 내려 다니잖아요
거기 총가기 그거 인제 데리구는 도마을 간다이 도마을	거기 총각이 그거 인제 데리고는도망을 간다니 도망을
모부턴 싸람처럼 가만 가마니 가니까 가만히 자미 고요온 뭐 자니까	뭐가 붙은 사람처럼 가만 가만히 가니까 가만히 잠이 고요히 뭐 자니까
그래 성말 에미라고 평창 댕기는 정선서 평창 절로 해서 저 횽성으로해서 쭉 서울로 가자내요	그래 성말어미라고 평창 다니는 정선에서 평창 저리로 해서 저 횡성으로 해서 쭉 서울로 가잖아요
그 성막 그그 재가 성말고개유	그 성막 그그 재가 성말고개예요
성마렴	성마렴
성마렴 고개	성마렴 고개
성마렴 그럼 시방도 성마려미써요	성마렴 그럼 지금도 성마렴 있어요
성마렴 네	성마렴 네
그래 옌나레 그 건다리 노래요 그게	그래 옛날에 그 건달 노래예요 그게
그래서 거치 여 한치 여 저저 그그 정서네 거치련 그 노래도 이써유	그래서 거칠현 여기한치 여기 저저 그그 정선에 거칠현 그 노래도 있어요
나 하능거 볼라우	내 하는 거 볼래요
네 네	네 네
거칠혀이 치러인데	거칠현이 칠현인데
거칠현 네 알조 네 정선 들어와쓸 때 옌날	아 거칠현 네 알지요 네 정선 들어왔을때 옛날
거거 거치련 거거거 거개 피란하민서 곤드레딱쮜기 쌀	응 거거 거칠현 거기 피란함녀서곤드레딱주기 삶아 먹으면서
곤드레 딱쭈기	곤드레 딱주기
땅떵어리 내 그 내 하느라	땅덩어리 내가 그렇게 내가 하느라
거 거 한치가 동면 한치가 남현 한치라 거 이써요 거게	거기 거 한치가 동면 한치가 남현 한치라는 게 있어요 거기에
그 고리 바루 거 칠허니 우에 고리 한치라고 한치	그 골이 바로 거칠현이 위에 골이 한치라고 한치
정선아리랑 한치 뒤싸네 곤드레딱쮜기가 나지미 만남거따며는 그건만 뜨떠 머거도 보문사러 나네	한치 뒷산에 곤드레 딱주기가 나지미 만남 같다면 그것만 뜯어 먹어도 봄은 살아나네
그 칠허니 양반드리 아무도 업짜네요 씰랑 업쓰니까	그 칠현이 양반들이 아무도 없잖아요신랑 없으니까
그래가서 곤드레 그 딱찌기 뜨떠 가주고 동에 그 무처가주 사나 그 노래 그래해따는기여	그래서 곤드레 그 딱지기 뜯어 가지고 겨울에 그 무쳐 가지고 사나 그 노래 그렇게 했다는거에요
그 나지미 나지미 만낭거떠 얘기는 나지미는 여자라고 하는 얘기요	그 나지미 나짐지 만남 같다는 얘기는 나지미는 여자라고 하는 얘기에요
여 색씨들 정말 그 꼬 까튼 마으미 아니요	여기 색시들 정말 그 꽃 같은 마음이 아니요
응 그 꼰드레 딱찌기가 마시 그 그런 마시라 이기여	응 그 곤드레 딱지기가 맛이 그 그런맛이라는 거야
나지미	나지미
나지미 나지미	나지미 나지미
나지미 마마  자기 그 그 아내그 처녀를 두고 하는 얘기래요	나지미 마마 자기 그 그 아내 그 처녀를 두고 하는 얘기에요
나지미	아 나지미
나지미 맘마	나지미 맘마
거 가따며는	그것과 같다면
가따며는	같다면 예
봄 사러 난다고	봄 살아 난다고
봄 사러 난다	봄 살아 난다
보미 사라 난다구요	아 봄이 살아 난다고요
어 그렁게 마니 이껜네요 그런 노래가	아그런게 많이 있겠네요 그런 노래가
그건뇨 마니 하조 여게는 그래서 그 노래 마니 하지 그 하기 돌쐬가 왜 딱찌기 그 칠헌 칠헌 칠허니 고개 인는 그래 그 거칠허니 요 일곱 냥바니 그 거게 거 걸처 가따고 그 이그래서 갈 꺼 짜에 거칠허니가	아 그건요 많이 하지요 여기는 그래서 그 노래 많이 하지 그하기 돌쇠가 왜 딱지기 그 칠헌 칠헌 칠헌이 고개 있는 그래 그 거칠헌이 여기 일곱 양반이 그거기에 거 걸쳐 갔다고 그 이 그래서 갈 거 자에 거칠헌이가
갈 꺼거칠현	갈 거 거칠현
칠현 칠혀니	칠현 칠현이
네네 칠혀니죠	네네 칠현이죠
그런디 요기 모 또 요기 정선 아라리 이 쥐문 꽉 차도 아라리고 또 요 요 요 이찌 대가찝요기 정서네 그 그 노래가 정서네게두 기푼 노래고 고 담 누니 오느나 비가 오나 그에 가먼 또그거 하고 고 다메 저 저 아우라지 배싸공	그런데 여기 뭐 또 여기 정선 아라리 이걸 쥐면 꽉차도 아라리고 또 요 요 요 있지 대가집 여기 정선에 그 그 노래가 정선에게도 깊은 노래고  그 다음 눈이 오나 비가 오나 거기에 가면 또 그거 하고 그 다음에 저 저 아우라지 뱃사공
그 노래 한 번아가지구	예 그 노래 한 번아우라지
거러선	걸어선
아우라지 백싸공 아저씨이 뱀머리 돌레 주세요 오오 사리 꼬레 올 동바리 다 떠러어 지네에	아우라지 뱃사공 아저씨 뱃머리 돌려 주세요 사리 골에 올 동발이 다 떨어 지네
아하 처녀가 겨우네 기종 그래 그 처녀 동산 해 놔짜네요	아하 처녀가 겨우  그래 그 처녀 동산 해 놨잖아요
네네 고고 마를 말 뜨슬 다시 함 번만 쫌 해주십	네네 그그 말을 말 뜻을 다시 한번만 좀 해주세요
네 아우라지	네 아우라지
그 뜨시 왜냐먼 그 처녀가 그 싸리꼴 거 꼬리 싸리꼴 이꺼든	그 뜻이 왜냐면 그 처녀가그 사리골 거기 골이 사리골 있거든
싸리꼴	사리골
동 동박 이써 동박	동 동박 있어 동박
동박 그 글 따가주고 지름 짜먼 머레에 옌나레는 이 머레에 이래 발라따고 머리 머리에 동박 찌름	동박 그 그걸 따 가지고 기름 짜면 머리에 옛날에는 이 머리에 이렇게 발랐다고 머리머리에 동박 기름
참 비 잘 나써 여기에	참 빛 잘 났어 여기에
냄새 조코 이래 바르는데 거 동막 따러 갈라니까두루	냄새 좋고 이렇게 바르는데 거기 동막 따러 가려니까
무를 올차내야돼 건너 가야 되자네요	물을 올차내야돼 건너 가야 되잖아요
그러니 건너가니까두루 배를 뚝 이 저 짜가 이쓰니까두루 배에 건너 가지지 아네요	그러니건너가니까 배를 뚝 이 저쪽에 있으니까 배에 건너 가지지 않아요
건너가야 처녀가 배를 타고 나가서 동바글 다러 가주 가지유	건너가야 처녀가 배를 타고 나가서 동박을 따서 가지고 가지요
그래 동막 따러 가야 되는데 배를 안 보내주구 가서 동바글 짜이콜로 안 따먼 그 동바기 그뭄께 부서지고 말자나 따에	그래 동막 따러 가야 되는데 배를 안 보내주고 가서 동박을 로 안 따면 그 동박이 그믐께 부서지고 말잖아 땅에
그게 인제 어느 정도 여슬레 따가 따야마이 지르미 나오는데 고만 그거 하루 하루 이틀 사 다쌔 여쌔 가먼 고 푸더비 써제지먼 지름 안 나짜네요	그게 이제 어느 정도 여슬레 따가 따야만기름이 나오는데 그만 그거 하루 하루 이틀 사 닷새 엿새 가면 그 푸더비  기름이 안 나잖아요
그래 그거 처녀가 말핸 거기라고 지금	그래 그거 처녀가 말한 거기라고 지금
배 배싸공 아저씨 배 좀 뱀머리 돌리게 뱀머리 빨쿠네 오라 이기여	배 뱃사공 아저씨 배좀 뱃머리 돌리게 뱃머리 빨리 오라 이거야
싸리 싸리꼴 올랑방이 다 떠러지네	사리 사리골 올랑방이가 다 떨어지네
거기 또 마디 고거 말고도 또 이떤데	아 거기에 또 말이 그거 말고도 또 있던데
또 누니 올려나 비가 올라 그 이찌	아 또 눈이 올려나 비가 올려나 그거 있지
누니 올라나 비가 올라나 억쑤 장마니 한 번 널컥 찔랄 언제 만수산천 거문 구루문 왜 모여어 드나아	눈이 올려나 비가 올려나 억수 장마가 한 번 털컥 질 날이 언제 만수산천 검은 구름  이 왜 모여 드나
그기 세 가지가 자랑이지 그 우리 그 정선 하라버지에게두 본 본터에 노래조	그 세 가지가자랑이지 그 우리 그 정선 할아버지에게도 본 본터에 노래지요
고거는 어떤 뜨세 누니 오나 그 뜨슨뇨	아 그거는 어떤 뜻에 눈이 오나 그 뜻은요
그 누니 요 그리 왜냐 오머는 이거 다 거칠혀니 그 하는 그 이 옌날 마리라고	그 눈이 여기에 그렇게 왜 오냐면 이거 다 거칠현이 그 하는 그 이 옛날 말이라고
한 이틀 싸라미 한다고 그 칭구 마나따나 시커먼 구루미 모여 들기를 칭송은 나메거이 되거든	한 이틀 사람이 한다고 그 친구 말마따라 시커먼 구름이 모여 들기를 칭송은 남의 것이 되거든
어떤 구루미요	어떤 구름이요
시커먼 구루미 비구룸 눙구룸 망 모여 들더니 그 참 비가 올라나 누니 올라나 구룸도 너무모여 드니까 만수산천 응 거문 구루미 왜 모여 드니 이기여	시커먼 구름이 비구름 눈구름 막모여 들더니 그 참 비가 올라나 눈이 올라나 구름도 너무 모여 드니까 만수산천 응 검은 구름이 왜 모여 드냐 이거야
네네	네 네
그 번개 구룸도 하두 마니 모여 들고 뭐 비도 마니 오고 인제 그러되니까두루 하두 일기가그러니 진 노래가 응 그래 누니 올라나 비가 올라나 끄차네요	그 번게 구름도 하도 많이 모여 들고 뭐 비도 많이 오고 이제 그렇게 되니까 하도 일기가 그러니까 지은 노래가 응 그래 눈이 올려나 비가 올려나 그렇잖아요
옥쑤 장마이 치야 모여드능 거 보니까는 탁 날리가 나께께거든	억수 장마가 쳐야 모여드는거 보니까 탁 난리가 나겠거든
그래 억쑤 억쑤 여 보먼 억쑤장마 무리 마니 옴 억쑤라 그러지 억쑤루 오더냐 억쑤장마이지누나	그래 억수 억수 여기 보면 억수장마 물이 많이 오면 억수라 그러지 억수로 온다냐 억수장마가 지는구나
만수산 꼭때기에 거노문 만수사니라고 저 저 사는 상 꼬때기 상 꼬때기 그륻 이륻 구룸 머리댕 보이자네요	만수산 꼭대기에 거기에   만수산이라고 저 저 산은 산 꼭대기 산 꼭대기그 이 구름 머리댕 보이잖아요
어트케 왜 모여 드나 왜 그러케 모여들구 캄캄한 버드먜기여	어떻게 왜 모여 드냐 왜 그렇게 모여들고 캄캄한
그런 그기다 그이 그 칠현 칠허네 하는 소리야	그런 그게다 그 이 그 칠현 칠현에 하는 소리야
그럼 이  우리 그 정선 아라리가 만 차나요	아  그럼 이  우리 그 정선 아라리가 많잖아요
만치 아이구이 전 정선 아라리는 전 싹 치잉거래요 싹	많지 아이구 저 정선 아라리는 전부 싹 치인거래요 싹
우언 여적 하는 지꺼리	원 여적 하는 짓거리
동네마다 지끼도 하고 그러겐네요	동네마다 짓기도 하고 그러겠네요
그러면 그 뭐 뭐 뭐 뭐 막 찌끄럼	그러면 그 뭐 뭐 뭐 뭐 뭐 막 짓지 그럼
그럼 인제 제일 유명항게 그아까 얘기요 싸리꼴 올동마기	그럼 이제 제일 유명한 게그아까 얘기요 사리골 올동막이
응 응 그 해요	응 응 그 해요
그 까마지 백싸공 노래 하나 그 다음 인제 누니 올라나 비가 올라나	그 까마지 백사공 노래하나 그 다음 이제 눈이 올려나 비가 올려나
한치 뒤 상끼스게서 공덕 딱찌기	한치 뒤 산기슭에서 공덕 딱지기
한치 뒤싼 곤덜 딱찌기 고 고게 인제 세 개가 가장 유명한 거에요	예 한치 뒷산 곤덜딱지기 그 그게 이제 세 개가 가장 유명한 거에요
유명하조 아주 그럼	아 유명하지요 아주 그럼
그거또 이미 이짜네요	그것도 의미 있잖아요
거기 아니 이래 걷 한치 뒤싼 곤덜 딱찌기가 칠헌 양바니 뜨더 머글 시저레 그 양반니 그 그피 말한 피라미 피라미 그 피라노면 피라미먼 그 서인 드리 정서네 서인드리 그 정차글 하미해따는 노래가 그기 그 노래고	거기 아니 이래 거 한치 뒷산 곤덜 딱지기가 그 칠현 양반이 뜯어 먹을 시절에 그 양반이 그 그 피 말한 피라미 파라미 그 파라노면 피라미면 그 성인들이 정선에 성인들이 그 정착을 하며 했다는 노래가 그게 그 노래고
또 여 아우라지 백싸 고거는 처녀가 그 동막 따 따서 지름 머리에 바르는 그 역싸를 가진 그함 오래되찌 수시미 수 수처니라 할 쑤 이쪼	또 이 아우라지 백사 그거는 처녀가 그 동막 따따서 기름 머리에 바르는 그 역사를 가진지 그 함 오래 됐지 수심이 수 수천이라 할 수 있지요
거서 제나온 노래구 끄 그 누니 오나 비가 올라나 하며 곤덜 딱찌기 따먼 들구 댕기면서 하두 워낙 그 기 병 이꺼든 머꾸 머꾸루미 막 모여드니까 머꾸미랜 시커먼 먹꾸루미라 그리구 그래깐두루 그래 노래가 하머 제저쪼	거기에서 지어 나온 노래고 그 그 눈이 오나 비가 올라나하며 곤덜 딱지기 따면 들고 다니면서 하도 워낙 그 기 병 있거든 먹고 먹구름이 막 모여드니까먹구름이란 시커먼 먹구름이라 그러고 그러니까 그래 노래가 하며 지어 졌지요
고 세개가 인제 대표저그로 마니 불러	그 세 개가 이제 대표적으로 많이 불러
그럼 대표저기조 그러먼	그럼 대표적이이지요 그러면
땅거래는 막 끌구 땅거래는 아께 여 저 저 저 머야 정선어매 여내하고 시포 건 건달들 노래고	땅거래는 막 끌고 땅거래는 아까 여 저 저 저 뭐야 정선어미 연애하고 싶어 그건 건달들노래고
건달 건달	건달 건달
건달 이 술 먹 김사까시 건다래 김사깐 얘기 드러 봐씨요	건달 이 술 먹고 김삿갓이 건달이야 김삿갓 얘기 들어 봤어요
김삳 김사깓 왜 요건 김사까로 치키	김삿 김삿갓 왜 이건 김삿갓으로
네 이당게 여 젇 젇 글 지꼬 그런 그런 그런 그런 자까들 노래지 뭐	네 이렇게 여 저 저 글짓고 그런 그런 그런 그런 작가들 노래지 뭐
그 만치 모	그 많지 뭐
월래 그 말코 또 또 노래 이써요	원래 그거 말고 또 또 노래 있어요
꽉 차찌 아이 그래간두루	아 꽉 찾지 아이 그러니까
쪼금만 더 불러주세요 며깨 며까지만 더 그 설명도 좀 해주시구 재민는데요 네	조금만 더불러주세요 몇 개 몇 가지만 더 그 설명도 좀 해 주시고 재밌는데요 네
그 굉장히 그거 중요한 그 자룐데요 보존자료로	그 광장히 그거 중요한 그 자료인데요 보존자료로
아시는 거 쫌 다 해주시 주시조 네	아시는 것 좀 다 해주시주시죠 네
고건만 좀 정말 보고인데	그건만 좀 정말 보고인데
그런데 세가지 이거는 참 상당히 괜차는거라	아 그런데 세 가지 이거는 참 상당히 괜찮은 거라
또 어떤	또 어떤
아까 그 장개가고 시집까는 그거또요	아까 그 장가가고 시집가는 그것도요
그거또 그 그 이미가 인능거래요	그것도 그 그 의미가 있는 거에요
어떤	어 어떤
장개가고 시집까는데 홀기는 왜 불러	장가가고 시집가는데 홀기는 왜 불러
고거 다시 함 범만 한 번	아 그거 다시 한 번만 한 번
장개가고 시집까는데 홀기는 왜 불러	장가가고 시집가는데 홀기는 왜 불러
마메 이꼬 떵만 이씨먼 뱅녀늘 살자능교	마음에 있고 떡만 있으면 백년을 살자는 거에요
홀기를 안 불러도만 백싸리 마메 이꼬 떵만 세는데 홀기 부른다 해서 마메 엄는 걸 살겐느냐	홀기를 안 불러도 백살이 맘에 있고 떡만 세는데 홀기 부른다 해서 마음에 없는 걸 살겠느냐
그런 그 노래라 그거는	그런 그 노래라 그거는
그차네요	그러찮아요
내가 예로소 처녀다	내가 예로서 처녀다
그럼 김교수가 저 뭐시기 뭐야 초 총가기다	그럼 김교수가 저 뭐 뭐야 초 총각이다
나 결혼식 하던 해 정철슴찌 쩌이 그 서로 서로 채 가서 홀기 부리머 행렬하자나요	나 결혼식 하던 해에  그 서로 서로 채 가서 홀기 부리며 행렬하잖아요
행꺼 행게라고 한 행녜	행거 행게라고 한 행례
행녜	행례
행녜	행례
행녜하는데  거 암 부러 암 부럴도 그냥 해도 나하구 마메 이쓰먼 사는데 저걸 홀기를 부부 불러도 내가 천눈데 하이고 너는 어쩍 생 생김새도 뭐여 쩨가 여자가끼 안 생겨 이래먼 마미 업짜네요	행례하는데 그거 안 불러 안 불러도 그냥 해도 나하고 마음에 있으면 사는데 저걸홀기를 부 부 불러도 내가 첫눈에 하이고 너는 어떻게 생 생김새도 뭐야 제가 여자같이 안 생겨 이러면 맘이 없잖아요
그럼 요 네 요 납짜요 소굼 하나이 두리 마미 마 마지먼 뱅녀네 산단 얘기가 땅 마찌 하나 이래도 시른 시른 데는 살기가 상당히 거부카자네요	그럼 이 네 이 납짝 소금 하나 둘이 마음이 마 맞으면 백년을 산단 얘기가 딱 맞지 하나라도 싫은 싫은 데는 살기가 상당히 거북하잖아요
그래 그 노래 젠 거시 바로 그 처녀가 젠 거시 그 융녀니 지응 거 거기라고	그래 그 노래지은 것이 바로 그 처녀가 지은 것이 그 육년이 지은 거 거기라고
시집까고 장개가는데 홀기는 왜 불러	시잡가고 장가 가는데 홀기는 왜 불러
마메 이꼬 떵만 이씨머는 뱅녀늘 하먼서 사는데	마음에 있고 떡만 있으면 백년을 하면서 사는데
근데 그 홀기른 마지 그 그 한 우리 마링가 홀기라능게 그 한짱가요	근데 그 홀기란 말이그 그 한 우리 말인가 홀기라는 게 그 한짠가요
홀기	예 홀기
어떠케 쓰나요 홀기가	어떻게 쓰나요 홀기가
어떤	어떤
홀기랑게 저	홀기라는 게 저
혼짜 혼 짜를 쓰나요	혼자 혼 자를 쓰나요
아니 아니 아니	아니 아니 아니
저 저건 내아따가 드리께요	저 저그건 내 이 이따가 드릴게요
요 내가 이저 뼈련데	이거 내가 잊어 버렸는데
그 뜨시 무슨 뜨시에요 홀 짜가	그 뜻이 무슨 뜻이에요 홀 자가
기 짜는 이 기 짜	기 자는 이 기 자
그건 그건 기로칼 기 짜네요	아 그건 그건 기록할 기 자네요
홀 짜는 무슨 뜨신가요	홀 자는 무슨 뜻인가요
홀께 홀끼라니 머는	홀게 홀기라는 뭐는
근데 홀기 제가 정화칸 으미를 제가 아직 파아기 안 돼서	아 근데 홀기 제가 정확한 의미를 제가 아직 파악이 안 돼서
아니 아니 저 저 저게 이씨요 저게 저 저 채게 저 이따고 홀기라고	아 아니 아니 저 저저기에 있어요 저기에 저 저 책에 저기에 있다고 홀기라고
그에 정선 하라비가 고거 인제 건제 내 쉐가지 세가지 뿔르구 그 누니 오나 비가 올라나그 또 그 다옥 그거또 한 칠 때이써 꼰데떡찌기 하구 마우라지 배싸공하 고거는 그 하두 옌날씨기로 유명해 그 참 하여튼 뜨끼 이꼬 또 칠헌 칠헌 거는 성인드리 불런 아라리 제는 기 직쩝 곤드레 딱찌기 따 머기먼서 젠 그런 노래고 그러코 고 다메 미역 꼬 보토이로 막 떠드릉거는 그럼 자까드리 우리 그냥 건달드리 막 그렁거야 근 저 저 드러보먼 머 노래 그 정선 아라리 참 가간 쪼자너시	그게 정선 할아버지가 그거 이제 그거 제 내가 세 가지 세 가지 부르고그 눈이 오나 비가 올라나 그 또 그  그것도 한 칠 대 있어 곤데 떡지기하고 아우라지 뱃사공 하 그거는 그 하도 옛날식으로 유명해 그 참 하여튼 뜻이 이꼬 또 칠현 칠현 그거는 성인들이 불른 아라리 지은 것이 직접 곤드레 딱지기 따 먹이면서 지은 그런 노래고 그렇고 그 다음에   막 떠드는 것은 그럼 작가들이 우리 그냥 건달들이 막 그런거야 근데 저 들어보면뭐 노래 그 정선 아라리 참 그건 좋잖아
뭐 어르시니 알고 인능 거 또 어떵 게 이쓰세요	뭐 어르신이 알고 있는 거 또 어떤 게 있으세요
내 절머서 술 머꼬 댕기며 노래 부름 꽉 차찌	내 젊어서 술 먹고 다니며 노래 부름 꽉 차지
색씨들 저 처녀들 색 술찌베 새벼기 파는 써따 안저노코 함마디 함 꽉 차찌	색시들 저 처녀들 색 술집에  파는  앉아 놓고 한 마디 하면 꽉 차찌
건전한 거는 업 업써요	건전한 거는 없 없어요
알지 이찌	알지 있지
어떵 게 또 이써요	어떤 게 또 있어요
그냥 당구 구래 그 대가 이꼬 대가 인는데 인제 옌나레 인제 그 마게 어른드리 그래 우리나기 저네 인제 우리 하라버지 씨드른 얘기 가운데 이 삼처게 강능에 소굼 지러가지 소굼	그냥 당구 그래 그 대가 있고 대가 있는데 이제 옛날에 이제 그 마을에 어른들이 그래 우리 나기전에 이제 우리 할아버지들 얘기 가운데 이 삼척에 강능에 소금 지러자기 소금
옌나레 소굼 이 지게루 지게 저다 멍는다구 저다가	옛날에 소금 이 지게로 지게 져다 먹는다고 져다가
저다 멍는데 소굼 지러 가머는 가따오다가 인제 중가네 인제 쉬거든	져다 먹는데 소금 지러가면 갔다오다가 이제 중간에 이제 쉬거든
인제 올라 가 가주구 인제 거가 거레가 물문 자고 소구물 인제 사고지곤 지게 질머지고 저백뽕녕 미테서 오능 거는 백뽕녕 삭빠느는 강능짜네 요	이제 올라 가 가지고 이제 거기가 거리가 멀면 자고 소금을 이제 사고 지고는 지게에 질머지고 저 백봉령 밑에서 오는 거는 백봉령강릉 있잖아요
거 인제 여 오다 중멀 하다보먼 인제 주막찌비 이써 주막찌비	거 이제 여기에 오다  하다보면 이제 주막집이 있어 주막집이
마껄리 아페 요 탁쭈가 파는 지비 거 인제 노카 제 한 잔 제 거 어른드리 한 제 미테서 머꼬인제 돈 주고 사머꼬 인제 한 시간 전시도 머꼬 인제 술 사머꼬 인제 그러 한 시간 두어 시간제가줘 인제 도라 온다고	막걸리 앞에 요 탁주가 파는 집이 거기에 이제 노코 제 한 잔 게 거어른들이 한 제 밑에서 먹고 이제 돈 주고 사 먹고 이제 한 시간 전시도 먹고 이제 술 사먹고이제 그렇게 한 시간 두 시간 보내고 이제 돌아 온다고
도라오먼 그거 하는 노래 고러케 이따고 지끔	돌아오면 그거 하는 노래 그렇게 있다고 지금
하하 그럼 그럼 응 그 인제언제 그 인제 젠 제 나중위가 술짱 그 인제 술짱사라지	하하 그럼 그럼 응 그 이제언제 그 이제 지은 제 나중이 술장 그 이제 술장사라고 하지
주모 주모 주모이 주모 술 파는 주모라 구래써 주모	주모 주모 주모 이 주모 술 파는 주모라 그랬어 주모
여 건제 건제 떠나가는 인제 노래 또 하는기 뭐냐먼 그니까 걷 걷 거리에 인는 거리를 인는노래라 그래써	여 거 이제 거 이제 떠나가는 이제 노래 또 하는 게 뭐냐면 그러니까 거 거 거리에 잇는 거리를 잇는 노래라 그랬어
갈라느네 갈지 짜 한 자는 당시니 가지구 가더래도 오실 라아는 올 래짜 한 자는 날 주고 가시요오	갈라는 갈지 자 한 자는 당신이 가지고 가더래도 오신다는 올 래 자 한 자는 나를 주고 가시요
그게 인제 저 이써 가지고 갈 쩌게는 당신 가 가더래두 그 자 가져가때루 내녀네 올 올라는올 래 짜 한 자는 놔두고 가르능기여	그게 이제 저 있어 가지고 갈 적에는 당신 가 가더라도그 자 가져가 내년에 올 온다는 올 래 자 한 자는 놔두고 가라는 거야
그래니까두루 그 쓰리써 놔두구 가능기 아니라 마으므로 꼭 온다는 걸 응 온다는 걸 온다능걸 맘 쏘그로 세기고 가거라그 아랄 한 번 해따고	그러니까 그 쓰고서 놔두고 가는 게 아니라마음으로 꼭 온다는 걸 응 온다는 걸 온다는 걸 맘 속으로 세기고 가거라 그  한 번 했다고
그래 하머는 메 껀 하자네	그래 하면 몇 건 하잖아
그 이 주모 가따 하먼 인제는 그읻 일부러 인제 남자드리 인능 거이 다써씨요 소움	그 이 주모한테 갔다 하면 이제는 그 일부러 이제 남자들이 있는 거 다 썼어요 소금
소굼 좀 아랄 기어오름 이카 머꼬 인제 또 놀파니다	소금 좀   이렇게 먹고 이제 또 놀판이다
그 다비 내 인경어미 그러 해써유 쪽 인자 그 남자 다비	그 답이 내 인경어미 그렇게 했어요 쪽 이제 그 남자 답이
내 떠나 간 뒤에야 도랑무리 뿔꺼든 당시널 놔두구 가느나구 우루 간 줄만 아러라	내가 떠나간 뒤에야 도랑물이 불거든 당신을 놔두고 가느냐고 울면서 간 줄만 알아라
이래 그 대가 되거든	이렇게 그 대가 되거든
그래 인제 그럼 인제 나가서 자기가 쉬워 핵 베끼나 보자고	그래 이제 그럼 이제 나가서 자기가 쉬워 확 벗겨 보자고
그래 노래 인제 그거 그 나 지는 노래요	그래 노래 이제 그거 그 내가 지은 노래요
그래도 고 고 담 또 또 건다래 하나 또 아주묘 하고 노랜 또 머라 하능 기거등	그래도 그 그다음 또 또 건달이 하나 또 아주 하고 노래는 또 뭐라 하는 거거든
한 잔 두 잔 바더다 파는 술 무슨 이무니 이께쏘 제나 저무니 아리 빠라비 목또이 드큭 드르가네	한 잔 두 잔 받아다 파는 술 무슨 이윤이 있겠소     목돈이 덜컥 들어가네
그게 뭔지 아러	그게 뭔지 알아
수를 수를 그 해야지 지베 꼭 강니이 살라내이 누룹 살라내 사다 파는 거 그 가따 저하구  한 되 술 한 되응 삼 처넌 이처넌 바다 크니문 업짜네	술을 술을 그 해야지 집에 꼭 강냉이살라면 누룹 살라면 사다 파는 거 그거 가져다 제하고 한 되 술 한 되 응 삼천 원 이천 원받아 큰 이윤이 없잖아
그르니 인제 그 남자가 하는 얘기가 그걸 한 냄비단 바다다 타먼서 무순 이무니 이껜나 무순소드기 인껜나그 얘기여	그러니까 이제 그 남자가 하는 얘기가 그걸 한 냄비에다 받아다 타면서 무슨 이윤이 있겠나 무슨 소득이 있겠나 그 얘기야
나키나 저 나주어머니 아라리 빠라메 저 나주어머니 노래 잘하거든	저 나주어머니 아라리 바람에 저 나주어머니 노래 잘 하거든
한 번 쐬자능 거 홀짝 반한다 이기여	한 번 쐬자는 거 홀딱 반한다 이거야
그럼 노래 빠람 노래 안 들먼 도늘 허또는 주물러 준다구	그럼 노래 바람 노래 안 들면 돈을헛돈은 주물러 준다고
그때 아주메 그걸 그 그 건달 로래라고	끄때 아주머니 그걸 그 그 건달 노래라고
그 뭐 동모 동노래 자버서 동막 준다구요	그 뭐 동모 동 노래 잡아서 동막 준다고요
아유 마지마게 허리추메 인는	아유 마지막에 허리춤에 있는
목똔 목또니 돈 목	목돈 목돈이 돈 목
도니 목또니라능 거는 한꺼버네 탁 트러 간다 이기여어	돈이 목돈이라는 거는 한꺼번에 탁드러 간다 이거야
수른 한 잔 두 잔 한 대먼 한 대깝 두 대먼 두 대깝 이래 주지마는 노래 한 번 하곤 마리요거 춤 아주머니가 노래 하능 거 보니깐 참 잘 하고 뭐 술 파라 팔 킁기 업꺼든	술은 한 잔 두잔 한 대면 한 대 값 두 대면 두 대 값 이렇게 주지만 노래 한 번 하고는 말이요 거 춤 아주머니가 노래 하는 거 보니까 참 잘하고 뭐 술 팔아 팔 큰 게 없거든
그래니깐두루 인제 내가 노래 하면서 주는 도니 그러케 한 움쿰 콱 찌르는 목또니 드러간다능기야 이거 목똔	그러니깐 이제 내가 노래 하면서 주는 돈이 그렇게 한 운쿰 콱 찌르는 목돈이들어간다는 거야 이거 목돈
목또니 드러간다	아 목돈이 들어간다 예
다들 그 설명이 이꼬 재미가 인네 다 어떤 그 유래가 다들 인네요 네	다들 그 설명이 있고 재미가 있네 다 어떤 그 유래가 다들 있네요 네 아
그론 아우 그런 그렁 거 그렁 거만 모아두 정말 으미가 이껜는데요	그런 아우 그런 그런 거그런 거만 모아도 정말 의미가 있겠는데요
나는 뭐 요 요꺼 바러리 가태진제나단 사타 한 다레 뭐 다 하지 꽉 차쓰 껀	나는 뭐 이이거  같아  한 달이면 뭐 다 하지 꽉 찼어 그건
쫌 더 해주세요	아 좀 더 해주세요
인제 모 태 거 네 거	아 이제 못 해 거 네 거
돼써요 돼써	됐어요 됐어
요런 노래도	이런 노래도
바께 노래 노래 세가지 노래 그거만 가따가 어데가서 트러나도 내 음성이 에 이제 늘거서 난거 항갑때 이거 이러서 악 납치가 돼가지구 요 싹 해 새로 너씨요	밖에 노래 노래 세 가지 노래 그것만 갔다가 어디에 가서 틀어 놓아도 내 음성이 에 이제 늙어서 나는 그 환갑 때 이거일어서 악 납치가 되어 가지고 요 싹 해서 새로 넣었어요
그런데 우리 절머서는 이 노랠 이 정선 아리랑 말을 마를 잘 해따고요 오디가 하머는	그런데 우리 젊어서는 이 노래를 이 정선 아리랑 말을 말을 잘 했다고요 어디에 가서 하면
야 우리 절머 이 친구드리 야 너 재시기 한 이 친구 한 번 파해랃	야 우리 젊어서 이 친구들이 야 너 재식이 한 이 친구 한 번 파해라
이처먹써기 가튼 앤데 인제는 늘거서리 이후 모기 가라앙꼬 모기 재들 가수들 봐요	이처먹서기 같은 앤데 이제는 늙어서 이후 목이 가라앉고 목이 재들 가수들 봐요
가수드리 어디 얼구리 얼구리 잘 나서 가수함니까	가수들이 어디 얼굴이 얼굴이 잘 나서 가수합니까
가수드리 보통 얘기하고 노래 부를 쩍 노래 인저 턱 여 터져 나온 달려 나오자네 조케끔	가수들이 보통 얘기히고 노래 부를 적에 노래 이제 턱 이 터져 나온 달려 나오잖아 좋게끔
근데 우리도 이 말할 쩌 보덤 이찌만 이 아라레 하고 한참 이럴 쩨는 상당이 그리고 양산도니미라니 한디 이 참 조응기 이씨요	근데 우리도 이 말할적 보다는 있지만 이 아라리 하고 한참이럴 적에는 상당히 그리고 양산돈이 미라니 한다 이 참 좋은 게 있어요
여 이 저 청춘금 뭐이 뭐 머시기라	여 이 저 청춘금 뭐 뭐 뭐더라
양산도니 뭠니까	양산돈이 뭡니까
양산도두기 저기 여이 이이 이거는 정선 아라리고 아늘 청춘가 그 위네 위노네 이렁 거 이짜네요 이로카 하능거	양산도둑이 저기 여 이 이 이 이거는 정선 아라리고 하늘 청춘가 그  이런 거 있잖아요  하는 거
그런 거거 약 두 양산도 함 이꼬 여러가지가 만치요	그런 거 약 두 양산도 하면 있고 여러가지가 많지요
곡쪼가 얼마 요내기가 하나 하나래 요건 항끼 송끼송꾸윧 한 번 해 가주고 가야 조치	곡조가 얼마 요 내기가 하나 하나야 이건 한 개  한 번 해 가지고 가야 좋지
예 양산	예 양산
아니 저 인저 뭐시 청춘 청춘가 청춘가라 아니요	아니 저 이제 뭐 청춘 청춘가 청춘가라안 해요
청춘가 네 네	청춘가 네 네
에헤 압 똥사네는 봄 춘 짜 하 하니 뒤똥사네는 푸를 청 짜 가지 가지 꼳 까짜 하니 구비 구비는 내 천 짜라 영워라 술 한잔 부어라 마실 흠 짜가 말구 안주라	에헤 앞 동산에는 봄 춘자 하 하니 뒷동산에는 푸를 청 자 가지 가지 꽃 가 자 하니 굽이 굽이는 내 천 자라 영월아술 한 잔 부어라 마실 흠 자가 말고 안주라
조치오	좋지요
네 아유 조씀니다	음 네 아유 좋습니다
압 똥산 봄 춘 짜 뒤 똥산 푸를 청 짜 가지 가지 꼳 까 짜 그지	앞 동산 봄 춘 자뒷 동산푸를 청 자 가지 가지 꽃 가 자 그렇지
구비 구비 내 천 짜 내까미 준장 명보라 명월 이쪼 명이럴	굽이 굽이 내 천 자 내  준장명보라 명월 있지요 명일월 명워라 술 한 잔 부여라 명월아 술 한 잔 부어라
마실 흠 짜가 가지 가지라 마실 흠 짜 그짜뇨	마실 흠 자가 가지 가지라 마실 흠 자 그렇잖아요
저 며네는 술 알머 흠 하는 흠 그 뭐 산 뭐이 얼마 존냐 그게 그 글짜가 만주라 관주 알관주 알관주 짜르지	저 면에는 술 알며 흠 하는 흠 그 뭐 산 뭐이 얼마나 좋으냐 그게 그 글자가 만주라 관주 알관주 알관주 자르지
알관주가 뭐죠	알관주가 뭐지요
관주라는 글짜 내가 그저 이 첨비드리 가서 글 쌔울래머는 관지 씨자나 관직 관직 맨처메 주능거	관주라는 글자 내가 그저 이 천비들이 가서 글 새울려면 관직 쓰잖아 관직 관직 맨 처음에 주는 거
황토를 가지고 뻘꺼케 관주해따능거 응 관주	황토를 가지고 빨갛게 관주했다는 거 응 관주
관주 네 네	아 관주 네 네
그래 그 가지구	그래 그 가지고
그 알관주 아른 거기서 무슨 뜨시에요	그 알관주 알은 거기서 무슨 뜻이에요
알릴 안 짜지 알 지짜 알관주 알 알려준다는 광이야 관주	알릴 안 자지 알 지 자 알관주 알 알려준다는 광이야 관주
그런 하늘 천 짜 따 지 짜	그런 하늘 천 자 땅 지 자
그 다음 또 이써 내 세 가지 할께요	그 다음 또 있어 네 세 가지 할게요
인제 내 그 내가  에헤 처멘 인제 그 소리가 이러케 난다고 그다간	이제 내 그 내가 에헤처음에 이제 그 소리가 이렇게 난다고 그러다가
에헤 하늘 천 짜 따 지 짜 땅이 지부 짜루만 지불 지꼬 나릴 짜 다뤌 짜 영창무네다 바미되며는 별 찐 잘 쑤 마라 마라 너 그리들 마라 본처 괄쎄를 그리 마라아	에헤 하늘 천 자 땅지 자 땅이 집 우 자로만 집을 짓고 날 일 자 달 월 자 영창문에다 밤이 되변 별 진 잘 수 마라 마라 너 그렇게들 마라 본처 괄세를 그렇게 마라
아 네네	음네 네
거기 설명을 함 번 또 해 주세요	거기 설명을 한 번 또 해 주세요
아니 그래 그 이짜네요 하늘 천 짜 따 지 짜 하늘 하느리 생긴 따이 생긴 어데가 지 부 짜천 지 부 짜 지 부이짜네요	아니 그래 그 있잖아요 하늘 천 자 땅 지 자 하늘 하늘이 생긴땅이 생긴 어디가 집 우 자 천 집 우 자 집 우 있잖아요
거다 지불 지꼬 날 릴 짜 다 뤌 방문 다리 다리 나 쫌 해 이 행아교	거기에다 집을 짓고날 일 자 달 월 자 방문 달이 달이 나 좀 해 이 행아교
그 비춘데다가 고 다메 빌 찐 자수 그 이 가다를 잰다 이기야	그 비춘 데다가 그 다음에별 진 잘 수 그 이 가다를 잰다 이거야
가달 빌 찐 자수	가다를 별 진 잘 수
가달진다구요	가달진다고요
가다 가다 가다 외이라거드거든 저 사람 쫌 상욕하나 그럼 가다 잰다고 그럼	가다가다 가다 외이라고 하거든 저 사람 좀 상욕하나 그럼 가다 잰다고 그럼
포물 이러케 폼 재는 거	아 폼을 이렇게 폼 재는 거
그래 그래 하는데 그러케 하는데 마라 마라 내 그르 마라	그래 그래 하는데 그렇게 하는데마라 마라 내 그렇게 하지 마라
그러케 하는데 어데 그 짜그만한 드릉거 첨명이 한 거래 옌나레 그초	그렇게 하는데 어디에그 조그마한 드른 거  한 거래 옛날에 그치요 자근 마누레 본 마누라 놔두고 저건만 보고 가 재자네요 작은 마누라 본 마누라 놔두고 저것만 보고 가 재잖아요
가다루 잰다구	가다루 잰다고
가다 잰다구요 네 네	아 가다 잰다고요 네 네
가다 잰다구 옌나레 그러니까 결론저그로 마라 마라 내 그리 마라구 본처 괄씨 그러지 마라이기여	가다 잰다고 옛날에 그러니까 결론적으로 마라 마라 내 그러지 말라고 본처 괄세를 그렇게 하지 마라 이거야
그런 가다를 재더 가다를 재더래도 본처마는 괄쎄하지 마라 이기여	그런 가다를 재더라도가다를 재더라도 본처만은 괄세하지 마라 이거야
본처가 응 내려가친	본처가 응
예예 존내요 준 본처를 괄쎄 마라	예예 좋으네요 본처를 괄세 마라
방금 노래는 뭔가요 청춘 거 말구 이거 방금 본처 괄쎄 마라 해떵거	방금 노래는 뭔가요청춘 그거 말고 이거 방금 본처 괄세 마라 했던 거
다 가 그 한 가지지	다 그게 그 한 가지지
청춘가제	아 청춘가제
가라기 고러케 두 가라기 인나요	가락이 그렇게 두 가락이 있나요
아니 여러걸 찌 여러 내 하는 다 금가라기지	아니 여러개 있지 여러 내가 하는 게 다 금가락이지
항 곡 끄럼 한 공요	한 곡 그럼 한 곡요
양산둥 다르지  양산두는 또 금 또 다르지 또	양산두는 다르지  양산드는 또 그건 또 다르지 또
그 예리야준제	그
건 또 다르다고 양산두는	그건 또 다르다고 양산두는
근데 청춘가는 이쪽 동네에서 마니 불런나요	근데 청춘가는 이쪽 동네에서 많이 불렀나요
노인 이거는 옌날 어른 옌날 어른드른 다 부러쪼	노인 이거는 옛날 어른 엣날 어른들은 다불렀지요
옌날 옌날 어른드른 다 부르조	옛날 옛날 어른들은 다 부르지요
우리 우리 우리 뭐 한 백 쌀 이백 싸른 도라가신 분들 다 이거 다 부러찌뭐	우리 우리 우리뭐 한 백 살 이백 살 돌아가신 분들 다 이거 다 불렀지 뭐
거 나도 우리도 우리 진게 아니라 내러오는 이기 노래 옌날 내려오는 우리 다 노래 노래를 부른다구	그거 나도 우리도 우리가 지은 게 아니라 내려오는 이 노래 옛날 내려오는 우리 다 노래 노래를 부른다고
이 모냥을 절로 난 거또 어디 어데 뭐 긍가 어디 뭐 이심년 저네 낭간 백 뱅 년 전 낭 거 아니요	이 모양을 절로 난 것도 어디 어디 뭐 그런가 어디 뭐 이십 년 전에  백 백 년 전 난 거아니요
거칠헌한 그 분드리 이거 그런 데가 한 멛 뺑녀니요	거칠현한 그 분들이 이거 그런 데가 한몇 백 년이요
건 한 오뱅 년 역싼데	그건 한 오백 년 역사인데
어르신 그 정선아라리 노래 또 딴 거 쫌 아시는 거 쪼끔만 더 해 주세요	어르신 그 정선 아라리 노래 또 다른 거 좀 아시는 거 조금만 더 해 주세요
너무 조은데요	아 너무 좋은데요
하하하하 아유 저기 뭐이 조응거 해야 되는데	하하하하 아유 저기 뭐 이 좋은 거 해야 되는데
거기야 나뿐 걸 빼치워요 세 가지 부릉 거 하느 어떠카나	거기야 나뿐 거를 빼체워요 세가지 부른 거 하느 어떻게 하나
제가 조은 거 골라서 나중에 그 얘기 하도록 하게씀니다	예 제가 좋은 거를 골라서 나중에 그 얘기 하도록 하겠습니다
그랜데 이걸 내가 노래 이 세가지 해쓰며는 이기 내중에 내가 사라서 여기 한 번 이기 이거노인회든 이래서 불른 거 봐야 그 그 양반 언제 마리야 저 그래 어디 어느 어느 분 와서 이러게취재를 해서 이래 노래하문 그래야 되는데 원치근	그런데 이걸 내가 노래 이 세 가지 했으면이거 나중에 내가 살아서 여기 한 번 이거 이거 노인회든 이래서 부른 거를 봐야 그 그 양반 언제 말이야 저 그래 어디 어느 어느 분이 와서 이렇게 취재를 해서 이렇게 노래하면 그래야 되는데 원칙은
이게 아마 제가 나중에 꼭 채그로라도 이걸 쫌 해쓰먼 조켄네	이게 아마 제가 나중에 꼭 책으로라도 이걸 좀 했으면 좋겠네
어르신 요 나온 이 해신 거	어르신 여기 나온 이 하신 거
그게 언칭 유해 뵈요	그게 엄청 유해 뵈요
요 조은 열 까지를 해따 하더래도 조은 곡쪼만 빼가지구 마닐 삼처기면 삼척 이 정서니먼 정선 이래가지고 교수니미 아푸로 이러케 요 한 오륭년 후에 에 우리 가튼 사람들 직쩝 불러떤 사람들 주끼 저네 마닐 하먼 가주구선 한 일쭈마리야 이런 경로당에 이기 겨우레 눈 마니 올 쩌게한 번 내가 열면 또 저놔 와서 여기 와서 이래 취재 핸는데 이 양반 목쏘리를 한 번 드러보시오여러분들 보시오 내가 이러케 해서 하먼 시방 학쌩드른 그럼그 뭐 강원도 머러 그 목 그 하라버지 요 핸는 거를 그치마는  시방 예를 드러서 한 칠씹 칠씹때 이른 내 노인 남자 노회원드리 동면뜽거 이러케 들고 다메 야 겸상 돌려노콤 다 인는데 뭐 다는 몰라도 동면 한 삼군 서너컬리 가지만 뭐 서울재리 하고 이른 내 거 사네 인는 동면드리 올 하구 회유하는 말로 내 가왜 주꼬 업따 하더래도 그러코 다 살다 다 드를꾜	이 좋은 열 가지를 했다 하더라도 좋은 곡조만 빼 가지고 만일 삼척이면 삼척 이 정선이면 정선 이래가지고 교수님이 앞으로 이렇게 이 한오 오 육년 후에 우리 같은 사람들 직접 불렀던 사람들 죽기 전에 만일 하먼 가지고선 한 일주일 말이야 이런 경로당에 이 겨울에 눈 많이 올 적에 한 번 내가 열면 또 전화 와서 여기 와서이렇게 취재 했는데 이 양반 목소리를 한 번 드러보시오 여러분들 보시오 내가 이렇게 해서 하면 지금 학생들은 그럼그 뭐 강원도 뭐 그 목 그 할아버지 이 한 거를 그렇지만 시방 예를들어서 한 칠십 칠십 때 이런 내 노인 남자 노회원들이 동면뜬 거 이렇게 들고 다니며 야 겸상돌려노코 다 있는데 뭐 다는 몰라도 몽면 한 삼군 서너컬리 가지만 뭐 서울자리 하고 이런 내거 산에 있는 동면들이 올 하고 회유하는 말로 내가 왜 죽고 없다 하더라도 그렇고 다 살다 다드를거에요
하유 그 언제 아무 하라버지는 언제 껃 여게 취재를 해서 노구물 해가지구 뭐 그 교수 양반하자는데 마랴 그때 그때 노래 잘 불러쩌 마리 잘몯 뜨른게지뭐 아니 언제 그래쏘 내가	하유 그 언제 아무 할아버지는 언제 거 여기에 취재를 해서 녹음을 해 가지고 뭐 그 교수 양반하자는데 말이야 그때 그때 노래 잘 불렀어 말이 잘못 드른 게지 뭐 아니 언제 그랬소 내가
나 시치미 뚝 떼고 그래는데 귀거러 드께써요	나 시치미 뚝 떼고 그랬는데 귀 걸어 듣겠어요
그게 제가 마냐게 요걸 노그믈 해서 나중에 인제 궁닙꾸거워네 주며는 그게 인제 모든 궁민들한테 드를 쑤 이께끔 하는데 제가 꼭 부타글 해서 하라버지 해떤 저 노래가사 가사 의미 요런거뜨를 반드시 거 꼭 올려나서 모든 사라미 드를 쑤 이또록 하라고 제가 꼭 부타글 해 두게씀니다	그게 제가 만역에 이걸 녹음을 해서 나중에 이제 국립국어원에 주면 그게 이제 모든 국민들한테 들을 수 있게끔 하는데 제가 꼭 부탁을 해서 할아버지 했던 저 노래 가사 가사 의미 이런것들을 반드시 거기에 꼭 올려 놓아서 모든 사람이 들을 수 있도록 하라고 제가 꼭 부탁을 해 두겠습니다
고마워요	고마워요
네네	네 네
하튼 이거는 귀중한 노래고 이런 거뜨리 가락또 이써야 되고 또 가사 이게 노래 가사도 굉장히 다들 으미가 으미가 인네요	아 하튼 이거는 귀중한 노래고 이런 것들이 가락도 있어야 되고 또 가사 이게 노래 가사도 굉장히 다들 의미가 의미가 있네요
이거 세 아께 그 세 가지 마리 이게 으미 인는 마리에요	이게 세 아까 그 세 가지 말이이게 의미 있는 말이에요
아니 머 요 내 아께 술찝 가따 오는 얘기 이거는 소굼 집 가따오는 얘기도 그거또요 그 게  차능 게 그거요	아니 뭐 요 내 아까 술집 갔다 오는 얘기 이거는 소금 집 갔다 오는 얘기도 그것도요 그  게 그거요
그건 토 뭐 이케 이케 이 주고 반는 뭐 아주 안 조은 게 아닌데요	그건 또 뭐 이렇게 이렇게주고 받는 뭐 아주 안 좋은 게 아닌데요
아까 그런 거는 재민는데	아까 그런 거는 재밌는데
갈라는 갈찌 갈 찌짜가 이짜네 갈 찌 짜	갈라는 갈지 갈 지 자가 있잖아 갈 지 자
가주 가구 오는 올 래 짜는 날주고 가라구	가지고 가고 오는 올 래 자는 나를 주고 가라고
그 이름 이짜나 그거	그 이름 있잖아 그거
고런 주고 반는 노래 그런 거 말고 또 뭐 엄나요	그런 주고 받는 노래 그런 거 말고 또 뭐없나요
끈네 떠나간 뒤에 도라와 물 주꼰데	끝네 떠나간 뒤에 돌아와 물 줄건데
한 곡 쫌 해 주시죠 그런 거	한 곡 좀 해 주시지요 그런 거
그거또 해 달라고	그것도 해 달라고
아이 그 또 또 딴 노래 이쓰며는 해	아이 그 또 또 다른 노래 있으면 해
남자 여자가 이러게 사랑하고 헤어지는 요런 거뜨리 노래드리 만치 아나요	예 남자 여자가 이렇게 사랑하고 헤어지는 이런 것들이 노래들이 많지 않아요
응 자로	응 자로
욜 하점 장터이써요	요기 하점 장터 있어요
요 아주머니 노래 잘하는 아주머니를 하나 데와가주고 아께 그 노래 나중에 한 마디 해 준다구	요 아주머니 노래 잘 하는 아주머니를 하나 데려와 가지고 아까 그 노래 나중에 한 마디 해준다고
갈라는 갈 지짜는 당시니 가져가고 올 래는 쩌나주고 쒸래문 또 내가 응 으 내 떠나 간 뒤에도랑무리 뿔커든 당시늘 당시늘 놔두고 갈라고 울고 간 주 아라라	갈라는 갈 지 자는 당신이 가져 가고 올 래는 저 나 주고  또 내가 응 으 내 떠나 간 뒤에 도랑물이 불커든 당신을 당신을 놔 두고 가느라고 울고 간 줄 알아라
그 다불 그래 핸는데 나는 내 마리래머는 항종 해니까두루	그 답을 그렇게 했는데 나는 내말이라면 항상 하니까
흥이 안 나게쬬	흥이 안 나겠죠
그래두 그 그런 거뜨를 머 아무나 할 쑤 인는어떤 아주머니가 그 또 무조건 다 할 쑤이는 건 아니니까	아 그래도 그 그런 것들을 뭐 아무나 할 수 있는어떤 아주머니가 그 또무조건 다 할 수 있는 건 아니니까
옌나레 여니 여니 현 이르믄 우리 진 마리요 다 옌나레 옌나렌 그 다 그 불 불르는 노래가계속 내려오는 드꼬 드꼬 그래써 이래 드꼬 들커등	옛날에 이 이 현 이름은 우리 지은 말이요 다 옛날에 옛날에 그 다 그 불 불른 노래가 계속 내려오는 듣고 듣고 그랬어 이렇게 듣고듣거든
노래 젠거또 메께 이 이찌마는 전소글 흘러 내려오는 노래가 만 만치 망키는	노래 지은 것도 몇 개 이 있지만 전속을 흘러 내려오는 노래가 만 많지 많기는
진노래 젠노래는 어떤 게 또 이써요	지은 노래 지은 노래는 어떤 것이 또 있어요
젱거는 뭐 그이 뭐 막 찔러	지은 거는 뭐 그 뭐 막 질러
꽉 차찌 뭐	꽉 찼지 뭐
젠노래 중에서 혹씨 쫌 아시능 게 이쓰면 쫌 해주시죠	지은 노래 중에서 혹시 좀 아시는 거있으면 좀 해주시지요
고런 거 인제 착 고런 거 인제 어르시네 창자기니까 고런 거뚜 나중에는 시가니 지나며는 굉장히 중요한 자료거든뇨	그런 거 이제 착 그런 거 이제 어르신의 창작이니까 그런 것도 나중에는 시간이 지나면 굉장히 중요한 자료거든요
어떤 게 또 이쓸까	어떤 게 또 있을까
잘 생가기 안 나세 세요	아 잘 생각이 안 나세 세요
꽉 찬는데 마는데 그 쓸떼 엄는 거 할 피로 웁꼬	꽉 찼는데 많은 데 그 쓸데 없는 거 할필요 없고
그 쓸때 엄는 거또 상관 업써요 제가 아라서	아 그 쓸데 없는 것도 상관 없어요 제가 알아서
고거는 인제 조은 거는 일따는 올려 노코 안 조은 거또 그거는 귀중한 자료니까 고런 거뜨른나중에 제가 다 편지불 할께요	그거는 이제 좋은 거는 일단은 올려 놓고 안 좋은 것도 그거는귀중한 자료니까 그런 것들은 나중에 제가 다 편집을 할게요
그럼 하지 머	그럼 하지 뭐
이번 재파늘 몬 니기고서 고등 재파늘 갈 쩌게는 당신드리야아 말 하 마데만 잘 해주신다며느은 나는 뜩썽해요	이번 재판을 못 이기고서 고등 재판을 갈 적에는 당신들이 말 한 마디만 잘해 주신다면 나는 득성해요
그 재판 노래요 재판	그 재판 노래요 재판
그래요 그 어떤 노래	그래요 그 어떤 노래
그러니까 그거 또까짜네요	아 그러니까 그거 똑같잖아요
이건 저 재 재판 재판 인제 저 뭐실 한다고	이건 저 재 재판 재판 이제 저 무엇을 한다고
재판 재판 인제 응 예를 드러 부산 으 지거메 가서는 재판하자네요	재판 재판 이제 응 예를 들어 부산 지검에 가서 재판하잖아요
재판 져따고	재판 졌다고
내 으 그거심 하고 그래두 교수님 하나를 재 재판 뭐실 해 가주구 내 저꺼든	내 으 그거심하고 그래도 교수님 하나를 재 재판 무엇을 해 가지고 내가 졌거든
전는데 그담 고등 재판 고등 재파늘 간다고	졌는데 그 다음 고등 재판 고등 재판을 간다고
고등 재파늘 가 간는데 저테 저테 인는 사라미 응 으 쩌 마천는지 정이니 여태 인는 사라미말 한 마데만 잘 해주머는 그차뇨	고등 재판을 가 갔는데 곁에 곁에 있는 사람이 응 으 저 마쳤는지 정인이 옆에 있는 사람이 말 한 마디만 잘 해주면 그렇잖아요
내가 안 그런걸 그러타 이 해씨니까두루 그 사라미 안 그러타 금 그런 허쭈 헌 뗀 짇 헌 제리다 이런 고 내가 이버네 득썽을 하자네요	내가 안 그런걸 그렇다 했으니까 그 사람이 안 그렇다 그럼 그런 헛된 지 헛  이런 거 내가 이번에 득성을 하잖아요
덕쏭	덕송
득쏭 득쏭	득송 득송
득쏭 그 득쏭이라한다 예그래는	득송 그 득송이라한다
득쏭	득송
득쏭 그럼 교수니미 도료 또 내한테 지고 내가 득쏭하자네요	득송 그럼 교수님이 도리어 또나한테 지고 내가 득송하잖아요
그래 그 노래 옌나레 그 옌 옌나레 그 이거또 이 한 건다리가 그 술 한 잔 머꼬 그 고소가돼 가주고 하는 걸 그래 한데 됭기여	그래 그 노래 옛날에 그 옛 옛날에 그 이것도 이 한 건달이 그 술 한 잔 먹고 그 고소가 돼 가지고 하는 걸 그렇게 하는데 되는 거야
그저 재파늘 몬니기구 다시 또 몬 몬 니겨짜네요	그저 재판을 못 이기고 다시 또 못 못 이겼잖아요
몬 니기고 고등재파늘 갈 쩌게 모퉁이 갈 쩌게 당신드리 당신들 중에 만나 말 한 마디만 얼마도 피룝찌 아네요	못 이기고 고등재판을 갈 적에 모퉁이 갈 적에 당신들이 당신들 중에 만나말 한 마디만 얼마도 필요하지 않아요
거기 여래 하네 함 마디만 씩 하먼 열 마디 아니요	거기에 열에 하나 한 마디만씩 하면 열마디 아니요
당신드리 말 함 마데만 잘 해주먼 나는 득쏭가리라	당신들이 말 한 마디만 잘 해주면 나는득송가리라
아득쏭 가리라	아 득송 가리라
그 그런데 그 저넨 내 뭐지 내 이르믈 대따고 내 이름 대이며 해따고 내 또 가도 볼래요	그 그런데 그 전에는 내 뭐지 내 이름을 댔다고 내 이름 대며 했다고 내 또 하는 거 볼래요
이번 재파늘 몬 니기구서 고등재파늘 갈 쩌게에 당신드리 말 한 마데만 잘 해주신다며는 고재시기는 득쏭 하리라	이번 재판을 못 이기고서 고등재판을 갈 적에 당신들이 말 한 마디만 잘 해주신다면 고재식이는 득송하리라
고러케 인제 자기 이르믈 너어서 그런식 인네요 아하	아 그렇게 이제 자기 이름을 넣어서 그런식 있네요 아하
고런 거슬 사연드를 다 인제 다 인는데	그런 것을 사연들을 다 이제 다 있는데
그럼 그럼 아리라기 아리랑이 정선 아리랑이 이기 이륵 내가 빨레하는데 원체 느림미다	그럼 그럼 아리랑이 아리랑이 정선 아리랑이 이거 이렇게 내가 빨리 하는데 원체 느립니다
노래슬 슬퍼슬 슬푸구 우네요	노래슬 슬퍼 슬 슬프게 우네요
아니 옌나렌 그슬푼 고글 해야 된다고	아니 옛날엔 그슬픈 곡을 해야 된다고
그러치만 요 지금도 그 좀 빨리헐 쩌게는 아리라 상당히 슬푼 고글 해야 인저 그기 보통사람드른 그 쫌 서루메 보인 듣 서루메 바친 거는 거 아리랑을 드르먼 자연히 눈시우리 나온다구 눈시우리	그렇지만 요 지금도 그 좀 빨리할 적에는 아리랑이 상당히 슬픈 곡을 해야 이제그게 보통사람들은 그 좀 설움에 보딘 듯 설움에 바친 거는 거 아리랑을 들으면 자연히 눈시울이 나온다고 눈시울이
근데 뭐 하에참 상고제래는 곡쪼는 고걸 벅차 끌른디	근데 뭐 하에 참 상고제례라는 곡조는 그걸 벅차 끓른데
그거또 쫌 해주시죠 네	아 그것도 좀 해주시죠 네
하하 삼모제비 미물 국쭈가 어골 납짝 껄른데 간나니 아버지는 어들루 가실라구 심발 단속만하나아	하하 삼모제비 메밀 국주가 어골 납작 끌른데 갓난이 아버지는 어딜 가실라고 신발 단속만 하나
그 뭐야 미물 알지  미물 미릴	그 뭐야 미물 알지 미물 미릴
밀물	밀물
옌나레 미물쌀 이써요 미물쌀	옛날에 미물쌀 있어요 미물쌀
네 밀물쌀	네 밀물쌀
건제 실랑 대이팔라고 화뇨 그 끼리구 막 끄릴 꺼 아니요 복짝뽁짝	그걸 신랑  화루에그걸 끓이고 막 끓일 거 아니요 복짝복짝
어디 해 노코요	어디에 해 놓고요
화루에	화로에
화루에	아 화로에
인제 부레 꺼니믿 대주파러하면	이제 불에  대주팔어하면
그 실랑이 그건 미물오쪼글 끄러 머거야 되는데 저거도 갈라구선 심발른다구	그 신랑이 그건 미물오쪽을 끓어 먹어야 되는데 저거도 갈라고 신발을 신는다고
그기 뭐냐먼 저 저 어데 딴 색씨 찌부로 올라 간다고	그게 뭐냐면 저 저 어디에 딴 색시 집으로 올라 간다고
그러니까 삼모제비 미물 오쩌기 올 바짝 끄러대는데 당신 할라고	그러니가 삼모제비 미물 오쩍이 오래 바짝 끓는데 당신 할라고
상무	상무
상몬제비	상몬제비
상무제비	상무제비
미물 미무리 사 모이 세개래요	미물 미물이 사 세 개래요
미물싸리 모 뽜써	미물쌀 못 봤어
예 봐씀니다고게 세 세	아봤습니다그게 세 세
삼모 마찌요	삼모 맞지요
거 삼모제비 미물국쭈	그 삼모제비 미물국주메밀국수
삼모제비 미물국쭈	
삼모제비 미물국쭈	아 삼모제비 미물국주
거 그게 저 끄래먼 명국쭈기라 한다고	거 그게 저 끓으면 명국죽이라 한다고
음시글 주굴 명국쭈 정말 오골박짝 끌른데	음식을 죽을 명국주 정말 오골바짝 끓는데
오골박짝	오골박작
바글바글 끌차네	바글바글 끓잖아
오골박짝 끌른데	아 오골박작 끓는데
끌른데	끓는데
간나니 아부지는 간나닌 자기 남편 조건 이기야	갓난이 아버지는 갓난이는 자기 남편 조건이거야
어디를 갈라고 신발 단속 하시오	어디를 가려고 신발 단속 하시오
아예	아예
그니까 나랑 여기 지베 이찌 딴 데 가지 마라	그러니까 나랑 여기 집에 있지 다른 데 가지마라
그럼	그럼
합께에 술짠 어네넌 은가씨가 떠떠니 이버네 술짠 아네는 동구기 동동 뜨네	합게에 술잔 어네 넣은 은가시가 떴더니 이번에 술잔 안에는 동국이 동동 뜨네
이건 수리 먼저 이래 부어주든 수른 무쩍 뻐떠거두 개고 뭐시 업따고	이건 술이 먼저 이렇게 부어주던 술은    무엇이 없다고
마시 업따고요	맛이 없다고요
응 마시 읍꼬 뭐 이쩨 이래니까 그런 저 응가시가 떠따고	응 맛이 없고 뭐 이제 이렇니까그런 저 은가시가 떴다고
응가 응가시 응가시라는 건 그냥 가시라고 그러지만 응가시 응가시도 괜차나 으 으 으니니까은	은가 은가시 은가시르는 거는 그냥 가시라고 그러지만 은가시 은가시도 괜찮아 으 으 은이니까 은
으 응가시가 떠러	으 은가시가 떨어
가시는 뭔가요	가시는 뭔가요
가시 찔르는 가시이짜나요 찔르는 가시	아 가시 찔르는 가시 있잖아요 찔르는 가시
가시가 떤는데 그건 인제 으느로 핸 가시치 은 거튼 가시가 머그며 띠껑띠겅 그런데 쑤리	가시가 떴는데 그건 이제 은으로 한 가시지 은 같은 가시가 먹으면 띠겅따건 그런데 술이
첨 처음 마시는 수른 그러타	처음 처음 마시는 술은 그렇다
끄래이	그래
이 양반 부어 주는 수른 지 그러코 마시 그러코 이 또 아가씨가 부어주는 수른 이버네 술짠아께 술짜네는 응가시가 떠꼬 이번 술짜네는 보니까 봉노기 떠떠네 그러	이 양반 부어 주는 술은 전부 그렇고 맛이 그렇고 이 또 아가씨가 부어주는 술은 이번에 술잔 아까 술잔에는 은가시가 떧고 이번 술잔에는 보니까 복녹이 떴네 그려
보는데 왜 비가 오문 저 바께 봉오리가 저 안쪼	보는데 왜 비가 오면 저 밖에 봉오리가 저앉지요
물빵우리가 게 수를 보니까 그기 동동 떠또라 이짜네	물방울이가 그 술을 보니까 그게 동동떠돌아 있잖아
그래 봉노기 동동 떠따	그래 복녹이 동동 떴다
그걸 봉로기라고 한다고요	아 그걸 복록이라고 한다고요
봉록 보 복 복짜 봉녹	복록 보 복 복 자 복녹
거 조탄 얘기여	그거 좋다는 얘기야
술 복씨 조타 그거조	술 복이 좋다 그거지요
그 인제 갈 거 갈 거 둘 들고 한 잔 머꼬 난 인제 갈 터야 갈보데가 한 노래라구 이기	그이제 갈 거 갈 거 둘 들고 한 잔 먹고 난 이제 갈테애 갈보데가 한 노래라고 이게
그래 이 노래한테 여자가 부어주는 수리 더 조타는 그런 뜨시네요	아 그래 이 노래한테여자가 부어주는 술이 더 좋다는 그런 뜻이네요
이제 한 꼭쪼만 더 하하하하	이제 한 곡조만 더 하하하하
그 그 그거만 거 참 재민는 노래드리 만네요	아 그 그 그거만 거 참 재밌는 노래들이많네요
하하하하하	하하하하하
우리 서방니미 삼베 주적쌈 입꼬 고등어 질머지고 삼처게 소곰 지러 가는데 배뽕녕 구비 구비잘 다녀 오시오	우리 서방님이 삼베 주적삼 입고 고등어 짊어지고 삼척에 소금 지러 가는데 백봉령 구비 구비 잘 다녀 오시오
애쓰지 마시오 염녀 마시오 아주 근심 마라요 돌개바람만 불지 아니하면 무사이 다녀 오리라	애쓰지 마시오 염려 마시오 아주 근심 마라요 돌개바람만 불지 않으면 무사히 다녀 오리라
이기 옌나레 이제 내가 아페 그 메 깨는 뭐 저는 뭐 개똥 꿈꿈떠기머 청남 옥찌기 내빼라는어디에요 그 말하는데 그 옌나레 인제 그 삼처게 소곰 지러 간거요 다 단지 이 단지라 해찌	이게 옛날에 이제 내가 앞에 그 몇 개는 뭐 저는 뭐 개똥 꿈 꿈떡이며 청남 옥지기 내빼라는 어디에요 그 말하는데 그 옛날에 이제 그 삼척에 소금 지러 간거요 다 단지 이 단지라 했지
빈 단지 지 가주 거다 소고믈 파가주고 질머지거 인제 요 이틀 마꼬 오자네 소곰 저도 마꼬아께 내 그 술짱사 뵈면	빈 단지 지어 가지고 거기에다 소금을 파가지고 짊어지고 이제 요 이틀 맡고 오잖아 소금 저도 맡고 아까 내 그 술장사 보이면
그래 인제 동네 박쩐재 뭐 한 사십때든 여기 어른드리 인제 다서 여서시 소곰 지러 제 간다이기여	그래 이제 동내 박전재 뭐 한 사십 대든 여기 여기 어른들이 이제 다섯 여섯이 소금 지러 제 간다 이거야
그 첨 가미 엽쩐 성냥 깔무지버가 소곰지버	그 처음 가니까 엽전 석 냥 가지고 가 소금을집어
성냥한뇨	석 냥한요
엽쩐하고	엽전하고
저 머시 고등어 고등어 해 질머지고 으 인제 그래깐드루 옌나렌 돈 이찌 그 소곰 까부러 가  져가지 모타면 잰노래 가당 이 꾸 꾸 꿀 떵망을 맨드러 가주고 가	저 뭐 고등어 고등어 해 짊어지고 으 이제 그러니까 옛날에 돈 있지 그 소금 까불어 가져가지 못 하면 잰 노래 가당 이 꾸꾸 꿀떡을 만들어 가지고 가
뭘 만드러요	뭘 만들어요
꿈떡 꿈떡	꿈떡 꿈떡
꿈떡	꿈떡
꿈떡	꿈떡
꿈떠기 뭐죠	꿈떡이 뭐지요
꿈떡 요 귀리하고 저 청밀하 고래 가라 가주구서는 이게 주물러 가지구 이래 꼬가주고 하능 거	꿈떡 이 귀리하고 저 청밀하고 갈아 가지고서는 이렇게 주물러 가지고 이렇게 꽈서 하는 거
그걸 꿈 꿈떠기라구	그걸 꿈 꿈떡이라고
그런데 삼척 갈랄 가는데 그 배뽕녕이 구비구비가 그 요즘 의 저 짤분 뭐야 저 강 나는데	그런데 삼척  가는데 그 백봉령이 굽이 굽이가 그 요즘의 저 짧은 뭐야 저 강 나는데
삽떵용	삽덩용
거 아홉꾸비야 아홉 아홉꾸비	거기가 아홉 굽이야 아홉 아홉 굽이
삽떵용도 아홉 꾸비고 백뽕녕도 그이 구비가 한 그 연 연꾸비여	삽덩용도 아홉 굽이고 백봉령도 그게 굽이가 한 그 연 연굽이야 그래 구비구비 잘 드러오라고 그차네요그래 굽이 굽이 잘 들어오라고 그렇잖아요
잘 다녀오라고	잘 다녀오라고
다고라고 인제	다녀오라고 이제
그래 인제 아내가 소릴 하며는 그때 실랑이 이따가 염녀마시오 염녀말고 애쓰지 마시오	그래 이제 아내가 소리를 하면 그때 신랑이 있다가 염려마시오 염려 말고 애쓰지 마시오
돌개바람만 불지 안 하먼 무사히 흘러	돌개바람만 불지 않으면 무사히 흘러
단지래 질머지고 오자네요	단지 짊어지고 오잖아요
올때 바람 돌개바람 학 뿌러서 하먼 올 칠짜베요	올 때 바람 돌개바람 확 불어서 하면 치잖아요
이런 소곰 가마니 이거는 마달 포대 포대는 어퍼지먼 다시 그럭 이러거 지며 되자네	이런소금 가마니 이거는 마달 포대 포대는 엎어지면 다시 그렇게 이렇게 지면 되잖아
그래 옹기는 저런 옹기는 딱 탁 깨지먼 퍼석 깨지자나 고마	그래 옹기는 저런 옹기는 딱 탁깨지면 퍼석 깨지잖아 그만
그래니까두루 애쓰지 마시오 몸 달구지 마시오 너무 염녀하지 마시오 돌개바람만 불지 안 하먼 무사히 오리라	그러니까 애쓰지 마시오 몸 달구지 마시오 너무 염려하지 마시오 돌개바람만 불지 않으면 무사히 오리라
고 아비 다비라고 뭘 다비라고	그 아비 답이라고 뭘 답이라고
근데 그 옌나레는 그 단지에다가 핸나	근데 그 옛날에는 그 단지에다가 했나
그냥뭐 가마니 이런데다 해도 되자나요 소금 가틍 거	그냥뭐 가마니 이런데다 해도되지 않아요 소금 가튼 거
그래 옌날 가마니도 요 아주 귀해꼬 또 가마니 보덤 단지또 마시 요 굉장해따고 옌나레	아 그래 옛날 가마니도 요 아주 귀했고 또 가마니 보다 단지도 맛이 이게 굉장했다고 옛날에
단지로 단지 딴지다 새 새차물 지고 마리 내따고	단시로 단지 단지에다 새 새참을 지고 마을에 냈다고
여자 아까 그 여자가 해떤 그 가사는 어트게 되죠	여자 아까 그 여자가 했던 그 가사는 어떻  게 되지요
여자가 남편 갈 때 해떤 불러떤	여자가 남편 갈 때 했던 불렀던
불러 아께 그거 아니요	불러 아까 그거 아니요
다시 한 번 고 설명만 해 주시면	다시 한 번 그 설명만 해 주시면
그리 여자가 인제 인제 고 새버게 인제 강기 강기 아측 새버게 요 다서씨구 인제 가니까네 짇 꿈떡 해가주고 엽쩐 성 냥 엽쩐 성냥은 지금 삼처 넌이라 해찌	아 그래 여자가 이제 이제 그 새벽에 이제 가니까 가니까 아침 새벽에 이 다섯 시고 이제 가니까 지 꿈떡 해 가지고 엽전 석 냥 엽전 석냥은 지금 삼천 원이라고 했지
성 냥 껄머지고	석 냥 걸머지고
걸머지고	걸머지고
걸머지고 거 인제 세뿌리다 걸머지구서는 떠나가따 이기여	걸머지고 그 이제 세 뿌리에다걸머지고서는 떠나갔다 이거야
세 뿌레요	세 뿌레요
지게 세뿌리	지게 세 뿌리
참나무 옥찌게 이러게 이써 삼	참나무 옥지게 이런 게 있어 삼
참나무 옥쩌게 엽쩐 석 쩐 성 냥 걸머지고 삼처게 소곰 지러 가는데 응	참나무 옥지게 엽전석 전 석 냥 걸머지고 삼척에 소금 지러 가는데 응
구비 구비 삽쩡녕 구비구비 부디 잘 다녀오시오	굽이 굽이 삽정령 굽이 굽이 부디 잘 다녀오시오
삽땀녕 구비구비	삽담령 굽이 굽이
근데 삽땅녕은 저기 강릉쪼긴데요	근데 삽담령은 저기 강릉 쪽인데요
아니 저 저 백뽕녕	아니 저 저 백봉령
백뽕녕 네네네	아 백봉령 네 네 네
구비구비 잘 다녀오시오	굽이 굽이 잘 다녀오시오
그러게 야갈 손 한 번 해따	그러게  손 한 번 했다
그러니까 인제 떠나가는 남펴니 애쓰지 마시오 몸 달구지 마시오 너무 염녀하지 마시오 돌개바람만 불지 안 하머는 무사히 오리라	그러니까 이제 떠나가는 남편이 애쓰지 마시오 몸 달구지마시오 너무 염려하지 마시오 돌개바람만 불지 않으면 무사히 오리라
돌개바람만 안 불문 어굴질 일 업짜네 올 섀도 매 때릴 일 업짜네	돌개바람만 안 불면 어굴질 일 없잖아 올  매 때릴 일 없잖아
그러케 이 다불 옌나레는 그러케 그기에는 그 그거 거럼 옌나레 하비 뭐 그게 머 뱅 녀니든이 뱅 녀니든 삼 뱅명이든 옌날 성질 때 여기 어른드른 그 해떤 노래라고 우리 할머니 해떤 노래고	그렇게 이 답을 옛날에는 그렇게 거기에는 그 그거 그럼 옛날에 합이 뭐 그게 뭐 백 년이든 이 백 년이든 삼 백명이든 옛날 성질 때 여기 어른들은 그 했던 노래라고 우리 할머니 했던노래고
금 어르신 그 그러케 인제 남편 이러케 이를 가따 오며는 이러케 막 잘 가따 오라고 하기도하고 인제 저 서로 조아하는 노래도 하기도 핸는데 바테 일 가는 이러케 할 때 힘드러서 불러떤 노래 가튼 거또 이껜네요	그럼 어르신 그 그렇게 이제 남편 이렇게 일을 갔다 오면 이렇게막 잘 갔다 오라고 하기도 하고 이제 서로 좋아하는 노래도 하기도 했는데 밭에 일 가는 이렇게할 때 힘들어서 불렀던 노래 가튼 거것도 있겠네요
내 신세가 막 힘들기도 하고 그 다메 이게 농사진능게 막 힘드러서 불러떤 노래들도 이껜네요	내 신세가 막 힘들기도 하고 그 다음에 이게 농사 짓는 게 막 힘들어서 불렀던 노래들도 있겠네요
더러 이찌 받 까는 노래도 이꼬	더러 있지 밭 가는 노래도 있고
어떤 거요 받 까는 노래는	아 어떤 거요 밭 가는 노래는
내레 생각또 안나네 지금	음 내가 생각도 않나네 지금
이제 빼리따고	잊어 버렸다고
갠니리 이떡 할 쩌근 한 잔 머꼬 해야 된다고	할 적에는 한 잔 먹고 해야 된다고
그러면	아 그러면
가마니 그 교수님 가만 이써봐	가만히 그 교수님 가만 있어봐
우리 시꾸 왜 안 오나 저 지 마꺼리 하나를 까	우리 식구 왜 안 오나 저 지 막걸리 하나를까
제가	제가
차 때무네	차 때문에
차가 이써가지고 제가  저 가마써봐저 제가 좀 이따가	예 차가 있어가지고 제가 저가만 있어봐 저 제가 좀 있다가
아니 안 마껄리 저 이써	아니 안에 막걸리 저기에 있어
저 저 저 마껄리 저 저 제순덕 마꺼리 어제부터 사놔 사놔 봐따가 나중에 내 한 잔씩 멍는다고	저 저 저 막걸리 저 저 제순덕 막걸리 어제부터 사놔 사놔 봤다가 나중에 내 한 잔씩 먹는다고
그래요	아 그래요
당신네는 쇠가 줴	당신네는 소주가 좋아
예예예	예예예
좀 쇠가 조쓰까 좀 시간 줘야지 공부도 마리 좀	좀 소주가 좋습니까 좀 시간을 주어야지공부도 말이야 좀
그 그러며는 어르신 그 옌나레 농사 지으셔짜나요	그 그러면 어르신 그 옛날에 농사 지으셨잖아요
어떤 농사를 마니 지으셔써요	어떤 농사를 많이 지으셨어요
저 농사 지을 쩌기 뭐읻	저 농사 지을 쩍에는 뭐
논 농사도 지언나요	논 농사도 지었나요
논 농사를 지어쪼 노니 엄는 쩌기 이 요 풍촌이짜나요 풍촌	논 농사을 지었지요 논이 없는쩍에 요 풍촌있잖아요 풍촌
거게 논 내가 서 마지기 욛 언니데 여서 사는 우리 마을 분드리 노나 한 열 찌비가 부쳐써요 열찌비	거기에 논 내가 세 마지기 여기에 얻는데 여기에서 사는 우리 마을 분들이 나누어서한 열 집이가 부쳤어요 열 집이
서 마지기 단 마지기 이르케 여 여 분드른 귿 땅을 사가지고 저구	세 마지기 단 마지기 이렇게 여 여기 분들은 그 땅을 사가지고 지고
그래요 그러며는 여기는 노니 한 마지긴 한 멷 평 정도 되나요	아 그래요 그러면은 여기는 논이 한 마지기는 한 몇 평 정도 되나요
여게는 백 오십평	여기는 백 오십평
백 오십 평 정도요 되고 뭐 어르시는논 농사 한 서 서마지기	아 백 오십 평 정도요  되고 뭐 어르신은논 농사 한 세 세 마지기
서 마지기	서 마지기
그거또 우리 내가 산 게 아니고 우리 동 동네 서낭님 서낭당 이 터래 이 터	그것도 우리 내가 산 것이 아니고 우리 동 동네 서낭님 서낭당 이 터래 이 터
이 터 그거 부치고 내가 제사 체내고 그래가지고 인제 그래 그래 부치고 그래 그 부치고 음서그 하고 모 요 보미 뫼며는 감재 옥쑤수 뭐 귿 콩 파 모 마냐 마니 해쪼	이 터 그거 부치고 내가 제사 지내고 그래 가지고 인제 그래 그래 부치고 그래 그 부치고 음식 그 하고 뭐 요봄에 매며는 감자 옥수수 뭐 그 콩 파 뭐 마냥 많이 했죠
귀리 귀리 아뇨 귀리	귀리 귀리 알아요
귀리 청밀 호밀	귀리 청밀 호밀
그래요	아 그래요
밀 보리	밀 보리
머 마니 하션네요	뭐 많이 하셨네요
가지각쌕 다 하지요	아 가지각색 다 하지요
마 녀평 부치는데 마 녀평	만 여평 부치는데 만 여평
마 녀평을 받 그 바치 이씀니까 그게	아 만 여평을 밭 그 밭이 있습니까 그게
바치 인제 그 내 해고 모자래며는 그 여 여 여너 분들 이 터 어짜네요	밭이 인제 그 내 하고 모자라며는 그 여 여 여너 분들 이 터 얻잖아요 또 이 또 부치고 제사 채리고 그러고 또 한 한 머 팔백 평 구백 평 저거도 부치구 부쳐 또이 또 부치고 제사 차리고 그러고 또 한 한 뭐 팔백 평 구백 평 적어도 부치고 부쳐 아아
아이구 두 부니서 하시기 힘드셔껀네요	아이구 두 분이서 하시기 힘드셨건네요
아이 그래가지고 내가 일람 삼녀래요	아이 그래가지고 내가 일남 삼녀래요
내인제 따리 마지가 인제 오 오십 두리고 야 고 담 아드른 지금 안산 가 이씨요	내 아이 인제 딸이 맞이가 인제 오 오십 둘이고 이 아이 그 담 아들은 지금 안산 가 있어요
요 아드리 요거또 오시비고 또 고 다음우리 마흔 여덜 머근 우리 따리 저 저저 안산 가이꼬 저 망내가 망내이 호래 오 오레 사시비지	이 아들이 이것도 오십이고 또 그 다음 음우리 마흔 여덜 먹은 우리 딸이 저 저저 안산 가 있고 저 막내가 막내 이 올 해에 오 올 해 사십이지
그래 저 태백 까이꼬요	그래 저 태백 가 있고요
망내 뿌니 저랑 나이가 비스타겐는데요	아 막내 분이 저랑 나이가 비슷하겠는데요
그 여게 머 그래도 소 키 보고 얼릉 또 인제 거 야채 묵 묵쑤고 이런 거 해 가지고 팔 바삐로 팔로미래 그래서 그래가주 애들 고등하꾜 다 씨고 우리 내 자스근 저 그 당시만 하더래도대하꾜 몯 가씨요 모두	그 여기에 뭐 그래도 소 키워보고 얼른 또 인제 거 야채 묵 묵 쑤고 이런거 해 가지고 바쁘게 팔고 그래서 그래 가지고 애들 고등학교 다 졸업하고 우리 내 자식은 저 그 당시만 하더라도 대학교 못 갔어요 모두 영주 전문 대학 우리 아들 나와찌 영주 전문 대학 우리 아들 나왔지
근데 옌나레는 그 그러쵸 뭐 여기서 여기서 가는 게 쉽찐 아나쓸꺼야	근데 옛날에는 그 그렇죠 뭐 여기서 여기서 가는 게 쉽지는 않았을거야
여게 그때 우리 여기 영주 전문 대학 댕길 쩌게그 아무깨나 이런 거이 아무깨 그 아저씨 아드른 으 여 여 대하꾜 댕긴다고 그랟 그래써 그래해따고요	여기에 그때 우리 여기 영주전문대학 다닐 적에그 아무개나 이런 거이 아무개 그 아저씨 아들은 여 여 대학교 다닌다고 그래 그랬어 그렇게 했다고요 요새 머 요 경기에서 서울 고려대고 뭐 강원대고 근데 그른 데는 생각찌도 모타고 그럼요새뭐 요 경기에서 서울 고려대고 뭐 강원대고 근데 그런 데는 생각지도 못하고 그럼
그래도 그거 시키는데 힘드셔께써요	그래도 그거 시키는데 힘드셨겠어요
이게 농사지어가	이게 농사지으며
암 그럼 고아쪼 그럼 그 읻 그 하는 기 이 고등하꾜도 정선 유학씨자네요	암 그럼 힘들었지 그럼 그 이 그 하는 것이 이 고등학교도 정선 유학 가잖아요
요 화동 중하꾜만 요기 댕기면 거러 댕기고 고 다음 우리 망내 딸 댕길 쩌게 뻐스로 타고 댕겨찌만 우리 애비는 여 거러서 이 이시비면 이심미를	여기 화동 중학교만 여기 다니면 거러 다니고 그 다음 우리 막내 딸 다닐 적에 버스로 타고 다녔지만 우리 아비는 여기 걸어서 이 이십이면 이십 리를
이심미를 한 팔 키로를 아이고	이십 리를 한 팔 키로를 아이고
팔 키로를 어떠케 거러 거러 댕겨따고요	팔 키로를 어떻게 걸어 걸어 다녔다고요
밥 감자 밥 쌀밥또 아니고 읻 옥쑤수 밥 보리밥 싸가 댕기고 그 아페 빼운 아드리래요	밥감자 밥 쌀밥도 아니고 이 옥수수 밥 보리밥 싸가지고 다니고 그 앞에 배운 아들이래요
그 어르신 그럼 인제 그 농사와 괄련덴 거를 먼저 쫌 여쭤 보고 시푼데 여기에는 인제 벼가잉는 시기에 따라 벼 품종이 이짜나요	그 어르신 그럼 인제 그 농사와 관련된 거를 먼저 좀 여쭤 보고 싶은데 여기에는 인제 벼가 익는 시기에 따라 벼 품종이 있잖아요
품종이 어떤 게 이씀니까	품종이 어떤 게 있습니까
옌날 품종으론 인젠 다 치 지우고 시방 개량종이쪼	옛날 품종은 인제 다 치우고 시방 개량종 있지요
개량종 인제 그 모야 저모시 지도서 요 보그패 주는데 이 지려근 그니깐드루 화암 미트로는면 소재지 미트로는 화암 이리 삼 니 소끄깐 그건 그 노늘 부처요	개량종 인제 그 뭐야 저뭐서 지도에서 보급해 주는데 이 지역은 그러니까 화암 밑으로는 면 소재지 밑으로는 화암 이리 삼 리  그건 그 논을 부쳐요
화암 이리 삼니	화암 이 리 삼 리
응 화암 이리 화암 이리 저창서 내려오는 쪼기래요	응 화암 이 리 화암 이 리 서 내려오는 쪽이래요
그런 부치먼 요 모룬니 또 요 풍촌 면 하난 이 몬 나난제가 하고 하고 오르는데요	그렇게부치면 여기 모룬 리 또 요 풍촌면 하는 이그래요그래요
내 노 논 농사를 하니까 수확 만치게 거다 꼬추하고	내 노 논 농사를 하니까 수확 많지 거기에다 꼬추하고
그래요	아 그래요
응 꼬추 꼬추 거다 꼬추하고 고담 도마도 하우쎄가 자고 야는 저 그래요 시방 시방 저 그 취배추 모야 종모근 모르지요모	응 꼬추 꼬추 거기에다 꼬추하고 고 다음 토마토 하우스에다 하고 여기는 저 그래요 시방 시방 저 그 배추 뭐야 종목은 모르지요모
아란는데 옌나레는 어떤 게 이써써요	예 알았는데 옛날에는 어떤 게 있었어요
옌나레는 이지베라 내가 그 이르미 뭐 인는지 뭐 거	옛날에는 잊어버려서 내가 그 이름이뭐 있는지 뭐 거
요즈메는 저 쪼게 가니까 오대쌀 오대쌀	요즘에는 저 쪽에 가니까 오대쌀 오대쌀
오대쌀	오대쌀
마니 하던데 옌나레는 머 저기 그 벼 품종 가튼게 업썬나요	많이 하던데 옛날에는 뭐 저기그 벼 품종 같은 게 없었나요
이써찌만 건 기어근 안 나요	있었지만 그건 기억은 안 나요
그래요	아 그래요
그럼 어릴 때 머이 하기는 핸는데 그 머	예 그럼 어릴 때 뭐 하기는 했는데 그 뭐
그건 잘 모르시고요	그건 잘 모르시고요
그러며는 그럼 어르신 그 옌나레 그 논농사를 지 진는 과정이 농사를 어트게 진는지 처으메진는 과정을 쫌 알 쑤 이쓸까요	그러며는 그럼 어르신 그 옛날에 그 논 농사를 짓는 과정이농사를 어떻게 짓는지 처음에 짓는 과정을 좀 알 수 있을까요
그 먼저 봄 보미 되며는 어떠케 해야 되나 봄 인제 질려며는	그 먼저 몸 봄이 되며는  어떻게 해야 되나 봄 인제 지을려며는
질 먼저 질	질 먼저 질
그래간드루 인제 봄 에여기에 사월 오이리 아직 처리 안 돼꼬 언제든지	그러니까 인제 봄에여기에 사월 오일이 아직 철이 안 됐고 언제든지
네네	네네
고 인제 그때 마냑 외음지 그 누니 쓸코 인제 그 개화가 되자네요	그 인제 그때 만약음 음지 그 눈이 녹고 인제 그 개화가 되잖아요
꼬치 샥 아이 피고 풀 피고 이때머는 그 사월 오워리 한 오이리치	꽃이 샥 다 피고 풀 피고이때며는 그 사월 오월이 한 오일이지
음녁 음녀그로 치는 건가요	음력 음력으로 치는 건가요
요 음녀그로 아니 양녁 사월 오일 양녁 사월 오이리 오일 이 심는 나리 아님니까	여기 음력으로 아니 월 일 양력 월 일이 일 이 심는 날이 아닙니까
싱목 싱모기린데 그때 청명한 시기라고	심목 심목일인데 그때 청명한 시기라고
물 청명한싱만 지내며는 인제 그 농사질 준빌 하조	물 청명한 시기만 지내며는 인제 그 농사지을 준비를 하죠
농사질 준빌 허는데 청명한싱만 지내며는 한 여를 후에 대마 래 대마 대마 삼 사물 인제갈지오	농사 지을 준비를 하는데 청명한 시기만 지내며는 한 열흘 후에 대마래 대마 대마 삼삼을 인제 갈지요
시방 시릉코 바테 나가 갈 고  고 다으메 인제	시방 심어 놓고 밭에 나가 갈고  그 다음에인제
농사 이게 벼 벼농사 지을 때요	농사 이게 벼 벼농사 지을 때요
베느뇨 베 농사 질 쩌른 벼농사 질 쩌도 그기 사물 음녁 사멀 사월 사워리지	이 베는요베 농사 질 때는 벼농사 질 때도 그게 삼을 음력 월 월 월이지
사월 삼시빌 경에 가서 그 벼를 가따 으아리 가따 씨아시 부쪼	월 일 경에 가서 그 벼를가져다 응아리 갔다 씨앗을 붓죠
그러며는 먼저 벼씨 머 씨를 고르자나요 볃 씨를	아 그러며는 먼저 벼씨 뭐 씨를 고르잖아요 벼 씨를
베씨를 고르니 아니고 우리는 떠륻 베를 갈겓 타 치데가지고 떠러가지고다 그 베씨를 내일농사질 베씨 두 두마리먼 두말 서말 서말 씨아시 나투요	벼씨를 고르는 게 아니고 우리는베를 가을에 타 치데가지고 떨어가지고 그 다음 그 벼씨를 내일 농사 지을 벼씨 두 두 말이면두 말 서 말 서 말 씨앗이를 놔둬요
나 도따가 그 개령  시바누 전 개롱종 다시도 하고 바꾸 이찌마는 그때는 이르게 떠나가지고서는 그 방아까네 가서 머글 껀 찌꼬 나문 씨를 보관해 두따가 고다메 풍낭 사월	놔 뒀다가 그개량 시방은 전부 개량종 다시도 하고 받고 있지만 그때는 이렇게 떠나가지고서는 그 방앗간에가서 먹을 건 찧고 남은 씨를 보관해 뒀다가 그 담에 풍랑 월
고 씨를 뭐라고 함니까	그 씨를 뭐라고 합니까
베씨 벱씨 벱씨	벼씨 볍씨 볍씨
그읻 그거 그거 지버가지고 무레 가서 노네 가서 모씨를 맨드러 가지고	그거 그거 집어가지고 물에 가서 논에 가서 모씨를 만들어 가지고
그럼 인제 제가 인제 저 제가 인제 여쭤볼께요	아 그럼 인제 제가 인제 저 제가 인제 여쭤볼게요
베씨가 인제 거 보관해 놔따가 보관해 노코 이제 그 다메 노늘 먼저 가라야 되게쬬	벼씨가인제 그거 보관해 놨다가 보관해 놓고 이제 그 담에 논을 먼저 갈아야 되겠죠
그럼 거 거 거르쪼	그럼 거 거 갈았죠
언제쯤 부터 노늘 감니까	언제쯤 부터 논을 갑니까
그 오사월 한 그뭄 쩌게 저거 갈지요	그 오사월 한 그뭄 쩍에 저거 갈지요
고럼 인제 그 한 노 논 가능 거요	예 그럼 인제 그 한 노 논 가는 거요
네 가능 거 그러니까드루 한 그이	네 가는 거 그러니까 한그이
언제쯤	언제쯤
사월 한 시빌 경인가 그먼 쬐끔 갈조	사월 한 십일 경인가 그러면 조금 갈지요
그 어트게 감니까	아 그 어떻게 갑니까
무어스로	무엇으로
소 소로 갈조 소로	소 소로 갈지요 소로
소로 가능 거 그 농사로	소로 가는 거 그 농사로
소로 뭘어떤 도구로 하나요	소로 뭘어떤 도구로 하나요
보구레	보구레
보구레 아라요 보구레	보구레 알아요 보구레
네 네	네 네
보 보구레 가지고 갈지요모	보 보구레 가지고 갈지요 뭐
근데 소를 함마리	근데 소를 한 마리
아니 그리까두루 인제 집찜마다 소는 다 이씨니까 자기 자기 논 자기가 가지고 가능거지	아니 그러니까 인제 집집마다 소는 다 이쓰니까 자기 자기 논 자기가 가지고 가는거지
갈 때 인제 소를 한 마리 가지고 갈기도 하고 두 마리 가지고	갈 때 인제 소를 한 마리 가지고 갈기도 하고 두 마리 가지고
두 마리 고 저리 그 저리	두 마리 그  그
저리 저리 저 엽 이 우리 바튼 저나주 갈고 노네는 노니 뭐 저 아주 이러케 뭐 평수가 만코여러 바치기먼 저 논 먼저 여게 논 서 마지 갈면 너마지기 한 다래이 그를 때는 저 소를 가꼬갈지	저리 저리 저 옆 이 우리 밭은 저건 아주 갈고 논에는 논이 뭐 저 아주 이렇게 뭐 평수가많고 여러 바치기면 저 논 먼저 여기에 논 서 마지 갈면 너 마지기 한 다고 그럴 때는 저 소를  갖고 갈지 소 가지고 갈고 고 다메 인제 그 모 모를 가따가 인제 그래가 물 대가지고 물 말기를 맨들자나 말기 소 가지고 갈고 그 담에 인제 그 모 모를 갖다가 인제 그래 가서 물을 대가지고 물말기를 만들잖아 말기 말기를 저 읻 한 마자기 씨불만치 다서 평이면 다서 평 이러케 응 갈그 두고 그래 씨를와 뿌레 말기를 저 이 한 마자기 심을만큼 다섯 평이면 다섯 평 이렇게 응 갈아 두고 그래 씨를 와서 뿌려
그 아니 고걸 쪼끔만 더 자세히 요 바틀 인제 이게 쪽 갈자나요	아 그 아니 그걸 조금만더 자세히 이 밭을 인제 이렇게 쪽 갈잖아요
소를 가지고 이케	소를 가지고 이렇게
갈구는 물 대가지고	갈고는 물 대가지고
바틀 갈고 그 다메 인제	이 밭을 갈고 그 담에
물 대고	물 대고
그 다메 인제 무를	그 다음에 인제 물을
대고 고 다음 쓰 쓰레로 찌푸림 쌀머요	대고 고 다음 쓰 쓰레로 찌푸리면 삶어요
써래로	아 써래로
그러길래 내 본데 쌀머가지고	어 그러길래 내 본데 삶어가지고
그럼 언	그럼 언
그이 사월 금적끼쯤 한다고	그걸 사월 금적기쯤 한다고
사월 그뭄께쯔메요	사월 그믐께쯤에요
그래 그래가지고 인제 막 양쪼게 이르키 무를 대고 무리 몯 빠져나가두룩 말게를 딱 맨든다고	그래 그래가지고 인제 막 양쪽에 이렇게 물을 대고 물이 못 빠져 나가도록 말게를 딱 만든다고
말게	말게
응 말게 흥 말게를 맨든다고	응 말게 흙 말게를 만든다고
흥 말게를 요로케 맨드러서 무리 몯 빠져 나가게요	아 흙 말게를 이렇게 만들어서 물이못 빠져 나가게요
그러치	그렇지
그래구 인제 그 씨를 지베 딱 인제 오른 쪼 그 뿌리고 대기머는 한 상면쯤 무레 다머	그러고 인제 그 씨를 집에 딱 인제 오른 쪽 그 뿌리고 다니며는 한 상면쯤 물에 담어
그러문 쒹 뿌릴 께 아니요	그러면 쉭 뿌릴 거 아니요
네 네	네 네
곡서기 무레 드러가따 껀저 놈 뿔른다구	곡식이 물에 들어갔다 건저 놓으면 불른다고
녜  녜	녜 녜
그럼 그걸 가지구 가 떠레요	그럼 그걸 가지고 가 떨어요
근데 그러케 하기 그러케 하기 저네 인제 모짜리를 만들지 안나요	근데 그렇게 하기 그렇게하기 전에 인제 못자리를 만들지 않나요
그래 그게 모자리라꼬	그래 그게 못자리라고
네네네	네네네
그걸 모짜리라 한다고	그걸 못자리라 한다고
그래 인제 모자리 가따 뿌리고 그 저네는 인제 비니루 업써찌만 일모 업써찌만 시방 비니루가어떠케 비니루가 가따 어트케 말겔해 말게를	그래 인제 못자리 갔다 뿌리고 그 전에는 인제  비닐 없었지만 뭐 없었지만 시방 비닐이 어떻게 비닐을 갖다 어떻게 말게를 해 말게를
이러케 해서 하고 활때를 가따가 이러 꼬꾸 대를 댈 하나 꼬꾸서는	이렇게 해서 하고 활대를 갖다가 이렇게 꽂고 대를 댈 하나 꽂고서는
모자리는 한 어느 정도 종 함니까	못자리는 한 어느 정도 쯤 합니까
그거는 인제 서마지기 불라무는 메 평 두 마직 두 말 불라먼 메평 단마지기 메평 그 아푸로 그 마지가 백 오십평이라 앙 그래요	그거는 인제 세 마지기 불려면 몇 평 두 마지기 두 말불려면 몇 평 단 마지기 몇 평 그 앞으로 그 마지가 백 오십 평이라 안 그래요
그 예산 내서 인제 만들지	그 예산 내서 인제 만들지
모짜리를 어느 정돈 만드는 거조	못자리를 어느 정도는 만드는 거죠
그러치 그러치	그렇지 그렇지
다선 마지기 모짜리는 더 크고 넝마지기는 저글꾜 그러차네요 다섯 마지기 못자리는 더 크고 넉 마지기는 적을 거에요 그렇잖아요 그래가주 인제 활때를 돌려 꼽꼬 비니루 씨워	
그래가주 인제 활때를 돌려 꼽꼬 비니루 씨워	그래가지고 인제 활대를 돌려 꼽고 비질을씌워
씨워서 인제 그 태양이 미리 조으니까드루 무리 뜨거워요 자라자네요	씌워서 인제 그 태양이미리 좋으니까 물이 뜨거워야 자라 잖아요
베가 자라서 인제 쌀 저 인저 무 물까 인는데로 가카다 올라오머는 그먼 비느를 끌라도 탄다고 도늘 또	벼가 자라서 인제 쌀 저 인제 물 물가 있는데로 가깝게 올라오며는 그러면 비닐을끌어 놔도 탄다고 돈을 또
베를 거둬노먼 짐 일취월짱으로 푸로푸로 올러 가머는 요 오월 다노 다노 알지요 다노	벼를 거둬 놓으면 일취월장으로 푸로푸로 올라 가며는 요 오월 단오 단오 알지요 단오
다노 머리에 심 시머요	단오 무렵에 심 심어요
다노 다노 무려베	단오 단오 무렵에
응 무려베	응 무렵에
인저 곤 모자리 모자리에 인는 거뜨른 이제 다 뽀봐야 되자나요	인제 못자리 못자리에 있는것들은 이제 다 뽑아야 되잖아요
뽀버지 그럼	뽑아야지 그럼
뽀바서 이제	뽑아서 이제
또 저짝 인제 큰 노네 가서 그 그거또 인제 그 서로 가러서 미리 다 안 가러 노초	또 저쪽인제 큰 논에 가서 그 그것도 인제 그 서로 갈아서 미리 다 안을 갈아 놓지요
가러 무를 대 놔따가 인제	갈아 물을 대 놨다가 인제
무를 갈고 그때 가리질	물을 갈고 그때 가리질
또 아니 그래곤 쌈쪼	또 아니 그러고 삶지요
소를 가지고 써래 이써 그래	소를 가지고 써래 있어 그래
써라래 봐찌요	써라래 봤지요
저 솔 가떤 소나 쌀머선 그 말하자먼 그 흥무를 흘글 싼는 거유	저 소를 갔던 소나 삶아선그 말하자면 그 흙물을 흙을 쌓는 거에요
흥무를 쌈는거죠	흙물을 삶는 거죠
그러초 그래야 인지 딱 꼬꺼덩 그럼 인제 아처게 그 모꽁에 가서 한 마지기 두 서이 먼 센여섣 여섣 오늘 다슴 마지기 심다 하머는 사람 여를 구해요	그렇죠 그래야 인제 딱 꽂거든 그럼 인제 아침에 그 목공에 가서 한 마지기 두 셋이면 셋 여섯 여섯  오늘 다섯 마지기 심는다하면은 사람 열을 구해요
서로  그러나 지끔 몰 지며는 써래꾼 이써 써래 이써 써래꾸니라고	서로  그러나 지  금 모를 지며는 써래꾼 있어 써래 있어 써래꾼이라고 서 서 서 성골루 소를 아피 세우누꾸 써그래 끌초서 서 성한 소를 앞에 세워 놓고 써그래끌치요
돌 싼는 거요	돌 쌓는 거요
그래머는 놔따가 갈머는 다 싸꾸 나머는 인제 글 몰 시머	그러면 놨다가 갈며는 다 쌓고 나면 인제 그 모를 심어
써꾸나문 그날 바로 심는	이 삶고 나면 그날 바로 심는
시머야지 그기 안 써 그 전날 쌀머노먼 다 가라 안짜네요 흘기	심어야지 그게 안 써 그 전날 삶아노면 다 가라 앉아네요 흙이 그래 그러키하 그래 인제 벼농사는 그래 진는거유그래 그렇게 그래 인제 벼농사는 그렇게 짓는 거요
그럼 그러케 무를 써래질 하고 그 다메 번 이겓	그럼 그렇게 물을 써래질 하고 그 담에 번이게
번지 치고 그럼 그 다 치요 번지	번지 치고 그럼 그 다 치요 번지
번지 치고 심는 거요	번지 치고 심는 거에요
처메는 인제 노늘 갈고 그 다으메 물 대고	처음에는 인제 논을 갈고 그 다음에 물 대고
그 다음 모 모 무꼬 저기 모시 모 모짜리 해서 씨아시 부꼬 그런데 지 그작 클키고 고 다메 또 시물 쩌게는 큰 큰 노네 시물 노네 아라뚜 쓱 가라이따 물 대가지고 써래 도 써래 돌돌리면서 돌리면서	그 다음 모 모를 묻고 저기 모시 못자리 해서 씨앗을 붓고 그런데 지 그 잘클거고 그 담에 또 심을 적에는 큰 큰 논에 심을 논에 아래에 쓱 가랑이에다가 물을 대 가지고써래도 써래 돌리면서 돌리면서
한 번 며 뻔 돌리나요	한 번 몇 번 돌리나요
그거는 이 도로 아래요	그거는 이 도로 아래요
저쪼게 가서 확 돌려다 보먼 무리 저쪽 마니 가자네요	저쪽에 가서 확 돌려다 보면 물이 저쪽 많이 가잖아요
무리 거 나저	물이 거기는 낮어
그럼 이쪽 이쪼글 좀 더 이래 미러서 저쪼글 가먼 무리 무리 또까치 가자네요	그럼 이쪽 이쪽을 좀 더 이렇게 밀어서 저쪽을 가면 물이 물이 똑같이 가잖아요
무리 또까치 가머는 머 두 번 쌀물 때도 이꼬 또 노푼 데가 더 이러타고 그래 인제 어마하먼 번지 이쪼 번지	물이 똑같이 가면 뭐 두 번 삶을 때도 있고 또 높은 데가 더 이렇다고 그래 인제 엉마하면 번지 있지요 번지 가 번지 납때카는 거 하나 탁 때서는 쫙 내먼 그래무쿰 심는 심는 노니 다 되지 가서 번지 납짝한 거 하나 탁 대서는 쫙 내면 그렇게 하면 심는 심는 논이 다 되지
그래고는 인제 심는 데는 짝 서가지고 노니 머 수마지기다 이러며는 거리가 멀자네요	그러고는 인제 심는 데는 쫙 서가지고 논이 뭐 수 마지지다 이러면 거리가 멀잖아요
그래 이 줄 줄 띠우는 거 알지 줄 띠우는 거	그래 이 줄 줄 띄우는 거 알지 줄 띄우는 거
저짜게 야 꼬끄짜거나 인제 그 줄 저 일 모타는 하라버지 가튼 분드레 가선 주레나 다 시무머이 이 쪼써이러먼 저 쪼서가치 들고 뜨레 항 개만 처띠처 시꼬 또 또이래하먼 가치 이래 싱꼬	저쪽에 야 꼭 잡어라 이제 그 줄 저 일 못 하는 할아버지 같은 분들이 가서줄에 놔 다 심으면 이쪽에서이러면 저쪽에서같이 들고 뜰에 한 개만 척 척 심고 또 또어 이렇게 하면 같이 이렇게 심고 네 네
그래요	그래요
그러케 인제 모는 또 어트게 찐는 건가요	그렇게 인제 모는 또 어떻게 찧는 건가요
모는 소곰 바치조	모는 소금을 바치죠
시방 자천 시바은 저거 기게로 하고 기게로 다 심짜네요	시방  시방은 저거 기계로 하고기계로 다 심잖아요
옌나레 소느로 소느로 요로케 오쿰 요로 쪽쪽쪽 뽀버서 이 가르 가를 쌔 그래 욕땡이가 인제	옛날에 손으로 손으로 이렇게 오쿰 이렇게 쪽쪽쪽 뽑아서 이 가를 쌔 그래 옆에가 인제
한 오쿰을 쥐는거야	한 옹쿰을 쥐는거야
그러치 요레 요레 오쿠물 요래 재서 한 꺼버네 칵 쥐는 거 아니고 이 가를 쌔 이르케	그렇지 이렇게 이렇게 오쿰을 이렇게 재서 한 꺼번에 칵 쥐는 것이 아니고 이 가를 쌔 이렇게
가로 세로	가로 세로
이 이 강제 이래 가지고 이랜 그래 그르메 그래컨 이 미테는 흑 흑 덩어리지 너비를 그초	이 이 강제로 이래 가지고 이런 그래 그러며 그래 이 밑에는 흙 흙 덩어리지 너비를 그쵸 왜 베 베찌풀 가지고 확 꺼러서 매 이러케 왜 벼 벼짚을 가지고 확 걸어서 매 이렇게
베찌푸로 맨다고요	아 벼짚으로 맨다고요
응 한 다느로 요카조	응 한 단으로 이렇게 하죠
건 노네다가 확 확 쥐꼬 노치	그건 논에다가 확 확 쥐고 놓지
그럼 인제	그럼 인제
노네다가 인제 툭 툭 던져 논는거죠	논에다가 인제 툭툭 던져 놓는 거죠
그러치 그 던저나야 지지	그렇지 그 던져 놔야 지지
그 그 모꼬이 이써 또	그 그 목공이 있어 또
일꾼 두야혀	일꾼을 둬야해
그럼 그걸 심는 사라미 딱 이리 쥐머는 이 첨 배울 쩌겐 안 되요	그럼 그걸 심는 사람이 딱이리 쥐면 이 처음 배울 적에는 안 돼요
이거 이 소니 드러가 갈러 가지고 이리 이런데 내 존 이 이쑤케 지머는 이쑤케 지머는 이 소는 이 소니 가리킨다	이거 이 손이 들어가 갈라 가지고 이리 이런데 내 조금 익숙해 지며는 익숙해 지며는 이 손은 이 손이 가리킨다
이 소는 여다 딱 이래 하먼 학이러먼 왼손 이러서가지고 뭘 탁 쥐어가서 탁 쥐아져 이따가하먼 전주가 탁 빼머는 이게 이 송꼬라기 이 이 미러내요 요러케	이 손은 여기에다딱 이렇게 하면이러면 왼손 일어서 가지고 뭘 탁 쥐어가서 탁 쥐어야지 이따가하면 전주가 탁 빼며는 이게 이 손꼬락이 이 이 밀어네요 이렇게 이 쪼글 이 미러내먼 열로 이 연신 이 쪽을 이 밀어내면 여기로 이 연신
고걸 인제 말로 이케 설명을 해 줘야지이러케 하면 인제 이게 노금이 되니까 무슨 마린지 모르니까 말로 쫌 소늘 어떠케 한다고 구체저그로 말씀해 주시게써요	그걸 인제 말로 이렇게 설명을 해 줘야지이렇게 하면 인제 이게 녹음이 되니까 무슨 말인지 모르니까 말로 좀손을 어떻게 한다고 구체적으로 말씀해 주시겠어요
이 엄지가라글 딱 이랟 이짝 왼소네따가 오른 나 그 오른 손 재비니까 이 짝 딱 쥔다구	이엄지가락을 딱 이렇게 이쪽 왼손에다가 오른 나 오른손 잡이니까 이쪽에 딱 쥔다고
모물 저 머 머이 저 한추 와씨머는 얼른 걸러가지고 가 가르질 재쓰니까 딱 항 가루씽만 딱갈라가지고서는 딱 요래 쥐고 요 엄지가라글 이르 스스 내미러요	몸을 저 뭐 뭐 저 한 줌 왔으면 얼른 걸러가지고 가 가르질 쟀으니까 딱 한 가루씩만 딱 갈라가지고 딱 이렇게 쥐고 이 엄지가락을 이렇게 스스 내밀어요
내미러요	내밀어요
응 내미 그러치 요 내미 미테 꺼는 두 개는 요레 꼭 짭꼬 짜니요 요놈 내밀르이 요 갈키꺼아니요	응 내밀어 그렇지 이 내밀어 밑에 거는 두 개는 이렇게 꼭 잡고 있잖아요 이걸 내밀어이놈 내 밀면 이 갉히 거 아니요
그 갈리치머는 오른 손 이기 이기 미테 두 개는 피로써	그 갈리치면 오른 손 여기 여기 밑에 두 개는 필요없어
이 세 개여 고담 장가락 엄지가락 세개 간 네 개 까지고 이래 때구래	이 세 개야 그 다음가운데 손가락 엄지가락 세 개  네 개 가지고 이렇게 때고 그래
이 탁 때면서 요러게 탁 때면서 때면서 손 꼭 쥐고 이럼 꼭 꼭 꼭 쥐 아네요	이 탁 때면서이렇게 탁 때면서 손을 꼭 쥐고 이러면 꼭 꼭 꼭 쥐지 않아요
탁 쥐면서 탁 쥐며는 이 그 대공이 나요 처 이래머는 내려가주 손꾸락 이럳 이럳 탁 이러 무레 주너	탁 쥐면서 탁 쥐면 이 그 대공이 나요 쳐서 이러면 내려가지고 손고락을 이렇게 탁이렇게
쏘쫌 이래 쏘는 때공이거드뇨	이래 대공이거든요
소늘 뚝 지버 넌는다고요	손을 뚝 집어 넣는다고요
요 그래 콱 꼬찌먼 댐비래 이제 그래야 쉽찌 이걸	이걸 그래 콱 꽂으면 단번에 이제 그래야쉽지 이걸
자부며는 안 되겐네요	잡으면 안 되겠네요
끄틀 응 끄틀 이래 끄클 이래 쥐고 이래먼 또 이 소늘 가 때 이래먼 마니 다서 베기 꼬질 째한 패기 베끼 몯 꼬져	끝을 응 끝을 이렇게 끝을 이렇게 쥐고 이러면 또 이 손을 가 때 이러면많이 다섯 베기 꽂을 때 한 베기 밖에 못 꽂아
한 뻬기 바께요	한 베기 밖에요
응 이짝 소늘 이 내미러요 기게 기게가 내밀드시	응 이쪽 손을 이 내밀어요 기계 기계가 내밀듯이
소늘 내밀면서 그냥	아 손을 내밀면서 그냥
응 가 턱 쥐면서	응 가 턱 쥐면서
쥐면 그냥 또 바꼬 바로 꼼네요	쥐면 그냥 또 받고 바로 꽂네요
그냥 응 그래이머는 저서 내다보먼 머이 손끄테 무리 좀 이리 이따 내자네요	그냥 응 그러면 저기서 내려다보면 뭐 손끝에 물이 좀 이렇게 이따가 내잖아요
내가 뭐 서 따루 심니 뭐 그냥 하머는 일 때가지고	내가 뭐 서서 따로 심으면 뭐 그냥 하벼는 이렇게 때어 가지고
꼬즈먼 는네요	꽂으면 늦네요
안재료 이미 내래 행교 요 소늘 소늘요	이미 내가 한 거에요 이 손을 손을요
네 착 착 착 착 네 네	아 네 착 착 착 착 네 네
왕엳 때 이거 때 놔쓰니까 쥐미 쥐미 메빠꾸 꼬자뇨 요 요	때어 이거 때어 놨으니까 쥐면서 쥐면서 몇 바퀴 꽂잖아요 요 요
쥐면서 그냥 반네요	쥐면서 그냥 받네요
그럼 그 항 개이 탕 그게 이차 그 며태 배워야 돼요	그럼 그 한 개 그게  그 몇 해 배워야돼요
처메 가먼 우 절문 소인 시저레 가머는 이 모쫑해 모쫑	처음에 가면 젊은 소인 시절에 가면이 모종해 모종
모쫑을 움지기구 쌀문 그긷 모 뜨는 거 또 모 실른 거 요 자세히 보고 자기가 시방 메 일하문 어른들한테 쿠사리 쿠사리라고 그래써 서룸 반는다구 서룸	모종을 움직이고 삶은 그거모 뜨는 거 또 모 실른 거 이거 자세히 보고 자기가 시방 이렇게 일하면 어른들한테 쿠사리 쿠  사리라고 그랬어 설움 받는다고 설움
하그따구로 심니기 하먼 또또기 배우래먼 미테 배워야 매드른 시미나요 매드른 잘 심사는 잘 심는 사라문 한 해에 한 마지기 시머요 하루	하그따위로 심냐 하면 똑똑히 배우라고 하면 몇 해 배워야 매는 힘이나요 매는 잘 심사는 잘 심는 사람은 한 해에 한 마지기 심어요 하루
우리두 우리집 그전 대돋 노늘 마니 안 부처도 뽑 뽀펴 댕겨따구	우리도 우리집 그전 논을많이 안 부쳐도 뽑혀 다녔다고
잘 심는다구	잘 심는다고
까지는 거 탁 쳐서 마리 이럼 탁 이래 이리 착 깡겨	까지는 거 탁 쳐서 말이야 이러면 탁이래 이리 착 감겨
글교	그러는 거에요
네 하하하하	네 하하하하
그러케 인제 모를 이게 심네요 이게 쪼끔	그렇게 인제 모를 심네요 이게 조금
그러케 모를 이제 심짜나요 이제 다 시물 꺼 아니에요	그렇게 모를 이제 심잖아요 이제 다심을 거 아니에요
싱꼬나면 그 다메	심고나면 그 담에
매지요	매지요
괄리를 이제 해야죠	관리를 이제 해야지요
응 노늘 가 노늘 가 이제 매야조	응 논을 가서 논을 가서 이제 매야지요
논 이쪼게 그 모사리라능 게 이짜나 모사리	논 이쪽에 그 모서리라는 것이 있잖아 모서리
인제 아니 인제 시머 노머는 그게 뿌리를 때가지고 다시 가따 시무니까 그게 아처네요	이제 아니 이제 심어 놓으면 그게 뿌리를 때어 가지고 다시 가져다 심으니까 그게
사라미 사람 마나커드 병 병드러 가지고 안 시기래요 싱물도	사람이 사람 마냥 병 병들어가지고 안 래요 식물도
그러니까 인제 그게 인제 한 이시빌 시보일 그초 그래 인제 요런건 오창 시머 노먼 노라치	그러니까 인제 그게 인제 한 이십 일 십오 일 그렇지요 그래 인제 이런 것은  심어 놓으면노랗지
고다으메 인제 그기 무사랑 까무 우에 팔구래 하게 내려 잔차네요	그 다음에 이제 그  위에 팔구래 하게 내려 앉잖아요
그래먼 그 인제 소느로 소로 매 그 노늘 소쿰 삼백 평 두 마지기면 삼백 평이 아님니까	그러면 그 이제 손으로 소로 매 그 논을  삼백 평 두 마지기면 삼백 평이 아닙니까
그럼 이제 한 이주 후에 하나요	그럼 이제 한 이주 후에 하나요
이주 후에	어 이주 후에
이주 후에는 뭐 한 이시비이리나 되머는 가서 소느로 이 소느로 직쩝 마리야 그 포하 여줄 줄 하고 포기하고 사이 사에가 이 단 메씨짠드루 자네요 요러케	이주 후에는 뭐 한 일이나 되면 가서 손으로 이 손으로 직접 말이야 그   이 줄 줄하고 포기하고 사이 사이가 이 단 잖아요 이렇게
그럼 고 사이 이 손 하나 드러갈 정도가 시꾸든뇨	그럼 고 사이에 이 손 하나 들어갈 정도가
그래먼 고 포김 저탱이가 손 이래거드뇨 소니	그러면 그 포 젖탱이가 손 이렇거든요 손이
이러게 맨다고	이렇게 맨다고
호미로 매는 거 아니고 고거는 흑 흥무를 이래죽 이래죽 걸러주능교	호미로 매는 게 아니고그거는 흑 흙물을 이래죽 이래죽 걸러주는 거에요
벼에 벼 인는 고 서인는 서 세운데다가 소느로 이러케	아 벼에 벼 있는 거기 서있는 서세운데다가 손으로 이렇게
응 소느로	응 손으로
쓰다드머주는 거네요	쓰다듬어주는 거네요
고 고 모시기 이짜네요	고 고 뭐 있잖아요
골 이지 골	고랑 이지 고랑
네 골	네 고랑
골 고레가 이 베인는 골또 이찌마는 허고란데 이짜네요	고랑 고랑에 이 벼가 있는 고랑도 있지만 헛고랑인 데가 있잖아요
거게 거겔 감 베루 베를 센 이래머는	거기에 거길 가면 베로 베를 세워 이러면
흥무를 내서 베를 이륵 만드러주먼 베가 훨씬 나꺼든뇨	흙물을 내서 벼를 이렇게 만들어주면 벼가 훨씬 낫거든요
고 다음두 푿	그 다음
그걸 모자리라고 하는 검니까	그걸 못자리라고 하는 겁니까
그래 귿 그래 그래 매구 그랟 아이 도 아이 한 번 매고 두 번 매먼 다 끈나	그래 그거 그래 그래 매고 그래 아이도 아이 한 번 매고 두 번 매면 다 끊나
모사리도요	아 못자리도요
아니지 그건 짐 그 논 맨다 하지	아니지 그건 김 그 논 맨다 하지
모짜리 끈나고 나면 인제 놔두면 인제 모가 자라지요	못자리 끊나고 나면 이제 놔두면 이제모가 자라지요
자라고 나며는	자라고 나며는
고 다메 인제	그 다음에 인제
계속 무른 계속 댄 상태조	계속 물은 계속 댄 상태죠
아이 무리껀 봐야조	아이 물 이건 봐야죠
물또 모사리 하주 언쩡 나머는 마냥 무레 이써 아니조 고 다음 또 무를 떼요	물도 못사리하고  나면 마냥 물에 있는 게 아니죠 그 다음 또 물을 떼요
그건 노니 드러가머는 무를 따돌린다고	그건 논이 들어가면 물을 따돌린다고
그래먼 그 논 무리 자글 자글 끄러서 오래 따 보먼 인제 그 무리 자리 메갑짜뇨	그러면 그논 물이 자글 자글 끌어서 오래 있다 보면 인제 그 물이 자리를 메우잖아요
그래먼 바다게 요 바싹 말래요 좀 그러면 바닥에 바싹 말려요 좀 네	
쪼끔 말려따가 물드려	조금 말렸다가 물을 들여
사라미 모기 한 처베 마를 쩌게 물 항 곰 조 조치오	사람이 목이 엄청 마를 적에 물 한 모금조 좋지요
몽 마를쩌게 꺼시거든	목 마를 적에 그것이거든
그럼 물 말려따가 다시 무를 넌는거죠	아 그럼 물을 말렸다가 다시 물을 넣는 거지요
그러쵸 그럼 그 그래 연속	아 그렇지요 그럼 그 그래 연속
아까 계속 너따 빼따 요러케 해쬬	아까 계속 넣었다 뺐다 이렇게 했죠
응 그럼 그르게 끄내야듀	응 그럼 그렇게 꺼내야 돼요
그래가지고 인저 거 피지 피	그래가지고 인제 그거 피지 피
그먼 인제	그러면 인제
피 뽀바 또 내든지 해	피 뽑아 또 내던지 해
베 말고도 피 가 라는 게 이써 피가	베 말고 피라는 게 있어 피가
네 네	네 네
그 노네는 피라는 게 또 베처럼 올라나요 따로	그 논에는 피라는 게 또 벼처럼 올라와요 따로
게 고거는 인제 베가 한 자 되머는 피는 한 한 한 씸지어 더 노퍼 올라와	그래 그거는 이제벼가 한 자 되면 치는 한 한 한 심지어 더 높이 올라와
그럼 새 또 나가미 그 그거 땡낌 뽑꼬 그거또 갈게 가서 고마 베 뫼서 까라나따가	그럼 사이에 또 나가며 그 그거 다니며 뽑고 그것도 가을에 가서 벼 뫼서 깔아 놨다가
그러면 인제 고 고 상태에서 인제 그 피도 뽑꼬 그 다으메 그 풀 가튼 거 김 짐매자나요	아 그러면 이제 그 그 상태에서 이제 그 피고 뽑고 그 다음에 그 풀 같은 거 김 김매자나요
그래 아까 그 그게 김매는 거요 아께 그 내기	그래 아까 그 그게 김매는 거에요 아까 그맨게
그럼 김 여긴 김맨다라고 함니까 짐맨다고 함니까	아 그럼 김 여긴 김맨다라고 합니까 짐맨다고 합니까
김 김	김 김
짐 기미라고도 지미라 구래 여 마른 짐맨다 김맨다 이래	짐 김이라고도 짐이라 그래여기 마른 짐맨다 김맨다 이래
옌나렌 어떤 마를	옛날엔 어떤 마를
옌나레 지미라고 해찌 거기 짐	옛날에 짐이라고 했지 거기 짐
그래요	아 그래요
짐매자나요 보통 며뻔 맴니까	김매잖아요 보통 몇 번 맵니까
그래 건 두네 한 두 번 매지	그래 그건 두 번 한 두 번 매지
아께 내 얘기 하자뇨 그럼 물 흐 흐리고	아까 내가 얘기 하잖아요 그럼 물 흐 흘리고
그럼 첨 맬 때를 그걸 뭘 맨다고 함니까 처음	아 그럼 처음 맬 때 그걸 뭘 맨다고 합니까 처음
처메는 아이 매구 아이 두 두 벌  두 번 매먼 두 벌 세 번 매먼 세 벌	처음에는 아이매구 아이 두 두 벌 두 번 매면 두 벌 세번 매면 세 벌
세그면 아이 매고	세그러면 아이 매고
두 벌	두 벌
두 벌 매는 건 두 번	두 벌 매는 건 두 번
그럼 아이매고 나서 언제 이따가 두 벌 맴니까	그럼 아이매고 나서 언제 있다가 두 벌 맴니까
그거또 한 이시빌 이따 매지	그것도 한 일 있다 매지
이시빌 이따가 인제 그 두 번째 매는 거를 멀 맨다고	아 이십일 있다가 이제 그 두 번째 매는 거를 뭘 맨다고
두 두 두 번 맨다 그러지 두 번	두 두 두 번 맨다고 그러지 두 번
아이 매고 두벌 매고	아이 매고 두벌 매고
두벌	두 벌
네 두 벌 매고 나서	네 두 벌 매고 나서
이제 안 베지 뭐 그럼	이제 안 베지 뭐 그럼
그럼 피 뽀버	그럼 피 뽑아
마자 건 야께만치 장하자나 이러케 한 자 자 판쪽 모는 한 그 베도 이 저 머야 끄치 저저 싹 씨아씨 씨아시가 올러올 정도먼 망니피 나오고 말자네요	아 맞아 그건 아까처럼 장하잖아 이렇게 한 자 자 판쪽 모는 한 그 벼도 이 저 뭐야 끝이 저 저 싹 씨앗이 씨앗이가 올라올  정도면 막잎이 나오고 말잖아요
그래잔 그 피라는 기 딴 머 그런 잡똥새기 이써요	그래 그 피라는 거 다른 뭐 그런 잡동사니가 있어요
그건 베보다 더 더 노문 그 인저 베 저 태글 뽀버 치워야 된다고	그건 벼보다 더 더 올라오면 그 인제 벼 저  뽑아 치워야 된다고
그럼 두 벌 매고 나서 이제 그 다메 세 버른 안 매고	그럼 두 벌 매고 나서 이제 그 다음에세 벌은 안 매고
안 매조 안 매조	안 매죠 안 매죠
그때 세 번째는 피가 피만 이러케 뽑꼬	그때 세 번째는 피가 피만 이렇게 뽑고
피만 뽑꼬 고럼	피만 뽑고 그럼
뽑꼬 그러네요	뽑고 그러네요
그러면 자여느로 그만 여무는거지 뭐	그러면 자연으로 그만 여무는거지 뭐
벼씨만 잘 됨 뭐	벼씨만 잘 되면 뭐
그럼 인제 짐 매고 나면 그 다메 인제 그 자라면 인제 베야 되자나요	그럼 이제 김을 매고나면 그 다음에 이제 그 자라면 이제 베야 되잖아요
언제쯤 벰니까	언제쯤 벱니까
여게가 그기 터를 처서 기 음녁 가만 이써봐 음녁 시월 시월 딸 비지	여기가 그게 터를쳐서 그 음력 가만 있어봐 음력 월 월 달 베지
여겐 시월	여기엔 월
시월 딸 정도요	월 달 정도요
시월 시월 초승 초승쯤 삐	월 월 초승 초승쯤 달 베 중순경 그럼 물도 물로 비는 거 물르 드른 까래나따 물른 마르먼 오늘 타 타천는데 뭐 중순경 그럼 물도 물로 베는 거 물로 들은 깔아놨다 물은 마르면 오늘 타 타쳤는데 뭐
타춘다구	타춘다고
타출하지 타추	타출하지 타추
타초한다구요	아 타작한다고요
갈 갈 춘짜 타 타작 타자칸다 하기도 하고 타조한다고	가을 가을 춘 자 타 타작 타작한다하기도 하고 타조한다고
또 어느 거는 타자기라고 타작	또 어는 거는 타작이라고 타작
그러면 인제 베를 베서	그러면 이제 벼를 베서
쪽 까러요 옌나레는	쪽 깔아요 옛날에는
베고 나서 모로 벰니까	베고 나서 뭐로 벱니까
나즈로 베지	낮으로 베지
나즈로요	아 낮으로요
나즈로 베는데 나즈로 베서 그냥 그냥 나두죠 이러케	낮으로 베는데 낮으로 베서 그냥 그녕 놔두죠 이렇게
그러치 이러케 하날 베가지고 맨 뒤 뒤짜락 쪽 까라	그렇지 이렇게 하나를 베가지고 맨 뒤뒤자락에 쪽 깔아
거 노네다가	그거 논에다가
쪼네 까라나 도따가	쪽 깔아놔 뒀다가
한 얼마나	한 얼마나
날 날씨가 한 일쭈일 째나 짠 그럼 마르자네요	날 날씨가 한 일 주일 째나 째면 그럼 마르잖아요
그 마르먼 가 무꺼요	그 마르면 가서 묶어요
담 요러케 테두리라고 요러케	다음 이렇게 테두리라고 이렇게
어느 정도 묵쑴니까	어느 정도 묶습니까
하여튼 머 대이꼬찐 안 하고 이러게 마쮀서 마쮀서 더 더 크 크게	하여튼 뭐  안 하고이렇게 맞쥐어서 맞쥐어서 더 더 크 크게
마쮀서 더 크게 네 네	아 맞쥐어서 더 크게 네 네
그러게 인제 에	그러게 인제 에
고러케 다는 고런 다는 먼 무슨 다니라고 하나요	그렇게 단은 그런 단은 뭔 무슨 단이라고하나요
페딴	볏단
그러먼 이게 쫌 단도 크기에 따라서	그러면 이게 쫌 단도 크기에 따라서
크 크게 하는 거는 그거는 그건 큰다니라 하지	크 그게 하는 거는 그거는 그건 큰 단이라하지
큰 단	아 큰 단
뭐 요 테딴 그래 인제 요러케 해가지곤	뭐 이 볏단 그래 이제 이렇게 해가지고
그럼 요게 테따니고 요정도 마쭌거 보다 쪼끔 더 크면 제일 킁거는	그럼 이게 볏단이고 이정도 맞쥔거 보다 조금 더 크면 제일 큰거는
킁거는 페딴	큰거는 볏단
중간정도는 하나요	중간정도는 하나요
저건 건 건 중간타이라 하지	저건 건 건 중간탄이라 하지
예저네 그러거 안 해요	예전에 그런거 안 해요
그저네 베 떠는 기게가 와루와루 달를 때그 이 알조	그전에 벼 터는 기계가 와룽와룽 달릴 때그 이거 알죠
네네네	네네네
발루 발붐 그에 전수 도시물로 우리가 동리 마드른 여기 가그넨 존소글 이거 인게두 옌날 발로 다 이래는 거요	발로 밟으면 그에 전수 도시물로 우리가 동네  여기  존속을 이거 이렇게 해도 옛날 발로 다 이렇는 거요
전수가 뭔가요	전수가 뭔가요
전수 전 전수라 통게를 애기는 통게	전수 전 전수란 통계를 매기는 통계
전체를 전체를	전체를 전체를
전수를	아 전수를
그래 그래 까라나따가 그 읻 거 건는다고 이제 베 베 베를 거드니까 거둬서 매가지고서는	그래 그렇게 깔아 놨다가 그 이 거 걷는다고 이제 벼 벼를 걷으니까 거둬서 매가지고서는
고 다메	그 다음에
다늘 다늘 인제 묵짜나요	단을 단을 이제 묶잖아요
무꺼가지고	묶어가지고
보통 이 테딴하고 큰 단 둘 두 가지만 쓰나요 중간 다는 업꼬요	보통 이 볏단하고 큰 단둘 두 가지만 쓰나요 중간 단은 없고요
업꼬 업찌	없고 없지
큰 단 쓰는 거는	큰 단 쓰는 거는
왜 쓰나요	왜 쓰나요
큰 다는 모냐머는 이래 크게 인제 무꺼 가지고 와 가지고 지베 가지고 와서 뜰 쩌게 그 모야 그 거들 쩌게 나문 걸 고섕시러우니까 크게 묵찌마는 대랑 이 요런 테딴 마이 해요	큰 단은 뭐냐면 이렇게 크게 이제 묶어 가지고 와 가지고 집에 가지고 와서 들 적에 그 뭐야 그 걷을적에 남은 걸 고생스러우니까 크게 묶지마는 대략 이 이런 테단 많이 해요
그래가지고 이제 저 드렌 찌게로만 저다가	그래가지고 이제 저 들엔 지게로만 지다가
그게 언 까라 나따가 테따늘 묵짜나요	그게 깔아 놨다가 볏단을 묶잖아요
무꺼서 언제 그 계속 놔두나요	묶어서 언제 그 계속 놔두나요
아니지 그래 그래 가존 지 그 단 말링게 아니요	아니지 그래 그래 가지고 그 단 말린 게 아니요
그램 그 다음 무네다 가래요	그럼 그 다음 문에다 갈아요
도라간디이	돌아간데
두렁가러 딱 사네가서 요 푸떠부론 벼 아무나 안 질께 아니요	딱 산에가서 이  벼 아무나 안 질게 아니요
가래 노쳐	가래를 놓치요
응 그 가래노코	응 그 가래 놓고
또 그르치 안 허머는 모탄 떠른 저다가 미리 저다가 집 오래떠래다가 지베다 말까다그가따놔요	또 그렇지 안 하며는 못한 떨은 져다가 미리 져다가 짚  짚에다 그 갔다놔요
가래 나요	가래 놔요
그러구 인저 그 기게가 그 터는 베 끼게가 집찜마다 다 업꺼든뇨	그러고 이제 그 기계가 그터는 벼 기계가 집집마다 다 없거든요
그거뚜 인제	그것도 이제
옌나레는 그런 기계 말고	옛날에는 그런 기계 말고
다서 째 여서 째어울러 서요	다섯 째 여섯 째어울러 서요
그래요	아 그래요
가 인제 마냐게	그게 이제 만약에
고 기계 이르미 모나가요	그 기계 이름이 뭔가요
그게 베 베떠는 기게지뭐 베떠는	그게 벼 벼 터는 기계지뭐 베 터는
와루 와루 하는 고 발로 발부면 막 또라가자네 이러케 그 와룽와룽	와룽와룽 하는 거 발로 밟으면 막 돌아가잖아 이렇게 그 와룽와룽
이르미 이씀니까	이름이 있습니까
바두이 베 따는 와롱기게 와롱기게	바둥이 벼 터는 와롱기계 와롱기계
와룽기계요 에	와롱기계요예
그 인제 두리 뜨자뇨 두리	그 이제 둘이 털잖아요 둘이
서서마리 두리 인저 그래 뜰 쩌는 오늘 이 집 함 뜰자네요	서 서 말이 둘이 인제 그래 털쩍에는 오늘 이 집 한 번 털잖아요
하루머이 멀 가마니 까 뜰머는 고 이튼날 저 지베 가 뜨는데 뜨 도라가먼서 이 뜰고 그래며는 모 그 모를 부친 지비 한 동네 마냑 이십 찝 하며는 다섣 찝씩 올라가지고 하나씩 사나요그걸 하루면 뭘 가마니 까서 털며는 그 이튿날 저 집에 가 터는데 돌아가면서 이 털고 그러면모 그 모를 부친 집이 한 동네 만약  집 하면 다섯 집씩 올라가지고 하나씩 사 놔요 그걸   혼저 혼저 사놀 피료 업짜네요 여러 여러찌비 사서 가 사무 사서 공동구녕 사거라 그래 하는거요	
혼저 혼저 사놀 피료 업짜네요 여러 여러찌비 사서 가 사무 사서 공동구녕 사거라 그래 하는거요	혼자 혼자 사 놓을 필요 없잖아요 여러 여러 집이 사서 가 사서 공동으로 사거라 그래하는 거에요
금 옌나레는 와롱기계 하기 저네 이러케 막 이러케	그럼 옛날에는 와롱기계 하기 전에 이렇게막 이렇게
그럼 이거 이거 거 그거지	그럼 이거 이거 거 그거지
그 그 뭐라고 고런 걸 뭐라고	그 그 뭐라고 그런 걸 뭐라고
그거는 훌치기	그거는 훌치기
훌치기요 훌치기 이 낭그리대짜네요 문디요 턱 때가지고 짜르륵 그 짜르륵 훌투니까	훌치기요 훌치기 이 나무로 됐잖아요  턱 대가지고 짜르륵 그 짜르륵 훑으니까
훌치기에 하주 훌치기 옌나레 하다 그 다메 와롱기곈가요	훌치기에 하죠 훌치기 옛날에 하다 그 다음에 와롱기곈가요
와롱기게요 우리 우리는 우리 훌치기는 우린 안 해쓰요	와롱기계요 우리 우리는 우리 훌치기는 우린 안 했어요
그래요	아 그래요
우리 우로 아주 머이서 으른드리 해찌	우리 위로 아주 먼 어른들이 했지
그럼 훌치기 인제 그러케 하고 나서 그 다메 인제 고거를 지베 와서 인제그 노네 말린거는 그 미리 미리 오랍뜨레 가따논는 거또 인제 노네서 말린 한 어느 정도 말려따가 지부로 가져 오나요	그럼 훌치기 이제 그렇게 하고 나서 그 다음에 이제 그거를 집에 와서 이제그논에 말린 거는 그 미리 미리 뜰에 갔다 놓는 것도 이제 논에서 말린 한 어느 정도 말렸다가 집으로 가져 오나요
집 꺼그래니깐 베서 베 노코는 한 잘 마른 건 해싸리 잘 나가먼 일쭈이리 마르고 그 자뚤열흘 마르자네요	집 거 그러니깐 베서 베 놓고는 한 잘 마른 거는 햇살이 잘 나면 일주일에 마르고 그  열흘 마르잖아요
그래 그 말러 논는 때도 비가 온다 이기여	그래 그 말러 놓는 때도 비가 온다 이거야
그래먼 또 또	그러면 또 또
더 놔두고	더 놔두고
또 또 나거이자네요	또 또 나둬야 되잖아요
자주 오머는 거게서 베가 싸기나	자주 오면 거기서 벼가 싹이나
그래니깐두루 인제 그 애를 먹쪼	그러니까 이제 그 애를 먹지요
그래니깐드루 날씨만 잘 하머는 한 열흘 돼서 거더가지고 고다 그 문까에다 해가지고두사람 개 가지고 그 자리 떵 그 사네 떠네 가주 그초	그러니까 날씨만 잘 하면 한 열흘 돼서 걷어가지고 그 다음 그 문가에다 해 가지고두 사람 개 가지고 그 자리 그 산에 털어 가지고그렇지요
떠나가주구는 거서 질머 지구 지부루 가져가꼬 요즘 와서는 경웅기 경웅게다 실코 가고 또지베 저 저대난상 지베 뜰고 그짜그로 가두고는 그래도 들먹 들말러짜네요	털어 가지고는 거기서짊어 지고 집으로 가져갔고 요즘 와서는 경웅기 경웅기에다 싣고 가고 또 집에 저  집에 털고 그쪽으로 가두고는 그래도 덜 말랐잖아요
들 마르먼 멍석이쪼 멍석 멍서기라는 거	덜 마르면 멍석있지요 멍석 멍석이라는 거
마당에 짝 깔꼬는 베를 가따 쏘늘 거어서 떠논 물 태양에 하루 이틀 말래	마당에 짝 깔고는벼를 갔다 손을  떠놓은  태양에 하루 이틀 말려
말래가지고 방까네 가서 찌에가 쌀로 팔고 시방 모시도 매서는 마당 치무 매상 그러케 댕기  먼요 매상 요 한 임대도 할끼 임대도 존속 옹게고	말려가지고 방앗간에 가서 찌어서 쌀로 팔고시방 모서리도 매서는 마당 치며 매상 그렇게 다니면요 매상 이거 한 임대도 할거야 임대도 존속을 옮기고 매상서 매상서
매상	매상
매산	매산
매사 매상	매상 매상
예 매상 거 노네 바더 매상하는거	예예매상 그거 논에 받어 매상하는 거
네네 매상	네네 매상
팔 매 짜	팔 매 자
네 그러며는 그 이거 말리자나요	네 그러며는 그 이거 말리잖아요
말리며는 이게 그 이제 그 타저글 하면 베를 떠러낼라며는 그게 어느 정도 되야 베가 떠러내는지 어떠케 알 쑤 인나요 그게	말리면은 이게 그 이제 그 타작을 하면 벼를 떨어낼라면 그게어느 정도 되야 벼가 떨어내는지 어떻게 알 수 있나요 그게
어떤	어떤
타작	타작
아니 인제 베가 이게아를 그 떠러내자나요	아니 이제 벼가 이게알을 그 떨어내잖아요
아를 이제 타자게서 이제 베를 떠러 내며는 떠러내서 인제 거 찌어야 되자나요	알을 이제 타작에서 이제 벼를 떨어내며는 떨어내서 이제 거 찧어야 되잖아요
고 고 과정은 어떠케 되나요 베를 떠러내고나서 그 다멘뇨	그 그 과정은 어떻게 되나요벼를 떨어내고 나서 그 다음엔요
타 작하고 하고는 그 베 를 베 를 어트게 하느냐	타작하고 하고는 그 벼를 벼를 어떻게 하느냐
네네	네네
그래 내 아까 얘기하자네요	그래 내가 아까 얘기하잖아요
감투 그 태양에 건조를 해서 떠러따하더래도 또 자여니 쫌 눅짜네요	감투 그 태양에 건조를해서 떨었다 하더라도 또 자연히 좀 눅잖아요
방아 방아까네 가서 찔라하머는 고기 쫌 마르기를 정상으로 말러야지 너무 바싹 마르먼 뼈해지구유	방아 방앗간에 가서 찔라하며는 그게 좀 마르기를 정상으로 말러야지 너무 바싹 마르면뿌셔지고요
근데 그게 어느 정도 말라따는 걸	근데 그게 어느 정도 말랐다는 걸
그래 그거 알지요 베로 앙꺼 한 간다구요	그래 그거 알지요 벼로   간다고요
감가그로 아는 거에요	감각으로 아는 거에요
응 그러초	응 그렇지요
그래 인제 덜 말라씨니 망서근 망서글 펴고 말래가지고 가고 왜 저걸 봐요 우선 베나 콩 옥쑤수 우리가 매사거드뇨 무여베	그래 이제 덜 말랐으니까 망석은 망석을 펴고 말려가지고 가고 왜 저걸봐요 우선 벼나 콩 옥수수 우리가 매사거든요 무렵에
매상하면 그 사람들 책 책정되어 이써요	매상하면 그 사람들 책 책정되어 있어요
가따 뵈머는 이십 오도먼 정상이다	갔다 보여주면 도면 정상이다
이십 오도로 내려가머는 눅따	도로 내려가면 눅다
옌나레는 어떠케 해씀니까 옌나레는	옛날에는 어떻게 했습니까 옛날에는
옌나레는 깨미러서	옛날에는 깨물어서
그래요 어떠케 해요	아 그래요 어떻게 해요
옌나레는 콩강냉이를 깨미러요 깨미러	옛날에는 콩강냉이를 깨물어요 깨물어
깨미러 딱 쏘리나먼 옥쑤수 콩	깨물어 딱 소리나면 옥수수 콩
쌀 가튼 거는요	쌀 같은 거는요
쌀또 업찌	쌀도 없지
쌀도 잘 말르머는 좀 들 말르거는 이리 깨미머는 이 부시지 안코 눅씨하자뇨	쌀도 잘 마르면좀 덜 마르거는 이렇게 깨물면 이 부셔지지 않고 눅눅하잖아요
그런데 말른 거는 딱 깨밀머는 딱 깨지자나 쌀 알 아리	그런데 마른 거는 딱 깨물면 딱 깨지잖아 쌀 알 알이
그래먼 맏	그래면 말
말라따	아 말랐다
마 께지지무	막 깨지지 뭐
내가 망땡이란 얘기 하는 거 망때이 망때인 잘 대딴 얘기요	내가 망땡이란 얘기 하는 거망땡이 망땡이는 잘 됐단 얘기요
이러먼 망땡이 이제 좀 망때이다	이러면 망땡이 이제 좀 망땡이다
네 그럼 잘 대따 고러케 잘 되며는 이제 고거를 이제 방안까네 가저와서 찐는다	네 그럼 잘됐다 그렇게 잘 되면 이제 그거를 이제 방앗간에 가져와서 찧는다
그럼 그럼 전소기	그럼 그럼 전속이
그래가먼 돼요 옌나레 즉쩐 업쓸 쩌게는 옌나레 어른 어른드리 전수가 이부루 이부루 음식한다	그렇게 하면 돼요 옛날에 즉전 없을 적에는 옛날에 어른 어른들이 전수가 입으로 입으로음식한다
네네그러쿠나 예	네네그렇구나 예
그 간따니 가께요	예 그 간단히 갈게요
어르신 여기 인제 노네서 논농사도 지으셔꼬 반농사도 마니 지으셔따고 해짜나요	음 어르신 여기 이제 논에서 논농사도 지으셨고 밭농사도 많이 지으셨다고 했잖아요
그 어떤 거뜨를 지으셔써요 주로	그 어떤 것들을 지으셨어요 주로
반농사 중에서느뇨	밭농사 중에서는요
마이 지응거	많이 지은 거
마이 지응 거는 그게 연녀니 다르지	많이 지은 거는 그게 연년이 다르지
왜냐하머는 인제 첟 어떤 해는 옥쑤수가 젤 마니 하는 때가 이꼬 또 그 이드매 가서는 또 콩을 도 하는 데도 이꼬 요 이러니까두로 평수를 봐서는 비즏 비슫 한 거또 이꼬 요래 요러치 이러치	왜냐면 이제 첫 어떤 해는 옥수수가 제일 많이 하는 때가 있고 또 그 이듬해 가서는 또콩을 또 하는 데도 있고 이 이러니까 평수를 봐서는 비슷 비슷 한 것도 있고 이래 이렇지
그러며는 그 중 어떵 거또 콩도 하시고	그러면 그 중 어떤 것도 콩도 하시고
콩  보리 조이 모 밀 저 밀 미물 뭐 거 청보레 거 호메기는 호멥	콩 보리 조 뭐 밀 저밀 메밀 뭐 그 청보리 그 호메기는 호멥
거 호멥	그 호멥
응 팓	응 팥
고담 당콩이랑 거 이써 당콩	그 다음 당콩이란 거 있어
당콩이라는 게 또 이러케 납짝 납짝 항게 이따고 그거또 하고	당콩이라는 것이 또 이렇게 넙적 넙적 한 게 있다고 그것도 하고
그러면 그 중에서 예저네는 마니 하셔떵 건 어떵거세요	아 그러면 그 중에서 예전에는많이 하셨던 건 어떤거세요
예저네 여기 우리 고장에서	예전에 여기 우리 고장에서
마이 해뜬 마이 해뜽 거시 콩 옥쑤수 옌나레 강냉이라 하지	많이 했던 많이 했던 것이콩 옥수수 옛날에 강냉이라 하지
고담 메밀 조	그 다음 메밀 조
그니까 옏 어르신 그 말씀하실 땐 인제 옌날 말 가튼 거뜰	그러니까 어르신 그 말씀 하실땐 이제 옛날 말 같은 것들
글쎄 그 옌날말 그래 하제	글쎄 그 옛날 말 그래 했어
조 조  콩 고담 강냉이	조 조 콩 그 다음 강냉이
네그렁거	네그런 거
강내이 감자 감자 또 하고 감자	강냉이 감자 감자도 하고 감자
감자도 여러지지 뭐 돼지 감자랑 거또 코리부리항 거또 이꼬 양감자 노랑거 타고 무마푸우 마니 나능 거 그 여러 지리라니까 농사 제먼	감자도 여러가지지 뭐 돼지 감자라는 것도코가 부리한 것도 있고 양감자 노란 것 하고   많이 나는 거 그 여러 가지라니까 농사 지으면
그림 보며 쫌 이따 구체저그로 여쭤보고 근데 이제 보통 시저레 그 그래따가 반농사를 진는절차가 인는데 젤 먼저 인제 하는 거시 받 반농사를 지으라먼 어떠케 해야 됨니까 먼저	그림보며 좀 이따가 구체적으로 여쭤보고 근데 이제 보통 시절에 그 그랬다가 밭농사를 짓는 절차가있는데 제일 먼저 이제 하는 것이 밭 밭농사를 지으려면 어떻게 해야 됩니까 먼저
제일 먼저 진짇 보메 젤 먼저 진능 거시 파종하능 거시 대마	제일 먼저 봄에 제일 먼저 짓는 것이 파종하는 것이 대마
삼베 베 짱거 껍떼기 빼 베짜 말지요 삼베	삼베 베 짠 거 껍대기를 벗겨 베자 말지요삼베
근데 파종을 하기 저네 땅을 어떠케 해야 됨니까	근데 파종을 하기 전에 땅을 어떻게 해야됩니까
파종이 가마니 그냥 바테 이찌	파종이 가만히 그냥 밭에 있지
올해는 금녀네는 저 바텐 콩 심는다 저 바테는 옥쑤수 심는다 저 바테는 감자 심는다 다 이이꺼든	올해는 금년에는 저 밭엔 콩 심는다 저 밭에는 옥수수 심는다 저 밭에는 감자 심는다다 이런 게 있거든
그럼 장녀네 감재 시문 데는 또 그 다음 옥쑤수 싱꾸 옥쑤수 시문 데는 콩 심꾸 콩 시문데  강냉이 싱꾸 이러케 연녀니 이러게 그 종자를 바꿔서 바츨 시무무는 그 곡써기 잘 되지	그럼작년에 감자 심은 데는 또 그 다음 옥수수 심고 옥수수 심은 데는 콩 심고 콩 심은데는 강냉이심고 이렇게 연년이 이렇게 그 종자를 바꿔서 밭을 심으면 그 곡식이 잘 되지
그건 그러케 해 끄럼	그건 그렇게 해 그럼
주로 그러케 심는데 먼저 인제 씨를 뿌리기 저네 바틀 이제 갈자나요	아 주로 그렇게 심는데 먼저 이제 씨를 뿌리기 전에 밭을 이제 갈잖아요
뭘로 어트게 감니까 바틀	무엇으로 어떻게 갑니까
바틀 하지 여게는 아주 옌나레는 잘 모르게찌마는 우리 중녀네 와서 정서네 우리 마으레 보며는 한 뱅년 전부터 저리 소 두 말해	밭을 하지 여기에는 아주 옛날에는 잘 모르겠지만 우리중년에 와서 정선에 우리 마을에 보면 한 백년 전부터 저 소 두 말을 해
두 번 모 모에가 이 이 아홉 짜 아홉짜를 맨드레서 양쪼게 소가 이 땅 미 이어 소 모 모게다 미고 소가 두 마리가 갈지	두 번 모 모가 이 이 아홉 자 아홉 자를 만들어서 양쪽에 소가 이 딱 매 이어 소 뭐 목에다 매고 소가 두 마리가 갈지
그럼 저리 저리 보고 보고래라능 거는 호리 보구래 보다는 쫌 커요	그럼 저리 저리 보고 보구래 보구래라는 거는 호리 보구래 보다는 조금 커요
커야만 튼튼해야만 가자네	커야만 튼튼해야만 가잖아
그럼 머에가 아홉 짜 이 돈 이 저 소리라능 거 아페 중 매는 거 수리 아홉 짜 그래 가주고 인제 그 보습 호미 가능 거 보다 보스비 크지	그럼 멍에가 아홉 자 이 돈 이 저 소리라는거 앞에 죽 매는 거  아홉 자 그래 가지고 이제 그 보습 호미 가는 거 보다 보습이 크지
그래 그걸 가따 내다 간다고 그런	그래 그걸 갔다 내가 다 간다고 그런
왼 오른 짜게 인는 소 소 하고 왼짜게 인는 소 하고는 멀 오른 짜게 매 소를 가따가 요 매운 소는 오른짝 왼짜근 왼짝때로 그래가따가 소를 가따 매워야만 소가 잘 가지	왼 오른 쪽에있는 소 소 하고 왼쪽에 있는 소 하고는 뭐를 오른쪽에 매 소를 갔다가 이 맨 소는 오른쪽 왼쪽은 왼쪽대로 그렇게 갔다가 소를 갔다 매야만 소가 잘 가지
함 이쪼게 왼짜게 함 소가 이러케 지리 들자네요	하면 이쪽에 왼쪽해 하면 소가 이렇게 길이들잖아요
연습 해짜네요	연습을 했잖아요
그래게 왼짝 가따 매먼 틀리자네	그렇게 왼쪽 갔다 매면 틀리잖아
그래깐 자기 인는 위치에다가 소가다 매고 나가문 인제 내 가는 데는 보스비 크니깐 호리소보스 뽀다도 소 보스삐 제일 뽀스 크니까 땅을 더 지피 가러 티아머꼬 또 엽 여피 이 광이 또널리 갈리기 때미네 허리 대머는 허리 하루가리가 젤류 바먼 한 마지 가리	그러니깐 자기 있는위치에다가 소를 갔다 매고 나가면 이제 내가 가는 데는 보습이 크니깐 호리소 보습 보다도 소보습이 제일 보습이 크니까 땅을 더 깊이 갈어  또 옆 옆에 이 광이 또 넓게 갈리기 때문에허리 대면 허리 하루갈이가 제일 많이 하면 한 마지를 갈아
이틀가러 호리 이틀 가리이머는 제 하루에 다 간다	이틀을 갈아 호리 이틀을 갈리면 제 하루에 다 간다
매 그러치	매 그렇지
그래 고 고 다메 호 레 하나는 뒤에서 골  캐	그래 그 그 다음에 호리에 하나는 뒤에서 골을 캐
골 캐 씨아시 이 채는 골	골을 캐야 씨앗이 이 채는 골
그러며는 제리 저리가 먼저	아 그러면 미리 저리가 먼저
아이 아이 갈고 건 아이 인지피라고 갈고 또 뒤 뒤에는 그 호 호리라능 게 이써	아이 아이 갈고 그건 아이 라고 갈고 또 뒤 뒤에는 그 호 호리라는 게 있어
소 하나 가지고 가능 거 호리로 한다고	소를 하나 가지고 가는 거 호리로 한다고
그럼 그거 인저게 내다 골 타먼 고리 먹쭐치먼 되자네요	그럼 그거 진작에 내가 골을 타면골에 먹줄치면 되잖아요
고를 탄다고요	골을 탄다고요
골 타고 고 다음 인제 으 분재를 노코 그 다음 감자먼 감자 옥쑤수먼 옥쑤수 콩 콩 가따 시머요	골 타고 그 다음 이제 분재를 놓고 그 다음 감자면 감자 옥수수면 옥수수 콩 콩 갔다심어요
그래야만 아푸로 그 골 매자네	그래야만 앞으로 그 골을 매잖아
짐 매지 쉽꾸	김 매기 쉽고
그러며는 어르신 요걸 다시 말씀 하 하며는 먼저 씨를 뿌리기 저네 아이 먼저	그러면 어르신 이걸 다시 말씀 하 하면 먼저 씨를 뿌리기 전에 아이 먼저
갈고	갈고
갈고 그 다메	갈고 그 다음에
골 캐고	골을 캐고
고를 캐고	골을 캐고
고거 그 담 씨 감자 씨던	그거 그 다음 씨 감자 씨든지
그 다음 인젣 호리 호리로 하먼 또 고를	그 다음 이제 호리 호리로 하면 또 골을
캐고	캐고
호를 호를 가지고 고를 캐네요	호를 호를 가지고 골을 캐네요
캐고 고 다메는 감자를 심뜬 모 옥쑤수를 심뜬 콩을 심뜬 다 싱꼬는 호미 호미로 심는 거는여자드리 심꼬	캐고 그 다음에는 감자를 심든 뭐 옥수수를 심든 콩을 심든 다 심고는 호미 호미로 심는 거는 여자들이 심고
여기는 호미라고 하나 호모	여기는 호미라고 하나 호모
호미 호미	아 호미 호미
호모라 하기두 하구 호미라 허기두 해	호모라 하기도 하고 호미라 하기도 해
그래 가지구마 얘기 할 타씨여	그래 가지고 얘기 할 탓이야
저 홈 호미 가지구 와 이러케따 호미	저 홈 호미 가지고 와 이렇게 했다 호미
호미 가저와 이러기도 하고 호미 가저와 이러기도 한다고 그 두 가지 말 한다구	호미 가져와 이러기도 하고 호미 가져와 이러기도 한다고 그 두 가지 말을 한다고
그래가주구 그 아주 모네 싱꾸 그럼 광이 이 광이 알조	그래 가지고 그 아주 논에 심고 그럼 괭이 이 괭이 알지요
꼬깡이 이꼬 저 꼬깡이 그럼 인저 광이 나 담배떠리지	곡괭이 있고 저 곡괭이 그럼 이제괭이나
씨아시 무찌를 어트게 보기 보도 그 보두라 구래 보두	씨앗이 묻는 거를 어떻게 보기 보도그 보두라 구래 보두
문능 걸 보두라구 한다고 옌나레	묻는 거를 보두라고 한다고 옛날에
보둘한다	보둘한다
보두	보두
보두하구요	보두하고요
그래먼 인제	그러면 이제
그래가 그래 노먼 인제 응 그래 노먼 인제 응 그래 노먼 인제 옥쑤수 오고기 자기 그 일기에 마처서 올라 올라와 성장하능 거여	그래서 그래 놓으면 이제 응 그래 놓으면 이제 응 그래놓으면 이제 옥수수 오곡이 자기 그 일가에 맞혀서 올라 올라와서 성장하는 거야
그래이머는 올러 오먼 전속 호미를 가 쌍 매능거요	그러면 올라 오면 전속 호미를 가지고 싹매는 거에요
이만치만 오늘 오머는 응 예를 드러서 옥쑤수가 메 쎈치 올러와따	이만큼만 오늘 오면 응예를 들어서 옥수수가 몇 센치 올라왔다
그럼 품떡 또 올라 올 꺼 아녀 푸리	그럼 품떡 또 올라 올 거 아니야 풀이
게 풀 풀 푸를 제거하기 위해서는 호미를 매는 거요	그 풀 풀 풀을 제거하기 위해서는 호미를 매는 거에요
그래아무 옥쑤수도 함 다내 쌍 매거는 두버네 가서는 그게 두번 핸다 두번  그 두번	그래아무 옥수수도 한 번 다 내가 싹 매며는 두 번에 가서는 그게 두 번 했다 두 번 그두 번
그거또 두 번	그것도 두 번
거게는 그래 두 번 해먼 호미래 안 매고 이 호리 솔로 가지고 소를 드리 세워 가지고 그 보스피 가 쪼마한 보스불 이 저 보구래 끼워 가주고 내가 그 솔 대서 타	거기에는 그래 두 번하면 호미로 안 매고 이 호리 솔을 가지고 솔을 드리 세워 가지고 그 보습이 그 쪼그만한 보습을 이 저 보구래에 끼워 가지고 내가 그 솔을 대서 타 거기에는 그렇게 두 번 하면 호미로 안 매고 이 호리 솔을 가지고 소를 들이 세워 가지고 그 보습이 쪼금한 보습을 이 저 보구래에 끼워 가지고 내가 그 솔을 대서 타
골 내가 타먼 흘 양짝 부트머는 그 아이에 아이 맬 쩌게 남자 여자 푸미 열 깨 드러 갈 꺼가트머는 호미로 내따 두 번 하머는 다서시 하찰 껃 업써	골을 내가 타면 흙이 양쪽으로 부트면 그 아이에 아이 맬 쩍에 남자 여자 품이 열 개 들어갈 거 같으면 호미로 냅다 두 번 하면 다섯이 할 것 없어
그래 그러케 하먼서 갠는다고	그래 그렇게 하면서 갠다고
그러며는 그 쪼그마지만 풀 가틍 거도 그냥 한 번 쭉 그 호리로 함 번 가네요	아 그러면그 쪼그만 풀 같은 것도 그냥 한 번 쭉 그 호리로 한 번 쭉 그 호리로 한 번 가네요
이러케 쭉	이렇게 쭉
그럼 그러케 하지 그럼	그럼 그렇게 하지 그럼
그러먼 인제 북똗 끼도 하나요 부굴	그러면 이제 북돋기도 하나요 부굴
그럼 이 저 푸코	그럼 이 저 푸코
그 거기 그래간 보구래 그 홀래가트네도 고 허꼬른 곡썩 엄능 걸 내 타자네요	그 거기 그러니까 보구래 그 홀래 같아도 그 헛골은 곡식이 없는 걸 내가 타잖아요
곡썩 인는 걸 따내 그러니까두루 양짜게 푸코허찌 이러게 흘기 싸이지	곡식 있는 걸 따내그러니까 양쪽에 푸코하지 이렇게 흙이 쌓이지
그걸 뭘 싼는다고 함니까	음 그거를 뭘 쌓는다고 합니까
그 푸꼬 푸꼬 주르니야	그 부꼬 부꼬
부꼬준다	아 부꼬준다
응 두 벌 부꼬 주는 거지요	응 두 벌 부꼬 주는 거지요
부꼬준다라고 얘기를 하고요	아 부꼬준다라고 얘기를 하고요
그러면 그러케 부꼬를 줘서 인제 그냥 나두면 인제 자라자나요	그러면 그렇게 부꼬를 줘서이제 그냥 놔두면 이제 자라잖아요
자라요 그럼 자라지 그럼	자라요 그럼 자라지 그럼
그 저네는 이 시바는 비료가 이쓰니까 아이 아이 매고 뭐 이러게 옥쑤수 뭐 매거능 거따 비료를 주능 거요	그 전에는 이 지금은 비료가 있으니까 아이 아이 매고 뭐 이렇게 옥수수 뭐 매면 거기에다 비료를 주는 거에요
요서는 주구 또 또 두 버레 주고 뭐 뭐 이 또 이 재서자 그러치마는 옌나레는 비료가 업쓰니 아이 호미나줘 매고 두 버레 푸코 주머는 일기만 잘 하머는 그대로 크는 거요	여기에서는주고 또 또 두 벌에 주고 뭐 뭐 이 또 이  그렇지만 옛날에는 비료가 없으니까 아이 호미 가지고 매고 두 벌에 푸코 주면 일기만 잘 하면 그대로 크는 거에요
베도 그냥 그냥 크능 거요	음 벼도 그냥 그냥 크는 거에요
그러먼 너무 가무러 이 가무니까 거 씨 씨드러서 앙 커	그러면 너무 가물어 이 가무니까 그게 시 시들어서 안 커
장마가 지며는 너무 또 물커 가주고 야물지 모 터자네요 응	장마가 지면 너무 또 물커 가지고 야무지지 못하잖아요 응
야무진 게 업따고요	야무진 것이 없다고요
응 업쎄요 그러니까	응 없어요 그러니까
수와니라 수완 어른드리 옌날 어른들 말쓰미 농사가 풍녀니 지려먼 수와늘 잘 마쳐야 된다고 수와니랑 건 비가 비가 알마께 와야 된다	수완이라 수완 어른들이 옛날 어른들 말씀이 농사가 풍년이 지려면 수완을 잘 맞춰야 된다고 수완이라는 것은 비가 비가 알맞게 와야 된다
수와니랑 거 수완	수완이란 거 수완
비가 알마께 아이고 요번 비가 와씨먼 애가 저즐 모쓰물 쩌게 아주 저건 그거 어쑬 째 저즐가따 물려얀 애가 아기가 저즐 달게 먹짜네요	비가 알맞게 아이고 이번에 비가 왔으면 애가젖을 목 마를 때 아주 저거 그거 먹고 싶을 때 젖을 갖다 물려야지만 애가 아기가 젖을 달게먹잖아요
금방 저즐 머근데다가 가따 저즐 저꼭찌를 물리먼 어드르게 주문 시러할께 아니요	금방 젖을먹은데다가 갖다 젖을 젖꼭지를 물리면 얼러서 주면 싫어할 거 아니에요
그러니까 아기도 그 저지 목쑬 째가 엄마가 저즐 가따 물리머는 마시께 멍는데 곡썩또 고썩또실무린데 그거또 비가 오늘 와따 이기여	그러니까 아기도 그 젖이 먹고 싶을 때 엄마가 젖을갖다 물리면 맛있게 먹는데 곡식도 곡식도 식물인데 그것도 비가 오늘 왔다 이거야
그래먼 내일모레 해가 나오는 뭐가 나씨니까두로 빔 빔무리 머거쓰니 잘 크자뇨	그러면 내일모레 해가 나오는 뭐가 나왔으니까 빗 빗물을 먹었으니까 잘 크잖아요
근데 크나들 비가 또 온다 이기여	근데  비가 또 온다 이거야
또 그래먼 크다발키로 여 배 안 부리자 여피	또 그러면  이 배가
한 번 저 올라가고 안 되고 또 이번 그래 와씨머는 이 부 일쭈이리나 가서 어느 정도 둥버기마르고 이럴 쩌게 다시 비가 한 번 더 내러 주머는 또 그때가선 저 고 고 곡써기 또 또 더 크며버리자네요	한 번 올라가고 안 되고 또 이번에 그렇게 왔으면 이 일주일이나 가서 어느 정도 둥벽이 마르고 이럴 적에 다시 비가 한 번 더 내려 주면 또 그때 가서 저 고 고 곡식이 또 또 더커 버리잖아요
비가 안 오고 그냥 일쭈일 마네 와야 되는데 열흘가도 안 아놔	비가 안 오고 그냥 일 주일만에 와야 되는데 열흘이 지나도 안 안 와
버론 이주일간 아놔	심지어 이 주일 동안 안 와
또 담 삼주 삼 치일 이시빌 아놔 하머는 곡써기 요건 크지도 모타고 빼배 꼬여 이따 보며는엽또 모뽈고 고레 씨드러서 사라마고 가트면 병이 드러따 이기여	또 다음 삼 주 삼 칠에 이십일 동안 안 오면 곡식이 이건 크지도 못 하고 빼빼 꼬여 있다 보면 엽도  그대로 시들어서사람하고 같으면 병이 들었다 이거야
병이 드니까 예정에 이시빌 이구 한 다레왜 비가 온들 그때 암 씨드러서 주 주 주서기자너 그때가서 전소글 모 커 하니까 클 쎄 업짜뇨	병이 드니까 예전에 이십일 이고 한 달 동안비가 오더라도 그때는 시들어서  그때 가서 전속을 못 크니까 클 새가 없잖아요
그래먼 갈하먼 이 저루가 하 뭐 뭐 뱅거 뱅노니 할 노니 저래가머 그 저네 항 거 이기 뭐 이꼬치 피어서 망 열매가 달리고 이래 이건는데 그러케 수와늘 어데 뭐 수와늘 안 마쳐 주며는흉녀니 든다 흉년	그러면 갈면 이 저루가 하 뭐 뭐 밴 거 밴 논이 할 논이 저렇게 그 전에 한게 이게 뭐 이 꽃이 피어서 막 열매가 달리고 이렇게 익었는데 그렇게 수완을 어디에 뭐 수완을안 맞쳐 주면 흉년이 든다 흉년
수와늘 잘 마쳐주머는 때를 잘 만지먼 퓽녀니 풍녀니 진다 이기여	수완을 잘 맞쳐 주면 때를잘 만지면 풍년이 풍년이 진다 이거야
그리고 그 일기가 어떠냐 이기 옌날 어른들 말쓰미 일쯔기도 일 유 유거리 한 처리라고	그리고 그 일기가 어따냐 이게 옛날 어른들 말씀이 일찍이 일 육 월이 한 철이라고
농사꾼도 철쑤가 이짜네요 다	농사꾼도 철쑤가 있잖아요
곰파이 사처레 인는데 씨아시 뿌레야지 김매 타추해 응 타자캐 시간 인는데 그 시간 다노치머는 안 되자네요	곰팡이는 사철에 있는데 씨앗 뿌려야지 김 매 타추 해 응 타작 해 시간 있는데 그 시간 다 놓지면 안 되잖아요
꼬치 필 때 꼬치 페야조	꽃이 필 때 꽃이 피어야지요
응 이걸 때 이거야지	응 익을 때 익어야지
이 거 사사뭐시기로 안대 쓴다 이기여	이 거 사 사 뭐 안대 쓴다 이거야
그랜 그런 저그로 요 옥쑤수가 메 쎈치가 될 꺼또 저거서 메씨리 되고 메물 콩이 아리 오시바리야 열매가 달리끼머는 그 이러케 키 아뿔써네가지고 삼십 아리 안 되니까 그래도 갈게 가서는 창꼬에 열 까마니가 드러 가야 겨우레 머꼬 사는데 다섣 까마니가 안 되니까두루 겨우레봄 까지 머그라니 핻 꼭씨기 날 때까지 머글라니깐두루 그 싱냥을 줄 거 논다고	그런 그런 적으로 이 옥수수가 몇 센치가 될 것도 작아서 메씨리 되고 메밀 콩이 알이 오십 알이야 열매가 달리면 그 이렇게 키로 까불러 삽십 알이 안 되니까 그래도 가을에 가서는 창고에 열 가마니가 들어 가야 겨울에 먹고 사는데 다섯 가마니가 안 되니까 겨울에 봄까지 먹으라니 햇 곡식이 날 때까지 먹으려니까 그 식량을 줄 거 논다고
바불 모태 머꼬 메또레 가라서 주 죽 물 붜 가주 중물 응 머꼬 이래 이러케 옌날 사러 사러 와따고	밥을 못 해 먹고 멧돌에 갈아서 주 죽 물을 부어 가지고 죽물 응 먹고 이래 이렇게옛날 살아 살아 왔다고
그게 그기 그 내 시저레 내가 시저레 왜 내가 한 삼십 시절까지 그 저까 나오고 삼십 내 삼십유꾸러 봐선 인제 보리꼬개가 너머가고 박쩡히 양바니 정치를 이러케 으 그 생활 사어불 해 가주고 그래 가주고 지금 이 싱냥이 전소가 제 도라가고 이래따고	그게 그게 그 내 시절에 내가시절에 왜 내가 한 삼십 시절까지 그  나오고 삼십 내가 삼십 러 봐서는 이제 보릿고개가 넘어가고 박정희 양반이 정치를 이렇게 으 그 생활 사업을 해 가지고 그래 가지고 지금 이 식냥이 전소가 잘 돌아가고 이랬다고
비료가 나오고 비료를 들추니까 그까지 모 옥쑤수가 마리요	비료가 나오고 비료를 들추니까모 옥수수가 말이요
이러케 턱 뭐야 덩치도 굴꼬 알뚜 마니 드러가저씨우	이렇게 턱 뭐야 덩치도 굵고 알도많이 들어 가 있어요
오고기 다 전수가 비료 때미네 지금 농사를 지능 거요 저 배추 모 탄거	오곡이 다 전수가비료 때문에 지금 농사를 짓는 거에요 저 배추 못 한 거
그래서 이러케 농초니 농초니 뭐 모싸라 모싸라 하지마는 사실 에 모 싸는 게 아님니다 농촌도 잘 사래요	그래서 이렇게 농촌이 농촌이 뭐 못 살아 못 살아 하지만 사실 못 사는 것이 아닙니다 농촌도 잘 살아요
지금 요 나두 이런 지불 젠는데 나두 요 배추 배청 모 쓰머 이렁거 해서 일 녀네 한 삼천마넌 이천마너는 다 애들 교유글 소 키워 가주 이렁 거 그전 모태 농초네 대하꾜를 갈치구 여여 이럭 이럭짜리 지불 지꾸 이래	지금 이 나두 이런 집을 지었는데 나도 이 배추 배청 모 심어 이런 거 해서 일 년에 삼천만 원 이천 만 원은 다 애들 교육을 소 키워 가지고 이런 거 그전에는 못 해 농촌에 대학교를 가르치고 이 이 일억 일억짜리 집을 짓고 이래
그 그래가 지 이 지내간 역싸가 멀지 아나따구요	그 그러니까 이 지나간 역사가 멀지 않았다고요
인제 한 한 사 사 오심년 저네는 여기 그 저 싱냥이 엄는 사람 배 꼬러따 인저 배고러따고	이제 한 한 사 사 오십 년 전에는 여기 그 저 식량이 없는 사람 배 골았다 배를 골았다고
그집 배고러따고	아 그집 배 골았다고
어르신 그 옌나레 보리 농사도 제셔짜나요	어르신 그 옜날에 보리 농사도 지셨잖아요
제쪼 그름	지었지요 그럼
보리 농사를 질 질때 보리 종류가 이씀니까	어 보리 농사를 질 지을 때 보리 종류가있습니까
보리 종류가 갈보리 봄 보리 이찌	보리 종류가 가을보리 봄보리 있지
그래요	아 그래요
갈게 가러 갈게 인제 이 인즈 시방 인제 한참 보리 가러요 지금	가을에 가러 가을에 이제이 시방 이제 한참 보리 갈아요 지금
이때 보리 간다고 이때	이때 보리 간다고 이때
이때 보리 갈른 보리가이시비리먼 탁 올러 오자네요	이때 보리 가는 보리가이십일이면 탁 올라 오잖아요
코레 누러	노래
거 보리가 겨우레 지내가주고 그 갈보리요	그 보리가 겨울을 지나 가지고 그 가을보리요
그래 보메 그 오궐 따레는 보리 비자네요	그래 봄에 그 오월 달에는 보리 베잖아요
비고 봄보리는 또 보메 가러 보메	베고 봄보리는 또 봄에 갈어 봄에
보메 인제 사월 오일 지내머는 인저 보 가 가러서 거 되먼 갈보리 댐 쪼끔 느께 머거	그게되면 가을 보리 보다 조금 늦게 먹어
그 보리도 그 그렁거요	그 보리도 그 그런 거요
봄보리는 이제 보메	아 봄보리는 이제 봄에
가러 그럼 여 밀 밀 밀 청밀 현미 보리는 갈게 간다고	갈어 그럼 이 밀 밀 밀 청밀현미 보리는 가을에 간다고
봄보리만 보메 갈지	봄보리만 봄에 갈지
그 여기 쌀보리도 인나요	그 여기 쌀보리도 있나요
쌀보린 업써	쌀보리는 없어
쌀보리	쌀보리
여기 쌀보리 업써	여기 쌀보리 없어
껍떼기 버리지 그렁 건 안 해 봐따고	껍대기 버리지 그런 건 안 해 봤다고
건데 여기는	아 근데 여기는
미만 싸리지 미만 싸리지	미만 쌀이지 미만 쌀이지
쌀 쌀보리는 안 해 보셔써요	쌀 쌀보리는 안 해 보셨어요
아니요	아니요
금 여기는 인제 보리농사는 어터케 진능 거에요	그럼 여기는 이제 보리농사는 어떻게 짓는거에요
보리 농사 아께 얘기 해짜너 갈게	보리 농사 아까 얘기 했잖아 가을에
갈게 시방 인제 한참 간다고요 인제 왜냐먼감자 감자 보메 탁 캐짜네요	가을에 시방이제 한참 간다고요 이제 왜냐하면감자 감자 봄에 딱 캐잖아요
그럼 인제 그 감자 바테도 이러케 뭐 깨도 갈고 뭐 거 두문 두문 그 옥쑤수 시먼는데 건 암뻐러서 천제치고 다 제고 요새 좀 보리 가라요 요새 좀 간다고	그럼 이제 그 감자 밭에도 이렇게 뭐 깨도 갈고 뭐 그 두문 두문 그 옥수수 심었는데 그건  천제 치고 다 짓고 요새 좀 보리 갈아요 요새 좀 간다고
요새 인제 보리 한참 갈 때라고	요새 이제 보리 한참 갈 때라고
인저 보리 보리 콩 또까치 인제 보니까 바틀 가라서	이제 보리 보리 콩 똑같이 이제 보리까 밭을 갈아서
아께 그럼 뭐 지근 또까치 가는 또까치 뭐	아까 그럼 뭐  똑같이 가는 똑같지 뭐
요 재래두 재래들 갈도록 까러	이 재래도 재래들  깔아
홀켜 그 다메 보리	홀켜 그 다음에 보리
제 절 제라라고 하나요 저리라고 저리라고 하나요	이제 절 제라라고 하나요 저리라고 저리라고 하나요
소 두 마리 저리소 저리	소 두 마리 저리소 저리
쩌리 저리 저리라고	저리 저리 저리라고
호리 하나 하나 가능 건 호리쏘 호리 호리 보구래 호리 간다고	호리 하나 하나 가는 건호리소 호리 호리 보구래 호리 간다고
두 개 가는 저리 저리쏘라 그러지	두 개 가는 저리 저리소라 그러지
저리 보구래	저리 보구래
그러케 해서 인제 갈고 요 보리는	그렇게 해서 이제 갈고 이 보리는
갈게 그래 이때 간다고 이때	가을에 그래 이때 간다고 이때
이때 가라서 이제	이때 갈아서 이제
보메 보메	봄에 봄에
보메 인제 수화글 하자나요	봄에 이제 수확을 하잖아요
근데 이제 보리를 발끼 보리 발끼도 하나요 여기	근데 이제 보리를 밟기 보리 밟기도 하나요 여기
여는 거 안 해요	여기는 그거 안 해요
압때이는 그 노네 보리 밥또 마치 안치만 연 보리 발분제 업씨요	앞는 그 논에 보리 밥도많지 않지만 여기는 보리 밟는 거 없어요
왜 보리를 밤	왜 보리를 밟
그래간 보리 밤능 거는 압때이모냥 그 저 노래 부리고 패라 그런 땅이 드찌 아네요 드끼 이러케에	아 그러니까 보리 밟는 거는 앞댕이 처럼 그 저 노래 부르고 패라 그럼 땅이 듣지 않아요 듣기 이렇게
대다분 그 돌뿌리가 을자네요	대답은 그 돌뿌리가 읊잖아요
그러니깐 그 단단하라 발버 주능 거요	그러니까 그 단단하라고 밟아 주는 거에요
그 여게는 우리 시고른 딱 그 땅이 강하자네요	그 여기는 우리 시골은 딱 그 땅이 강하잖아요
강하다고요	강하다고요
응 땅이 인제 말하먼 그 저 진흑 매질 숙써 칼질 매지리라먼 아유 매질 매질 숙써	응땅이 이제 말하면 그 저 진흙 매질 숙서 칼질 매질이라면 아유 매질 매질 숙서
그 다메 뭐 황토 그래 여러 가지가 이끼 때무네 이러거 갈쩌겐 탁 뜨 심 드러 가지만 갈먼물물하지	그 다음에 뭐 황토 그래 여러 가지가 있기 때문에 이런 거 갈 적엔 탁 뜨면 힘 들어가지만 갈면 물물하지
그럼 씨아시가 드러가 씨아시가 올러 오머는 한 비만 오먼 탁 다진 키가 만타고	그럼 씨앗이 들어가 씨앗이 올라 오면 한 번 비만 오면 탁 다진 키가 많다고
그럼 딱 땅이 다저 다저 노니까 발불 피료 업찌	그럼 딱 땅이 다져 다져 놓으니까 밟을 필요가 없지
압땡이 간다고 압땡이	앞댕이 간다고 앞댕이
압때 멀구레 그런데 하지 그릉거는	앞에 멀구레 그런데 하지 그런거는
여긴 그냥 땅이 조키 때무네 발구리 안 하네요	아 여긴 그냥 땅이 좋기 때문에 밟굴이안 하네요
그럼 그러 어떤 행사 가틍 거또 그렁 거 잘 안 해꾸요	그럼 어떤 행사 같은 것도 그런 거잘 안 했고요
저너 볼 보리 밤는데 뭐 거 노래 부르고 이 그 요리는 뭐 차명어거리 여깅 거 업씨요	저기는 보리 보리 밟는데 뭐 그 노래 부르고 이 그 요리는 뭐  여기는 그런거 없어요
그냥 농사 그냥 진능 거요 그대로	그냥 농사 그냥 짓는 거에요 그대로
반농사 가틍 거 짐매기를 한 며 뻔 정도 하나요	아 밭농사 가튼 거 김매기를 한 몇 번정도 하나요
다 두 버리지 두벌 매지	다 두 벌이지 두 벌 매지
옌날 두 벌 시방은 머 시방은 전수 콩가까라지양 그런 곡씨기야 끄름	옛날 두 벌 지금은뭐 지금은 전수 콩 같은 그런 곡식이야 그럼
붐부기 지고서는 탁탁탁 이러게 시방은 지금 전소가 이러게 그 경웅기 노타 탁 치문 그럼 이이 뭐 백 평이고 천 평이고 팽 탁 치머는 그렁 꺼 지지지지 기게이씨요	붐부기 지고서는 특특특 이렇게 시방은 지금 전소가 이렇게 그 경운기 모타 탁 치면 그럼 이 이 뭐 백 평이고 천 평이고 팽 탁 치면 그런 그 지지지지 기계있어요
콩 심는 기계	콩 심는 기계
콩 거따가 한 한 말 너 가주고 메 짝 그게 이만한 콩이 기계 도라간 세 개 네 개 딱 뚸따가 시먼 캐요	콩을 거기에다 한 한 말 넣어 가지고 몇 짝 그게 이만한 콩이 기계 돌아간 세개 네 개 딱 두었다가  캐요
저 저 저 압떼 논 마리지 이 이양기 이씨요	저 저 저 앞에 논 말이지 이 이양기 있어요
이양기 시면서 여 그르카이 지끔	이양기 쓰면서 여기는 그렇게 해요 지금
옌나렌 저 호미로 시머따요 호미로	옛날엔 저 호미로 심었다 이 호미로
호미로 요러케 파올 딱 딱 옥쑤수고 뭐이고 다 그래 싱꼬 그래따고	호미로 이렇게 파 딱 딱옥수수고 뭐든지 다 그렇게 심고 그랬다고
그래 가지고 인제 이 굉이는 모두 보두 아너주고 노 올러 올러 오머는 아이 쌍 내 아이 아이사람 그래 그 제초제 약뚜 업찌 아무도 업짜네요	그래서 이제 이 괭이는 모두  올라올라 오면 아이 싹 매 아이 아이 사람 그래 그 제초제 약도 없지 아무 것도 없잖아요
그래니까누 남자 여자나 자기 만 펴는 피 저 여 부치던 오천 평을 부치더래도 우리 그 자기부부 부부 부부 또 고 다메 지베 가정에 어머니 아버지 자기네 시꾸 뭐 이래 마흔 다서씨먼그 다 다 매능 거요	그러니까 남자 여자나 자기 만 평을 부치던 오천 평을 부치더래도 우리  그 자기 부부 부부 부부 또 그 담에 집의 가정에 어머니 아버지 자기네 식구 뭐 이렇게 마흔다섯이면 그 다 다 매는 거에요
그걸 호미로 가따 땅을 다 다 해 한 번 싹 씨꺼 캐베링거에요 그 곡써글	그걸 호미로 가져다 땅을 다 다 해 한 번 싹 캐버리는 거에요 그 곡식을
그 땅 캐비거는 두 버레 가서는 아께 말처럼 소 소로 이러 타서 그래 옌나레는 소 아니먼농사 몯 쪄요	그 땅 캐고는 두 벌에 가서는 아까 말처럼 소 소로 일고 타서 그래 옛날에는 소아니면 농사 못 지어요
소농사 잘 치 옌나레는 그래	소 농사 잘 쳐 옛날에는 그래
그러머는 그 김 매기를 할 때 이제 소느로 한 번 매고	아 그러면 그 김 매기를 할 때이제 손으로 한 번 매고
그 다메 두 번 맬 때는 보통 소를 타네요	그 다음에 두 번 맬 때는 보통 소를 타네요
소로 소로 타조  다  타먼 소 소 소로 다 끄러	소로 소로 타지요  다 타면 소 소 소로 다끌어
그럼 끄내고 갈지	그럼 꺼내고 갈지
그 어르신 그럼 여기서 인제 옌나레도 서리 가틍 게 이짜나 서리 해 먹짜나요	그 어르신 그럼 여기에서 이제 옛날에도 서리 같은 거 있잖아 서리 해 먹잖아요
서리 해 먹쪼	서리 해 먹지요
어떵 걸 서리 주로 핸나요 옌나렌	어떤 거를 서리 주로 했나요 옛날엔
여 서리는 옌나레 거 감자 서래 옥쑤수 서리	여기 서리는 옛날에 그 감자 서리 옥수수서리
서래를 우리 우리 아치 야들까지 핸나	서리를 우리 우리 아이 아이들까지 했나
우리 아들까점 핸거테	우리 아이들까지 한 거 같아
이 저 저저 요리 이 거 도랑까 가먼 이 저 모래부레든지 월래는 떡빱 트근 바까래 라든지 올낄 바까야 돼	이 저 저 저 요리 이 거기 도랑가 가면 이 저 모래부레라든지 원래는 떡밥  바까래라든지  바꿔야 돼
저 따을 파능기여	저 땅을 파는 거야
땅을 파고 고 다메 이짜게 이러케 돌밍이 가따가서 이 미테 불루 마 해노코 그 도 우에 이씨먼 돌 매다러	땅을 파고 그 다음에 이쪽에 이렇게 돌맹이 갖고 가서 이 밑에 불로 마 해 놓고 그 도 위에 있으면 돌 매달아
파로 다 꿰머	파로 다
여다가 삼 삼하는 시그로 믿 처서 모 모태를 노코 그러구 옥쑤수 감자를 다 끄자 요러케착 연차게 노코는 우에다가 저 여 쑥 저 풀 푸를 가따가 베다 폭 덥꼬는 시방은 뭐 비니루가저꺼든 하구 업쓰니까 그래구 흘글 가따 미겨 흘글	여기에다가 삼 삼 하는 식으로 밑을 쳐서모 모태를 놓고 그리고 옥수수 감자를 다 꺼내 이렇게 착 연착에 놓고는 위에다가 저 여 쑥 저풀 풀을 갔다가 베서 폭 덮고는 시방은 뭐 비닐이 적었거든 하고 없으니까 그러고 흙을 갔다가매꿔 흙을
흐글 폭 더퍼 노코 내가 인제 호 이 화지비라 구래 화집	흙을 폭 덮어 놓고 내가 이제호 이 화집이라 그래 화집
불 화 짜 지비라고	불 화 자 집이라고
탕찜 걸 인제 흐를 끄러 무더꺼느	탕찜 그걸 이제 흙을 끌러 묻었거든
그럼 이기 곧 드러가는 무니 이써요	그럼 여기에 곧 들어가는 문이 있어요
구멍을 서 서 너 개 놔도	구멍을 서 서 너 개 놔도
성가게 놔둔다고요	성각에 놔둔다고요
거게 왜냐하머는 뭐요 옥쑤수랑 감자를 이러케 서래해 놔쓰니까 요다가 구녕이 이써야만 짐올러가자네	거기에 왜냐면 뭐요 옥수수랑 감자를 이렇게 서리해 놨으니까 여기에 구멍이 있어야만 김이 올라 가잖아
네 네	네 네
그래 이 거 뭐 무를 인제 뭐 서 이고 너 이고 인제 절문 두애지	그래 이 거 뭐 물을 이제뭐 셋 이고 넷 이고 이제 절문 두어야지
가따 그 다 총각 씨절 하지	갖다 그 다 총각 시절하지
퍼다가따가 그 그 다메 구녕을 쪼끔 우로 이래 주머는 돌미이다 무를 주먼 그 지미 인날쩌아니요	퍼서 가져다가 그 그 다음에 구멍을 조금 위로 이렇게 주면 돌맹이에 물을 주면 그 김이 일어날 게 아니요
그 지미 우에다 싸발라쓰니 갈 때 업짜나 그럼	그 김이 위에가 막혔으니 나갈 때 없잖아그럼
구녕으로 가 구녕으로	구멍으로 가 구멍으로
올라 가 가주 아네 또 짐 올라와 짐 나갈 때 업짜네	올라 가 가지고 안에 또 김이 올라 와김이 나갈 때가 없잖아
지무리 준다 지무로	지물이 준다 지물로
그래 한 번 주곤 좀 이따가 한 이십 뿌니나 좀 쉐가지고 다시 인제 또 도리 도주 도줌	그래 한 번 주고는 좀 있다가 한 이십 분이나 좀 쉬어 가지고 다시 이제 또 돌이 도주 도줌
또 쉐 해서 어데 그래가주고 삭 대마도 옌나레 그러케 한다고	또 쉐 해서 어디에 그래 가지고 대마도 옛날에 그렇게 한다고
그래가주고 인제 애 좀 꺼내보먼 감자 그 옥쑤수가 이러고 광 고담 콩 광재이 광재이라고 이찌 광쟁이	그래 가지고 이제 이거를 좀 꺼내 보면 감자 그 옥수수가 이렇고 광 그 다음콩 광쟁이 광쟁이라고 있지 광쟁이
그거또 조나 끄내먼 다 다 이 거 아네 꺼 다 인능거요	그것도 같이 꺼내면 다 다 이 이거안에 거 다 익는 거에요
거 드러감 고긴 안 이거	거기에 드러가면 고기는 안 익어
그래서 성애 부꼬	그래서 성애를 붓고
그러치 아느머는 이러케 저 노래라능 기 돌맹이 이쓰먼 젤 킁 거	그렇지 않으면 이렇게 저 라는 것이 돌맹이 있으면 제일 큰 거
에 저 시 번 쪼가리 가틍 거 고거먼 도레 그걸 가따 가서는 노코는 흘글 강에 감 이 저 두치처너머네 짜울래	이 저 십 원 쪼가리 같은 거 그거면 돌에 가져 가서 놓고는 흙을 강에 가서이 저 두치  짜울려
맹거를 맹거를 짜울래 걸	맨 거를 맨 거를 짜울려 그걸
이래 짜우리고 그 새 미테다 모태를 노코는 거다가 인제 감재 깡냉이를 또 서래고는 미테부를 너	이렇게 짜울리고 그 사이에 밑에다 모태를 놓고는 거기에다가 이제 감자 강냉이를 또서리하고는 밑에 불을 넣어
부를 너 그 돌매이가 다라	불을 넣서 그 돌맹이가 달아
달문 제 여기 뒤에다 물 주는 구녀이 이써요	달아 오르면 이제 여기 뒤에다가 물을 주는 구멍이 있어요
거다 무를 주며는 미테 돌매이 다라쓰니까두루 적 짐 오르 오자네	거기에다 물을 주면 밑에 돌맹이가 달았으니까 김이 올라 오잖아
그래 가지구 끄내 머거 서리 그게 서리라고	그래 가지고 꺼내 먹어 서리 그게 서리라고
그 감재 설래 강냉이 설래 옌말	그 감자 서리 강냉이 서리 옛말
그렁 걸 하셔써요	아 그런 걸 하셨어요
옌나레는 그 보리찝 이게 지퍼라틍 게 마니 이짜나요	옛날에는 그 보리짚 이게 짚 같은 게많이 있잖아요
지푸로 어떠케 해요 뭘 만드런나요	짚으로 어떻게 해요 뭘 만들었나요
집 가지고	짚 가지고
보리집 이거는 아니 저 저 전서 보리채 이렁걸 저 쐬게서 바트로 나 나가고 여게 저 뭐시기청머리 내 저 호 호 시방 호미라구 이찌 호밀	보리짚 이거는 아니 저 저 전속을 보리째 이런걸 저 썩혀서 밭으로 가지고 나가고 여기에 저 뭐 청머리 내 저 시방 호밀이라고 있지 호밀
호밀 청머리 점부 키 커요	호밀 청머리 전부 키가 커요
키가 마흔 네자 돼쓰니까 건두 그 대고이 빠빠태	키가 마흔 네 자가 됐으니까 그것도 그대공이 빳빳해 그거 인제 떠러서 그 곡써근 인제 가라 가주고 뭐 이 칼국태 해 머꼬 그러치마는 그 지푼 여페 이르기 여꺼 가주고 집 고담 원 원 집 말고도 인저 화장실 이짜네 바께그거 이제 떨어가지고 그 곡식은 이제 갈아 가지고 뭐 이 칼국수 해 먹고 그렇지만 그 짚은 옆에 이렇게 엮어가지고 집 그 다음 원 원 집 말고도 화장실 있잖아 밖에
화장실 방아깐 방아 찐능 거 거 이튼 거 쓰지 지푸로 가주고	화장실 방앗간 방아 찧는거 거기에서  거기에서 쓰지 짚을 가지고
그게 이엉 거 이엉라 하더 이엉	그게 이엉 그거를 이엉이라 해 이엉
지금 이엉이라 그텨	지금 이엉이라고 그래
그래먼 이엉 지붕 지푸로 그래서 그래 존찝 이러고 모 수수 더 이찌 옥쑤수 여 전소가 쏘를 소 다 미기지 콩깍찌 가틍 거는	그러면 이엉 지붕 짚으로 그래서 그래 좋은 짚 이러고 뭐수수 더 있지 옥수수 여기 전소가 쏘를 소 다 먹이지 콩각지 같은 거는
소 꺼 소 함 번 머켜보래	어 소한테 그걸 한 번 먹여봐
그 저 저 그 쏘를 가주고 이 작뚜에 이르 쏘를 가주고 시반 뭐시기 막 쏘가져간	그 저 저그 쏘를 가지고 이 작두에 이렇게 쏘를 가지고 시방 뭐 막
시방 싸람드른 해요	시방 사람들은 해요
옌나레는 짐 이 지게를 질머져 저 저런 저 상꼭띠기라 해 상꼭 건 상꼬때기라는 그때는 잼말라요 잼말랑	옛날에는 짐 이 지게를 짊어져 저 저런 저 산꼭대기라 해 산곡 그건 산꼭대기라는 그때는 잼말라요 잼말랑
우리 잼말랑이 거게 여서 봄 일 키로 오백 한 저 일 키로는 지 질머지고 그 퇴비를 해	우리 잼말랑이 거기에 여기에서 보면 일 키로 오백 한 저 일 키로는 지 짊어지고 그 퇴비를 해
질머지고 거러가능 거야 매부리 지고요	짊어지고 걸어가는 거야 매부리 지고요
저 재를 보고 해찌먼 실감 마름 모르고 저 인저 실 융나래 미트리 아러요	저 재를 보고 했지만  모르고 저 이제 신 육날 미투리 알아요
재시기라고	재식이라고
집씬	짚신
융날 미트리요	아 육날 미투리요
집씬	짚신
네 네	네 네
그거 싱꼬 뭐 그 뭐 어데 운둥화 이꼬 어때뜸 뭐 고무신 이써	그거 신고 뭐 그 뭐 어디 운동화 있고 어쨌든 뭐 고무신 있어
그거 싱꼬 오늘 시느문 그 이튼날 가서 자몯 돌맹이 그럼 이틀도 앙 가 퍼져	그거 신고  오늘 신으면 그 이틑날 가서 자못 돌맹이 그러면 이틀도 안 가서 퍼져
맨발두 마니 댕기구 아이구 그이 그때는 시방 그 우리 손녀 손자들 손녀들 시방 그 학쌩드리나 지끔 후세 시방 아들 얘길 하먼 시 뭘 하라버지네 그래쓸까 시방 이 이 얘들 클먼뇨 이크닐 나써	맨달로도 많이 다니고 아이고 그 그때는 시방 그 우리 손녀 손자들 손녀들 시방 그학생들이나 지금 후세 시방 아이들한테 얘기를 하면 시 뭘 할아버지네 그랬을까 시방 이 이 애들이 크면요 이 큰일 났어
고생이랑 거 모르고 점차 거	고생이란 거를 모르고 점차 거
우리 우리 요 저 내 딸 딸또 올해 사십 머근 내 딸도 딸뚜 다 아러요 딸뚜	우리 우리 이저 내 딸 딸도 올해 사십 먹은 내 딸도 딸도 다 알아요 딸도
그래 요 그래니깐 이거 찌금 농사가 이러게 변동 됭 기 며 태 안 된다이	그래 이 그러니까이거 지금 농사가 이렇게 변동 된 게 몇 해 안 된다고
뭐 애를 하꾜 뭐 열아홉 쌀 댕길 쩌거는 전소그로 내 사네 가서 일 하먼 그 까 사네가 꼬치도 가치 딴 아드리고 짐 맬쩌도 가치 이꼬 거 와서 겨테 안저서 엄마 짐 매먼 다 보고그 심부름 다 해따고요	뭐 애들 학교 뭐 열 아홉 살 다닐 적에는 전속으로 내 산에 가서 일 하면 그 산에가 고추도 같이 딴 아이들이고 김 맬 때에도 같이 있거 거기에 와서 곁에 앉아서 엄마가 짐 매면 다 보고 그 심부름 다 했다고요
그래 인저 매틀께 지금뇨 인제 한 삼심 년 좌우간 여기 농초니 아래찌분 전소가 폐허가 나오고 이래 개바리 돼 가주고 천채근 주이래 그래써 옌나레는 이 어두운 시 정치고 어두운 시대고 그만침 응 능녀근 이써도 모등 게 안디가 아푸로 봐 아푸로 이 비행기가 댕기메 약 다치 치자네요	그래 이제  지금요 이제 한 삼십 년 좌우간 여기 농촌이 아래집은 전소가 폐허가 나오고 이렇게 계발이 돼 가지고 천책은 중이래 그랬어 옛날에는 이 어두운 시 정치고 어두운 시대고 그만큼 응능력은 있어도 모든 게 안 되고 앞으로 봐 앞으로 이 비행기가 다니며 약 다 치잖아요
지금 약 다 치고 다 하니까두루 가 인제 가마 안저서 납뚜루해주께이지	지금 약 다 치고다 하니까 가서 이제 가만히 앉아서
그래니까 교수님	그러니까 교수님
그낭 딴늠한 한 애가 선는데 여젠 훌 이 끄건 조강꺼보더 뭐 그 천재 영어 정치는 뭐 쫭 외게찌마는 날라리 가터 얘기여	그냥 딴늠한 한 애가 서 있는데 이제 이 그건  보다 뭐 그천재 영어 정치는 뭐 쫙 외겠지만 날라리 같아 얘기야
왜냐먼 우리가 그 당군 시대부터 내려 오능 기 매천 년 내려온 식 이고 글다보니까 각썽만지가 생기고 요케 김씨굴 제자꼴 고가분지 쭉 해서 이 되는데 현재 와서 세 개 세개의 문화를바다 드려 가지고 세개의 어깨를 저울로 하니까두루 영어도 해야 돼 그러차나요	왜냐하면 우리가 그 당군 시대부터 내려 오는 것이 몇천 년 내려온 식이고 그러다 보니까 각성만지가 생기고 이렇게 김씨굴 제자골 고가분지 쭉 해서 이렇게 되는데 현재 와서 세 개 세 개의 문화를 받아 들여 가지고 세 개의 어깨를 저울로 하니까 영어도 해야 돼 그렇잖아요
칠천 그 구나라에 가서 뭥 교 그날 그 하고 결혼도 해 가지구 대통령 와따 가따 하고 정치를좀 하는데 건 잘 되는데	칠천 그 구나라에 가서 뭐 하는 거에요 그날 그 하고 결혼도 해 가지고 대통령 왔다 갔다 하고 정치를 좀 하는데 그건 잘 되는데
그건 조은데 외서 대추낭개 대추 요래 들고 임그뫙이 잉그메 임 이러면 되는데 왜 대추남개에다가 임금 임금 나무하고 거다 부쳐 가주고서는 대추도 안 이건는데 문다 가만드리냐	그건좋은데  대추 나무에 대추 이렇게 들고 임금왕이 임금의 임 이러면 되는데 왜 대추 나무에다가 임금 임금 나무하고 거기에다 붙여 가지고서는 대추도 안 익었는데 문다 가만들이냐
영 영겅이 영겅이 뭐에요	영 영겅이 영겅이 뭐에요
능금	능금
능금낭기 이써야 되능 거 몰라요	능금나무 있어야 되는 거 몰라요
능능금 네	아 능능금 네
마실	마실
네 네	네 네
그게 뭐냐유 매석 지금 아푸로요 지금 아드리 지금 뭘 머꼬 사리 쪄 너무 커	그게 뭐에요매석 지금 앞으로요 지금 아이들이 지금 뭐를 먹고 살이 쪄 너무 커
우유 먹쪼	우유 먹지요
우유	우유
그래 우유를 도 그냥 두우 요 요 요 두유 이르지만 요새는 뭐 밀까루 가지고 맨들던지 뭐 어떤걸 맨드러서 부뉴는데 공장을 뭐 딴 걸 맨드러서 야글 너서 부뉴 하지만 되래 보먼 우유라구래 우유	그래 우유를 또 그냥 두유 요 요 요 두유 이러지만 요새는 뭐 밀가루 가지고 만들든지 뭐 어떤 걸 만들어서 분유 하는데 공장을 뭐 다른 거를 만들어서 약을 넣어서 분유 하지만되려 보면 우유라고 그래 우유
우유 부뉴	우유 분유
그래 얘들 엄마가 소라고	그래 아이들 엄마가 소라고
하하하하하	아 하하하하하
오느리 그런데 교수님 그 옌나레 그 얘기가하아들한테 뭐 아무 얘기 하다 자꾸 얘길해 부타글 하고 또 뭐이 이러 가르치기도 안 드짜네요	오늘이 그런데 교수님 그 옛날에 그 얘기가하 아이들한테 뭐 아무 얘기 하다가 자꾸 얘기를 해 부탁을 하고 또 뭐 이렇게 가르쳐도 안 듣잖아요
그래 뭐라 함니까	그래 뭐라고 합니까
저 자식 소 귀에 소경이 정일 일구만	저 자식 소 귀에 소경이 정일이구만
소론 아무리 얘기 한 드 들끼만 하지 마른 모터자네요	소는 아무리 얘기 한 들 듣기만 하지말은 못 하잖아요
그 소귀 존 귀여	그 소귀 좋은 귀에요
거 소 소 소 정시니라 인는데	그 소 소 소정신이라 있는데
거 지금 얘드리 엄마에 한테 우유는 소 젇 우유를 머그니 아부진는 남자라 하 할찌라도 엄마에 유모에 저즐 안 머꼬 소 저즐 머그니깐두루 그 정시니 소 정시니라이	그 지금 아이들이 엄마 한테 우유는 소젖 우유를 먹으니 아버지는 남자라고 하 할지라도 엄마의 유모의 젖을 안 먹고 소 젖을 먹으니까 그 정신이 소정신이라
그 되게써요	그 되겠어요
왠써 자기 난나치 마라고 아주 안 나먼 조차네요	왜 자기가 낳은낳지를 마라고아주 안 낳으면 좋잖아요
자기가 난 아들 아들 따리머는 귀천해요	자기가 낳은 아들 아들 딸이면 귀천해요
내 혈쏘 피에 나쓰니까 두 부부에 겨라베 그저 나씨머는 내 유모를 매겨 크머는 그거시 바로내 자 자시글 가르칭건데 나키는 자기 나따고 자기 배 아네 커서만 나써	내 혈소 피에 났으니까 두 부부의 결합에 그 저 낳았으면 내 유모를 먹여서 크면 그것이 바로 내 자 자식을 가르친 건데 낳기는 자기가 낳았다고 자기 배 안에서 커서 낳았어
나와 가지구 바롣 공장을 가따 주고서 공장을  공장에 누가 키워서 이러면 또 우유 우유 소우유를 사다가 매기고 자기 편할라고	나와 가지고 바로 공장에 갖다 주고서 공장을 공장에서누가 키워서 이러면 또 우유 우유 소 우유를 사다가 먹이고 자기가 편할라고
그럼 그기 그 얘가 커선 뭐 뭐 되능겨	그럼 그게 그 얘가 커서 뭐 뭐가 되는 거야
아무 때거나 공부 짤 하게찌마는 그기 욜리 도지니 답 치능거요	아무 때나 공부는 잘 하겠지만 그게   답 치는 거에요
그래서 지금 응 아부지한테 돈 안 준다구 아부지 패 잡꼬 얼마하먼 지지바지를 가서 마메 안든다 이혼하고 그 그 그 그 지 정시니 아니지 그 소 소 정시니란 얘기요	그래서 지금 응 아버지한테 돈 안 준다고 아버지 패 잡고 얼마 있으면 지지바지를 가서 맘에 안 든다고 이혼하고그 그 그 그 제정신이 아니지 그 소 소정신이라는 얘기요
그 내 아주 아주 이런 아이구	그 내 아주 아주 이런 아이구
내 마미 끄리야 엄마 저즐 마니 머겨야 되는데 그러케 잘 안 할라구 그러지요	내 마음이 끓어야 엄마 젖을 많이 먹여야 되는데 그렇게질 안 할라고 그러지요
그러니까 내 늠도 그래서 그 무 무더러 내 그리 아이구 참두 그게 뭐 그저네 요 그래 소 우유를 머꾸 나니깐 저 그 성냥유리 머리에 소정시니 드러가 이따고 소정시니	그러니까 내 놈도그래서 그 뭐 뭐하러 내 그렇니 아이고 참두 그게 뭐 그전에 이 그래 소우유를 먹고 나니깐 저그 머리에 소정신이 들어가 있다고 소정신이
그럼 뭐 처메 이 저 노무새끼 개정신 소주도 모타는 거시 이러자네요	그럼 뭐 처음에 이 저놈의 새끼 개정신 소주도 못하는 것이 이렇게 하잖아요
얘가 참 그래문	얘가 참 그렇게 하면
아유 그러니 내가 이 얘기를 하다 하다 이런데 이런데 지그미 조은 세워리 다 완는데 왜서마으믄 요건 아니야	아유 그러니 내가 이 얘기를 하다 하다 이러는데 이러는데 지금 좋은 세월이 다 왔는데 왜 어떻게 해서 마음은 이건 아니야
그리고 우유는 소우유를 먹떤 돼지 이거를 먹떤 뭐 흘글 푸머도 그 짜는건 안 돼 우리가 사시른 흘게 나 흘게 갈꼬 다 흘게 나 우리가 탄생한 사라민데 그래 부모인데 응 엄마하문 응하는 거지	그리고 우유는 소우유를 먹던 돼지 이거를 먹던 뭐 흙을 품어도 그 짜는 거는 안 돼우리가 사실은 흙에 나 흙에 가고 다 흙에 나 우리가 탄생한 사람인데 그래 부모인데 응 엄마하면 응 하는 거지
얼추는 이어 대창 아버지 해 봐	얼추는 이어 대창 아버지 해 봐
돈 때미네 아버지 살해해따	돈 때문에 아버지 살해했다
응 뭐 어때 아버지 뭐 엄마하고 그래따	응 뭐 어때 아버지 뭐 엄마하고 그랬다
이기 아부지가 아들 아들 살해항 거는 업써 아들 뭐 미러 사랑인데 마를 안 드르니까드루 이놈하고 때려주구 겨욱 이체를 핸 엄하게 하다 보니 그르치	이게 아버지가 아들 아들 살해 하는 거는 없어 아들 뭐 밀어 사랑인데 말을 안 들으니까 이놈하고 때려주고 겨우  한 것이 엄하게 하다 보니 그렇지
하는데 아들려머는 효자는 모 탈 망정 응 또 불효를 불효를 모 탈 망정 그 부모를 살핸 하지마라야지	하는데 아들은 효자는 못 할 망정 응 또 불효를 불효를 못 할 망정 그 부모를 살해는 하지 말아야지
그래 이 그 개정시니깐드루 사라물 부모가 아버지가 사라무로 안 보이니까두루 아버지 살해하능 거요	그래 이 그 개정신이니까 사람을 부모가 아버지가 사람으로 안 보이니까 아버지 살해하는 거에요
그랜 구까에서 이걸 신경을 안 써요 이걸	그래 국가에서 이거를 신경을 안 써요 이걸
아구 클라따 이 이 우리나라 이 클라따 스 이 어특 하면 되나 하구 생가글 하나 안 다치뭐	아구 큰일났다 이 이 우리나라 이 큰일났다스 이 어떻게 하면 되나 하고 생각을 하나 안닿지 뭐
이 교수님한텐 말 하지만 안 돼	이 교수님한테 말 하지만 안 돼
정치인들도 그러죠 정치인 요 여 구쾨으원들또요 그 건드른 왜냐머느뇨 지금 자기들 정 어들라고 여성을 마니 키우자네요	정치인들도 그렇지요 정치인 이 여 국회의원들도요 그 분들은 왜냐먼요 지금 자기들 정 얻을라고 여성을 많이 키우잖아요
여성부 장과니 뭘 하능 게 이써 여성부 장과니	여성부 장솬이 뭘 하는 게 있어 여성부 장관이
여성부 여성부 장과니 이씨먼 남성 남성부 장관도 하나 맨드러 놔야 될 꺼 아니요	여성부여성부 장관이 있으면 남성 남성부 장관도 하나 만들어 놔야 될 거 아니요
여성부 장관하먼 여성부 장관해서 그 사람 월그비 얼마짜니요	여성부 장관하면 여성부 장관해서 그 사람 월급이 얼마짜리요
장관 장관해 하고 우리두 부수들 한 구까에 한 일력 부를 맨드러씨먼 그 미테 내려온 그 거게 뜨더 머글 사라미 얼마냐고	장관 장관들 하고 우리도 들 한 국가에 한 인력 부를 만들었으면 그 밑에 내려온 그 거기에 뜯어 먹을 사람이 얼마냐고
제가 이게 학쌩들 이제 가르치면서 가능하면 저 엄마 엄마 젇 마니 머기라고 제가 꼭 얘길하고 교유글 제 저의 가튼 사라미 교유글 잘 시키도록 하게씀니다	제가 이게 학생들 이제 가르치면서 가능하면 저 엄마 엄마 젖 많이 먹이라고 제가 꼭 얘기를 하고 교육울 제 저의 같은 사람이 교육을 잘 시키도록 하겠습니다
나는 뭐인지 모르지만 그이 참 교수님 꼭 그래 주시오 거	나는 뭔지 모르지만 그렇게 참 교수님 꼭 그래 주시오 거
네 알게씀니다	네 알겠습니다
어떤 하라버지가 그랜다고 그래요 어떤 하라버지 가고 하튼 뭐시 가니까 하라버지가 탁 그래얘기 한데 교수님 내 마리 마즈머는 그 말씀하고 마찌 아느먼 아이 그냥 저 그 인간 재미 그쓰 쓸떼업씨 정신들 싀소성이라 아우 희소시기라 아무 희소시기래두 틀리지	어떤 할아버지가 그랬다고 그래요 어떤 할아버지 가고 하튼 어디에 가니까 할아버지가 탁 그래 얘기 한다고 교수님 내 말이 맞으면 그 말씀하고 맞지 않으면 아이 그냥 저 그 인간 재미 그 쓰 쓸데없이 정신들 희소성이라 아우 희소식이라 아무 희소식이래도 틀리지
제가 꼭 학쌩들한테 그러케 가르치도록 하게씀니다	제가 꼭 학생들한테 그렇게 가르치도록하겠습니다
요 어르신 저 말씀 제가 잘 명심하고요꼭 학쌩들한테 그러케 가르치게씀니다	어르신저 말씀 제가 잘 명심하고요꼭 학생들한테 그렇게 가르치겠습니다
다시 도라 와 가지고요	다시 돌아 와 가지고요
요 어르신 금 옌나레 이제 고러케 다 거둬 드리며는 가으레 갈거지 하고 겨울 사리도 하자나요	요 어르신 그럼 옛날에 이제 그렇게 다 걷어 들이면 가을에 가을 걷이 하고 겨울 살이도하잖아요
근데 예저네는 탈곡 하는 걸 어떠케 핸나요	근데 예전에는 탈곡하는 걸 어떻게 했나요
예를 인제	예를 이제
돌 돌께래다 다 해찌	돌 돌게에다 다 했지
그니까 베를 마냐게 벼 가틍 거를	그러니까 벼를 만약에 벼 같은 거를
베를 아께 그러자네요 그거	벼를 아까 그러잖아요 그거
거 발로 하능 거 와롱	그 발로 하는 거 와롱
묘를 베고 나며는 그 담 어터게 하나요 벼를 베서	모를 베고 나면 그 다음 어떻게 하나요벼를 베서
벼를 베가주고 쭉 까러 깔고 까라 놔따가 한 이 시보일 일대로 바싹 마르머는 다시 거더	벼를 베 가지고 쭉 깔아 깔고 깔아 놨다가 한 이 십오 일 일대로 바싹 바르면 다시 걷어
거더서 이러게 탄 단 무꺼 맨드러 가주고 맨드러 놔따 어따 갈 떠 이러 가러 놔따가 갈러따 고 담 지베 와 뜰 무네 가 뜰 도라 가주고 들 말러 씨면 염차게 마르고 이러 안 말라씨면들 뭐야 제동기 도약 우에 가서 진는 거지	걷어서 이렇게 탄 단 묶어 만들어 가지고 만들어놨다가 어디에다  이렇게 갈아 놨다가 갈아 놨다가 그 다음 집에 와서 뜰 문에 가 뜰 돌아 가지고 덜 말랐으면 염차에다가 말리고 이렇게 안 말랐으면 들 뭐야 제동기 도약 위에 가서 짓는거지
싸를 찐는거지 째가주고 내머너 쥐 머꼬 옌나레는 시방은 저 전소 발 그 자두 옌나렌 노니막 그 노니 여러 마지기래두 이 가온달 정성거튼 잘 안 되써요	쌀을 찧는 거지 찧어 가지고 내놓으면 쥐 먹고 옛날에는 시방은 저 전소 발 그  옛날엔 논이 막 그 논이 여러 마지기라 하더라도 이   잘 안 됐어요
안 되니까 해 가지고는 쌀 해 가지고는 쌀로 파능기요	안 되니까 해 가지고는 쌀 해 가지고는 쌀로 파는 거에요
인제 이러케 부자찝 인제 머 멍는 사람 사러 옴 산 주고 끌러 가주고 또 노네 우리가 싸른 한말 가따 머거찌 야 일리 두 개 해조	이제 이렇게 부자집 이제 뭐 먹는 사람 사러 오면 사러 온사람한테 주고 끌어 가지고 또 논에 우리가 쌀은 한 말 갔다 먹었지 야 일리 두 개 해 줘
인는 사라문 그러게 옌나레 옌나레도 부익뿌가 이써요	있는 사람은 그렇게 해 옛날에 옛날에도 부익부가 있어요
비니삔 이꼬 엄는 사람 남 일하다 멍능 거요	빈익빈 있고 없는 사람은 남 일하다 먹는 거에요
그 지베 종 노르타다가	그 집에 종 노릇하다가
그러며는 타자글 할 때 타자글 하고 나서 이제 베를 후터내자나요 그러며는 그러케 타자글할 때 그 아까 고 와롱와롱 기계가튼 거또 이꼬 풍군 풍	그러면 타작을 할 때 타작을 하고나서 이제 벼를 훑어 내잖아요 그러면 그렇게 타작을 할 때 그 아까 그 와롱와롱 기계 같은 것도 있고 풍군 풍
풍채	풍채
풍채는 언제 언제 쓰나요	풍채는 언제 언제 쓰나요
돌리능 거요	돌리는 거요
풍채는 저 난제가 얼마 안 돼요 요게	풍채는 저 난 지가 얼마 안 돼요 요기에
아유 그때는 옌나레는 안 써꾸요	예 아유 그때는 옛날에는 안 썼고요
요 칠 까부러 치	이 치를 까불어 치
치로 까불린	아 치로 까불린
치로	치로
그 할머니 저 아주머니 애 먹쪼	아 그 할머니 저 아주머니 애 먹지요
치로 까불며는 거기 뭐가 이러케 막 생기능 거	치로 까불면 거기에 뭐가 이렇게 막 생기는 거
그래 까부능 거는 그 치는 나 나러 나가고 치에 나가고 고 다메 그 아른 전소가 치 아내 치	아 그래 까부는 거는 그 치는 나 날러 나가고 치에 날러 나가고 그 담에 그 알은 전소가 치 안 해 치 그래 이리 까 이러 까불먼 여 아네 고 온 싸른 이제 껀저 이래 이러째 그거요 그래 이렇게까 이렇게 까불면 이 안에 고 온쌀은 이제 건저서 이렇게 이렇게 째 그거요
그 뿌난 메밀 콩 강내이 그 전소가 치로 전소가 다 까부능거요 옌나레	그뿐 아니라 메밀 콩 강냉이 그 전소가 치로 전소가 다 까부리는 거에요 옛날에
뭘로 까분다고요	뭘로 까분다고요
치 치	치 치
치로	아 치로
치로 해써 치	치로 했어 치
부들 부들 가주고 맨드능 거	부들 부들 가지고 만드는 거
부들 저 저 저 물까에 부두가 치먼뇨 치 다 이써요	부들 저 저 저 물가에 부두에가 치면요치 다 있어요
네 네	네 네
치 모 뽜써요	치 못 봤어요
네 봐써요 네	네 봤어요 네
부들 가지고 만드능 거	부들 가지고 만드는 거
응 그래 요롱 기로 만드는데 건 그건 그 치로 다 까거든 왜그뇽	응 그래 이런 기로 만드는데 그건 그건 그 치로 다 까거든 왜 그러지요
시바니 시방은 뭐 뭐 모이 딸랑 그거는 풍채 가주고 막 까니 막 부부시 돌리먼 뭐 새파러 나고 이거 우코 도라시먼 마니요	시방은 뭐 뭐 뭐 이 딸랑 그거는 풍채 가지고 막 까니까 막 부부시 돌리면 뭐 새파란 것이 나고 이거   많이요
예 할머니가요 네	예 할머니가요 네
그 그 콩이나 팓 가튼 거도 다 마찬가진가요	그 그 콩이나 팥 같은 것도 다 마찬가진가요
다 또까쪼	다 똑같지요
응 그 도리깨로 찌거 이 도리깨 이써 거기	응 그 도리깨로 찍어 이 도리깨 있어 거기
날개로 돌리자녀	날개로 돌리잖아
네 네 그건 좀 이따 여쭤보고요	네 네 그건 좀 이따 여쭤보고요
여기 방아 여긴 방아도 종류가 이써쪼 어떤 방아	여기 방아 여기엔 방아도 종류가 있었지요 어떤 방아
이 지티딜 빵아	이 지디딜 방아
발로 딘능 거	발로 딛는 거
이 방아 이짜네요 아께 이 방아 이떵 거 이 나무 낭그로 가주고 가 가 가까운 베가 두 개 이써 되짜네요	이 방아 있잖아요 아까 이 방아 있던 거 이 나무 나무 가지고 가  가 가까운 벼가 두 개 있어 됐잖아요
그럼 가서 인제 저 사람 두리서 가따 베	그럼 가서 이제 저 사람 둘이서 갔다 베
이 디딜 방아 쿵더 쿵더 찌능 교	이 디딜 방아 쿵덕 쿵덕 찧는 거에요
가달 팽이로요	가달 팽이로요
응 그 디딜 빠아	응 그 디딜방아
고담 고담 물레 물레방아	그 다음 그 다음 물레 물레방아
물 물 물싸랑고 똘라 가능거	물 물 물살로 돌아 가는 거
골러 두 개가 굴러 되는데 이래 이꼬	굴러 두 개가 굴러 되는데 이렇게 있고
고 다메 인제 그 요즘 요즘 방아깐 방아깐 이짜뉴	그 다음에 이제 그 요즘 요즘 방앗간 방앗간 있잖아요
그땐 그래도 방아깐 이써끼여 시방	그땐 그래도 방앗간 있었어요 시방
잔치는 방아깐 찌울기 도란 기게로 도라가자네요	잔치는 방앗간 기울기 도란 기계로 돌아가잖아요
전기로 해서	전기로 해서
옌날 방아깐 말고 이게 소로 이러케 도라가는 거 인나요 소로	옛날 방앗간 말고 이게 소로이렇게 돌아가는 거 있나요 소로
그건 아이 그건 아주 고려조 때구요	그건 아이 그건 아주 고려조 때고요
근 그건 아주 고려 시대고 여기는 끄럼	그건 그건 아주 고려 시대고 여기는 그럼
그 그런 방아를 이르물 뭐라고	그 그런 방아를 이름을 뭐라고
그 그 저 저즌 빵아라 하지	그 그 저 젖은 방아라 하지
저즌 방아	젖은방아
그저 제주도 가머는 제주도 가먼 가래 저 이 고라 하라버지 그 역싸에 그거또 그거또 다이따고	그거 제주도 가면 제주도 가면  저 이 고라 할아버지 그 역사에 그것도 그것도 다있다고
그럼 소로 이러케	그럼 소로 이렇게
그 소로 매거 가지고 옥쏘리 가먼 이 저 꺼러가먼 이 이 이 끄테가 이 물케 가지고 그래서까 껍때기를 까진다 하지	그 소를 매 가지고 옥소리 가면 이 저 걸어가면 이 이 이 끝에가 이물켜 가지고 그래서 까 껍대기를 까진다고 하지
그래요	아 그래요
그러며는 그 베나 보리가튼 경우는남는 껍찔 그런 껍찔 인제 종류가 마니 이짜나요	그러면 그 벼나 보리같은 경우는 여기에 남는 껍질 그런 껍질 이제 종류가 많이 있잖아요
그럼 아이 보 보리는 보리는 껍찌를 껍찌를 이씀 문제 거 제가지고 뭄데기고	그럼 아이보 보리는 보리는 껍질을 껍질이 있으면 그걸 제 가지고 문데가지고
밀하고 청밀하고는 건알벼하고 때미래	밀하고 청밀하고는 그거는알벼하고 때밀어
그건 그냥 메또레 그냥 가라 머거요	그건 그냥 멧돌에 그냥 갈아 먹어요
그 다메 변 베느뇨	그 다음에 변 벼는요
베도 쩌야지	벼도 찧어야지
베는 찔며는 처음 쪄쓸 때 나오는 그 껍찌를 뭐라고 하나요	벼는 찧을려면 처음 찧었을 때나오는 그 껍질을 뭐라고 하나요
처음 아이 건 아이 아이 아이 아이라고 해찌 아이 찐다 구러찌	처음 아이 그건 아이 아이아이 아이라고 했지 아이 찧는다 그랬지
아이 두 벌씩 아이 이제 찌머는 껍띡 껍때기 다 까져	아이 두 벌씩 아이 이제 찌면 껍질  껍대기 다 까져
그 그즌 그 제는 뭐라고 하나요	그 그거는 그 제는 뭐라고 하나요
요 그 저넨 그저 그 아이 심는다 그래 그건 껍때기를	이 그 전에는 그저 그 아이 심는다 그래 그건 껍대기를
근데 고 제를저기 저의 아버니문 왕게라고 이러케 하든데	아 근데 그 제를저기저의 아버님은 왕겨라고 이렇게 하던데
껍때기를	아 껍대기를
껍때기를 왕게라 그래요 왕게 왕게 껍때기라 하지	아 껍대기를 왕겨라 그래요 왕겨 왕겨 껍대기라 하지
베 껍때기를 왕게 껍때기라 한다고	벼 껍대기를 왕겨 껍대기라 한다고
그건 고게 한 번 더 이게 개서 보드라온 거능뇨	그건 거기에 한 번 더 이렇게 개서 보드라운거는요
그거는 뭐라더라	그거는 뭐라더라
그 저기 등게라고 하던데	그 저기 등겨라고 하던데
망게	망겨
왕게	왕겨
등게 마져 등게	등겨 맞아 등겨
고 다메 등게 다메 고정 쌀 씬능 거는 아이구 뭐이라 하더라 또	그 다음에 등겨 다음에 고정 쌀 씻는 거는 아이구 뭐라고 하더라 또
그 그건 그건 건 문 때 그 쌀 씬는 무른 그 뭐야 끄레 가주 멍는데	그 그건 그건   때그 쌀 씻는 물은 그 뭐야 끓여 가지고 먹는데
메찌우른	아 메기울은
밀찌울	밀기울
네 그래 언 언제	네 그래 언 언제
밀찌우르 밀찌우리라능 거는 속 아덜메 갈글 빼고 거틀 거틀 밀찌부로 한다고	밀기울은 밀기울이라는 거는 속 아덜메 갈 글 빼고 겉을 겉을 밀짚으로 한다고
네 속	네 속
알 알	알 알
소 가늘  껍 껍때기 좀 이짜네	소 간을  껍 껍대기 좀 있잖아
고걸 인제 갈기 되고 제도 개봉이 되고 고담 끄테가 좀 쎄거찌	그걸 이제 가을이 되고 제도 개봉이 되고 그 다음 끝에가 좀 썩었지
그거 그거 인제 뭐시라 한다고	그거 그거 이제 뭐라고 한다고
그름 인제 그러케 곡씩 타자글 하고 나며는 그 다메 고 나문 직 이짜나 직	예 그럼 이제 그렇게 곡식 타작을 하고 나면 그 담에 그 남은 직 있잖아 직
베찜 마니 이쪼 베찜 그걸로 모 굉장히 옌나렌 마니 여러가지로	볏짚 많이 있지요 볏짚그걸로 뭐 굉장히 옛날엔 많이 여러가지로
아이 베쯤 뭐냐먼 요게는 우리 요 이 동며네 요 삼 요는 대마를 마니 띠우기래 대마가 열이 이래욛	아이 볏짚 뭐냐면 이거는 우리 여기 이 동면에 여기 삼 여기는 대마를 많이  대마가 열이 이래요
열뚜 자거든	열두 자거든
삼 삼 대마 그러 그 그 그 대 올러간 정상에 이러그 베져 가주고 집 지붕 다 해 따고 지붕울	삼 삼 대마 그런 그 그 그 대에 올라간 정상에 이렇게 벼를 지어 가지고 집 지붕 다 했다  고 지붕을
대마르료	아 대마를요
대마 그	어 대마 그
근데 옌나레 베찝  옌나레	근데 옛날에 볏짚 옛날에
베찌분베찌분 드러봐라 베찌푼	볏짚은볏짚은 들어봐라 볏짚은
하리 싸람들 그 부리찌만 뭐 하자네	하리 사람들 그 보리 짓지만 뭐 하잖아
어디 사라미요	어디 사람이요
요 하리	여기 하리
연 하리랑게 안 이써요	여기에 하리라는 게 안 있어요
이 석꼴쩰로 내려가먼 하리라고 한다 하리	이 석골제로 내려가면 하리라고 한다 하리
저쪼글	저쪽을
거기를 하리라고 아이 하 짜써서 하린가	아 거기를 하리라고 아이 하 자 써서 하린가
응 그러치	응 그렇지
거게는 대마를 마니 안 자네요 안 하니까 그 지붕에 인다고 베 이츠깡 거 이 지피라 한다아페 요 이밥 푼 이밥	거기는 대마를 많이 안 짓잖아요 안 지으니까 그 지붕에 인다고 볏짚을 그걸 이 짚이라 한다 앞에 여기 이 밥은 이밥
이 밥 쌀 밥 메빱	이밥 쌀밥 메밥
네 네	네 네
제사 지내고 나먼 메빱 쌀밥이밥 하자네요	제사 지내고 나면 메밥 쌀밥 이밥 하잖아요
그래 거기는 그 이 베찌풀 이러 이러케 여꺼 가주고 지붕 다 일꼬 그담 우리드른 그건 가져와 가지구 이 새끼 꼬능 겨 새끼 알 새끼	그래 거기는 그게 볏짚을 이렇게 이렇게 엮어 가지고 지붕에 다 일고 그 다음 우리들은 그거 가져와서 이 새끼 꼬는 거야 새끼 일 새끼
잘 쉐 빈허요 광은 요 이 구들 구드레 깔꺼 깔 깔지	잘 쉽게 변해요 광은 여기 이 구들구들에 깔고 깔 깔지
그러면 찌께로 만드능 게 아니 거 지푸로 만드능 게 아까 이	그러면 지게로 만드는 것이 아니 그 짚으로 만드는 것이 아까 이
장 장서	장 장서
그 장성이라고	그 장석이라고
그래요	아 그래요
장석 멍석	장석 멍석
지푸로 가지고 맨드러  장석 멍석 이렁 거 하고	짚을 가지고 만들어  장석 멍석 이런 거하고
모양이나 크기는 어트게 되나요	모양이나 크기는 어떻게 되나요
이건 제 멍서그론 할타시지뭐	이건 저 멍석으로는 하기 나름이지 뭐
마당 크먼 큰 대로 저금 저근 대로 한 말 다선 마니 늘 망석 항 가마니 늘 망석 연 클쑤록더 마니 일고 저글쑤록 저께 일고 또 자래도 이 이 장석 짜리도 방이 여덜 짜면 여덜 짜	마당이 크면 큰 대로 작으면 작은 대로 한 말 다섯 가마니를 망석 한 가마니를 망석 이건 클수록더 마니 일고 작을수록 작게 일고 또 자리도 이 이 장석 자리도 방이 여덜 자면 여덜 자
건 보통 동그라케 하나요 아니며는 네모나케	그건 보통 동그랗게 하나요 아니면 네모낳게
망서근 똥그라케하고 멍서근 고 다메 장에는 이 방 생긴 대로 제가지고 이 고속또를내 이케	아 망석은 동그랗게 하고 멍석은 그 다음에 장에는 이 방 생긴 대로 지서 이 내 이렇게
저 장서가 몯 빠써 우리 요 이 다 인는 노니래요	저 장서를 못 봤어 우리 여기 이거 다 있는 논이에요
함 다 이따고래	하면 다 있다고
장서카고	아 장석하고
장서카고 멍석 하곤 어트게 다릉가요	장석하고 멍석하고는 어떻게 다른가요
장서근 새끼로 꼬 가주고 구둘 까능 게 장서기고 방에 멍서그른 새끼를 앙 꼬고 새끼를 까둔안 해도 나 나를 너서 자꾸 나를 마니 파고 너가주구서는 이 지풀 가주구 요러케 여꺼요	장석은 새끼로 꼬아 가지고 구들 까는 것이 장석이고 방에 멍석은 새끼를 안 꼬고 새끼를 까지는 않아도 나 나를 넣어서 자꾸 나를 많이 파고 너어 가지고서는 이 짚을 가지고 이렇게 엮어요
요러케 이쪼그로 자꾸 여꺼가주 그래 그래 한 그게 망서긴데 그건 곡썩 곡썩 여기에서 어빠	이렇게 이쪽으로 자꾸 엮어 가지고 그렇게 그렇게 한 그것이 망석인데 그건 곡식 곡식 여기에서 어빠
바께 곡썩 잉다고 고거는	밖에 곡식 인다고 그거는
그 목 멍서기 더 촘촘하겐네요	그 목 멍석이 더 촘촘하겠네요
쫌 촘촘허지 그럼	좀 촘촘하지 그럼
그 다메 또 그렁 걸로 또 뭐 만드런나요	그 다음에 또 그런 걸로 또 뭐 만들었나요
그기 뭐 싱꼬 다니는	그게 뭐 신고 다니는
집씬 집씬 사머 집씬	짚신 짚신 삼어 짚신
면날로 보통을 하나요	아 몇 날로 보통을 만드나요
그거 집씨는 네 나리 네 개고 참시는 여선 나리고	그거 짚신은 네 날이 네 개고 참신은 여섯 날이고
참시는 뭘로	참신은 뭘로
참시는 저 대마	참신은 저 대마
대마 껍찔로 가주고 그 찔겨 그거는 쫌 찔기다고	대마 껍질을 가지고 그게 질겨 그거는 좀질기다고
그걸 가져 꽈가주구 전소글 이 요골 꼬고 뭐이 맨드래가주 그건 한데 그거는 자색마 시느머는 우리 장마에 썩찌 안 하먼 그건 그래도 오래 사라 건 뭐	그거를 가지고 꽈 가지고 전속을이 이거를 꼬고 뭐 이렇게 만들어 가지고 그건 하는데 그거는 자색마 신으면 우리 장마에 썩지않으면 그건 그래도 오래 신어 그건 뭐
이 시골 댕기먼 그 한 보칸 이시빌까지 싱꼬 댕겨두 건 그치마는 그 집씨니라능 거는 딱 오래 시너따 그래 이래 이래 좀 비도 오고 축축하먼제 인제 한 이틀 신는데 이 한 사날 씬는데해가 마니 나따	이 시골 다니면 그 한 복한 이십 일까지 신고 다녀도 그건 그렇지만 그 짚신이라는 거는 딱 오래 신었다 그래 이렇게 이렇게 좀 비도 오고 축축하면 저거를 이제 한 이틀 신는데 이 한 사일 신는데 해가 많이 났다
저 이 그 짜드라기라해 이 경지가	저 이 그 짜드라기라고 해 이 경지가
짜드락	짜드락
짜드랑뇨 네	짜들락이요 네
집씬두 집씬두	짚신도 짚신도
지꼬 자뜨랑이 자뜨랑이라능 거 짜드랑이라능 거는 지금 이거 이러케 이 경사지문 뭐라 그래지금 시방 말로	짓고 자드랑이 자드랑이라는 거 자드랑이라는 거는 지금 이거 이렇게 이 경사가 지면 뭐라고 그래 지금 시방 말로
비탈낄	비탈길
비탈끼라 시방	비탈길이라 시방
옌나렌 짜드랑이라 한다고	옛날에는 자드랑이라고 한다고
그 짜드락 져따고요	아 그 자드락 졌다고요
짜드락 제 짜드락 바치 가라따고 짜드락	자드락 제가 자드락 밭을 갈았다고 자드락
저쪽 바치 짜드락 빠치네요 그러면	아 저쪽 밭이 자드락 밭이네요 그러면
응 그러치	응 그렇지
그런데 가서 돌맹이가 만차네	그런데 가서 돌맹이가 많잖아
그 시무 마리야 문데먼 집씬 사무니 하루 하루에 고 여거푸나고마러	그 신은 말이야 문지르면 짚신 삼은 것이 하루 하루에 그 망가지고 말아
이 나레 나감 모씬지고마	이 나리에 나가면 모신 지고
나리 사너 개 이 하먼 떠러지면 고만 고 고무신 마리 묵찌끈 들랑가치뭐	나리 개 이렇게하면 떨어지면 그만 고 고무신 마리  들랑 같이 뭐
그런 시대여	그런 시대야
그래간 겨우레 여르멥 장마지고 비 오먼 드러 안자서 삼 그 심찌	그러니까 겨울에 여름에 장마지고 비 오면 들어 앉아서 삼 그 심지
집씨늘 한 커레 두 커레 싱꼬 내 사 으 저 사머가지고 저 매다 놔	짚신으르 할 켤레 두 켤레 신고 내 사 으 저 삼아 가지고 저기에 매달아 놔
그래먼 오늘 오늘 신짜네	그러면 오늘 오늘 신잖아
오늘 신따가 떠러지먼 내 삐리고 고담 또 꺼 꺼내씽꼬	오늘 신다가 떨어지면 내버리고 그다음 또 꺼 꺼내 신고
오느른 업씨먼 뭐 맴발로 댕겨 맴발로 마니 댕기다메 막 또	오늘은 없으면 뭐 맨발로 다녀맨발로 많이 다녔다고 막 또
요 맴발또 마니 댕겨 맨발로	이 맨발도 많이 다녀 맨발로
그래요	아 그래요
하이고	하이고
그 막 바리 마니 다치고 그래껜네요	그 막 발이 많이 다치고 그랬겠네요
여기여 여 전세가 쫌 전소가 이 말하자먼 이러치 뭐	여기 이 전소가 좀 전소가 이 말하자면이렇지 뭐
이 까씨가 찔려도 잘 안 드러 갈 쩡도지 뭐 구더가지구	이 가시가 찔려도 잘 안 들어 갈 정도지 뭐 굳어가지고
그래요	아 그래요
손 앙 그래	손은 안 그래
시방 여르메 거 장가불 찌니 안 찡 안 되자나 이제는	시방은 여름에 거 장갑을 끼니까 안끼면 안 되잖아 이제는
찌니 고마 더워 쭈굴되는데 옌나렌 전소가 이 낭가가 해도 까시 까시거 이써도 이 전소가이 손 옌날 소느로 해	끼나까 그만 더워 쭈굴되는데 옛날에 전소가 이 나무를 해도 가시 가시가시가 있어도 이 전소가 이 손 옛날 손으로 해
그 찔리먼 또 파내고 여 여 전체가 이 끄르미 지고 뭐 토시가 인나 뭐 인나	그 찔리면 또파내고 이 이 전체가 이 그름이 지면 뭐 토시가 있나 뭐가 있나
명 지방 그 얘기하먼 아이구 우리는 고진감내 흥진비	시방 그걸 얘기하자면 아이구 우리는고진감래 흥진비야
단 당거또 머거보고 씨 씬거또 뭘 보고 조아도 보고 우러도 보고 고생도 해 보고 짐 우리는잘 사는 거요	단 단 것도 먹어 보고 쓰 쓴 것도 먹어 보고 좋아도 보고 울어도 보고 고생도해 보고 지금 우리는 잘 사는 거요
옌나레 고생해떤 얘기두 옌나레 고생하지 참 이 근데 시방 생강 시방 생각 하며는 고생핸생가기 항 개도 안 나	옛날에 고생했던 얘기도 옛날에 고생하지 참 이 근데 시방 생각 시방생각 하면 고생한 생각이 한 개도 않나
내 이러케 사니까	내가 이렇게 사니까
그래 우리는 고진감내 흥진비란 얘기가 당 거도 머꼬 씨꼬 머건는데 옌나레 고생은 한 오십때까지 해따고	그래 우리는 고지감래 흥진비란 얘기가 단 것도 먹고 쓴 것도 먹었는데 옛날에고생은 한 오십 대까지 했다고
그래 이게는 삼십 칠려니라두루 방아늘 안 지먼 호과를 한다고	그래 이거는 삼십 칠 년이라방아를 안 지으면 호과를 한다고
시방 농사는 농사 가찌 아니 하네요	시방 농사는 농사 같지 아니 하네요
전속 업씨 차가 막 바 빠치 다 하지 나감 경웅기 다 하고 모 모 모 그져 옌나레 이거 해 질머지고 아께 말 따라 그러케 그러케 소 함 마리씩 몰구저는 자께 말해 팬다게 올라가잠 아니때루 흘러도 사라따고 그래도	전속이 없이 차가 막 밭 밭을 다 하지 나가면 경웅기 다 하고 뭐뭐 뭐 그러지 옛날에 이거 해서 짊어지고 아까 말 처럼 그렇게 그렇게 소 한 마리씩 몰고 저는작게 말해 편당에 올라가자 아니 때로 흘러도 살았다고 그래도
그래도 병  안 들고  병  하나도 안 들  안 들고	그래도 병 안 들고  병 하나도 안 들  안들고
요새는 그래도 맹장 응 하나또 업씨 마껄레 한 사발씩 머꼬 쓰 거시 그아라리 해 대미서	요새는 그래도 맹장 응 하나도 없이 막걸리 한 사발 씩 먹고서 그아리랑 하면서
그럼 어르신 그 아까 그 집씬도 이써꼬 그 지풀 이는 그 지불 이는 그걸 뭐라고 핸나요	그럼 어르신 그 아까 그 짚신도 있었고 그 짚을 이는 그 짚을 이는 그걸 뭐라고 했나요
지붕	지붕
지붕인는 걸 뭐라고 핸나요	지붕 이는 거를 뭐라고 했나요
지붕 지붕요	지붕 지붕요
지붕에 뭘 인는다 영	지붕에 뭘 인다 영
영 요 이엉	영이요 이엉
이엉이라 하지 이엉	이엉이라 하지 이엉
그걸	아 그걸
그걸 이엉이라 한다고	그걸 이엉이라 한다고
그걸 이끼도 하 해쪼	아 그걸 잇기도 하 했지요
그럼 저 여피 난 그 베찝 가지고 하 지구 지푸라기 여꺼서 하는 그건 이엉 이엉 영는다 구래 영월가찌	그럼 저 옆에 난 그 볏짚 가지고 해 짚을 지고 짚을 엮어서 하는 그건 이엉 이엉엮는다 그래 영을
일쩐 지붕 인는다 이래고  논는다 그래 지부로	일전에는 지붕 인는다 이러고 놓는다 그래짚으로
마리 옌날 말 뭐 그리 허고	말이 옛날 말 뭐 그렇게 하고
어르신 그 옌나레 그 인제 겨울 되면 따뜨테야 되니까 땔까므로 어떤 걸 썬나요	어르신 그옛날에 그 이제 겨울이 되면 따뜻해야 되니까 땔감으로 어떤 걸 썼나요
겨울 차	겨울 차
겨우레	겨울에
옌나레 전소가 사네 가서 싹 해오지	옛날에 전소가 산에 가서 싹 해오지
화모	화모
사네 가서 사네 가서 인제	산에 가서 산에 가서 이제
어떵 거 어떵 거 땔려면	어떤 거 어떤 거 땔려면
옌나레는 그 왜냠 아이 저거 왜냐먼 이 구더지 구 구니 주는 서규꾸니 나라에 이찌 아나짜네요	옛날에는 그 왜냐하면 아이 저거 왜냐하면 이 구더쥐 군 군이 주는 석유꾼이 나라에 있지않았잖아요
건 건 또 거래 멀고 그래고 대로 이 바까이 이는다고 사늘 뒤져 사니 일찌기 사유 소유꿔니나고 내가 이 저 무 삼병무 이짜네요	건 건 또 거리가 멀고 그리고 대로 이 바깡이 인다고 산을 뒤져 산이 일찍이 사유 소유권이 나고 내가 이 저 무 삼병무 있잖아요
그건 가주 소 소늘 한 번 구빼 그차네요	그거 가지고 소 소늘 한 번 굽혀 그렇잖아요
그래 아께 내 얘기한 그대로 그 내가 예저네 목쌍 가지구 돈 좀 버러따고 그래도 생활비를버러 버러따고	그래 아까 내가 얘기한 그대로 그 내가 예전에 목상 가지고 돈 좀 벌었다고 그래도 생활비를 벌어 벌었다고
어디서요	어디서요
목쌍	목상
목쌍 그런데 인제 옌 어릴 때 금 어르신네 어릴 때는 인제 땔깜	예 목상 그런데 이제옛 어릴 때 지금 어르신네 어릴 때는 이제 땔감
땔깜 그럼 가서	땔감 그럼 가서
연탄 업쓰며는 뭐 뭘로 해주난	연탄 없으면 뭐 무엇으로 해주나
글쎄 그러니까 사네 가서 그 이짜나 사네 가먼 싸리 싸리 이써 싸리	글세 그러니까 산에가서 그 있잖아 산에 가면 싸리 싸리 있어 싸리
잠목	잔목
장모기 크며는 작 크지 아나 이러케	잔목이 크면 작 크지 않아 이렇게
피나오먼 싸리니 뭐 인제 소 끄러 그저 내처 크자네요	나오면 싸리니 뭐 이제 소 끌어 그저 크자네요
그래먼 동네가 오십 호 삼십 호 호먼 그기 이 삼 년 가먼 한질 지자네요	그러면 동네가 오십 호 삼십 호 호면 그게 이 삼 년 가면 한 길이 나잖아요
그 그거 전소가 베지 낭게칭 거 지버 와 가주고 걸 꺼꺼서 모아 그래 노코 또 소나무 이려올라가먼 아지	그 그게 전소가 베지 나무 친 거 집어 와 가지고 그걸 꺾어서 모아 그렇게 놓고 또 소나무 이려 올라가면 아지
아지를 그기 여름 하절기 가서 이러케 처나요	아지를 그게 여름 하절기에 가서 이렇게 쳐놔요
세 바리 노코 올라 가주구 저놈 따또지먼 그 이트 한 이 이 개월랄 일 녀네 바니먼 노나커바르자네요	세 발이 놓고 올라 가 가지고 저놈 딱 또지면 그 이트 한 이 이 개월 날 일 년에반이면  바르잖아요
그 소꼬바리라고 소꼬바리	그 소꼬바리라고 소꼬바리
그거 저다가 그래서 겨울 줌비를 요새 가 이 요새	그거를 져다가 그래서 겨울 준비를 요새가 이 요새
요새 인진 아푸롣 겨울 나먼 한달 안 한 달	요즘 인제 앞으로 겨울 나면 한 달 안 한 달
그럼 하루에 석찐 씩 뫄 자러 두먼 한두 살 구십쯔미요 구십쯤	그럼 하루에 석진 씩 뫄서잘라 두면 한두 살 구십 짐이요 구십 짐 그러면 덩 거지  덩거지가 뭔지 암니까  덩 거지 그러면 덩거지  덩거지가 뭔지 압니까  덩거지
모빠찌요 덩거지는	못 봤지요 덩거지는
저 장봉낭거는 고 다메 인제 그 겅갈항 게 이패이로 하능 거 장봉낭기고 덩거지랑 거는 패서 또이자내서 요건 장장 지금 장자기라 하죠	저 장봉낭기는 그 다음에 이제 그  게 잎팡이로 하는 게 장봉낭기고 덩거지라는 거는 패서 또 잘라서 이건 장작 지금 장작이라 하지요
그 덩거지라 함니다 옌나레는	그걸 덩거지라 합니다 옛날에는
그래요	아 그래요
그래 그런 거또 인제 패서 가래서 노코 그래 거 불로 때요 가메	그래 그런 것도 이제 패서갈아서 놓고 그래 그걸 불로 때요 가마에
가미서 가메에서 그걸겐 소이 끼리 주고 저 온돌빵 이쪼	가마에서 가마에서 그걸 소한테 끓여 주고 저 온돌방 있지요
저게 불 러머는 아래 아래싸람 우싸람 우싸라미 하라버지 아래싸람 이며는 아버지 또 아빵에는 할무이 그두 중아에는 어무이 내 실랑가씨는 우빵 이러케 말하자먼 삼대 살 쩌거는그래 부를러먼 안치 안채에는 바패 멍느라 소테 불르니까두루 아침 저 너니까 뜨시고 사라문아치미역 소주께는 뜨시고 이 방이 이만츰 뜨끈뜨끈하지 뭐	저기에 불을 넣으면 아래 아랫사람 윗사람 윗사람이 할아버지 아랫사람이면 아버지 또 앞방에는 할머니 그리고 중앙에는 어머니 내 신랑각시는 윗방 이렇게 말하자면 삼대가 살 적에는 그렇게 불을 넣으면 안채 안채에는밥 해 먹느라 솥에 불을 넣으니까 아침 지어 넣으니까 뜨시고 사리문 앞 소주께는 뜨시고 이 방이 이만큼 뜨끈뜨끈하지 뭐
그래머는 그 귀리 메물 그게 또 떠러 놔씀 갈게 가서 가메 쩌요	그러면 그 귀리 메밀 그거를 또 떨어 놨으면 가을에 가서 가마에 찌어요
물 붜가지구	물을 부어가지고
그래 쪄 가주구 다시 말래 가주구 물 붜가주구 쩨야마니 오른 싸리 나온다구 허지	그래 쪄가지고 다시 말려 가지고 물을 부어 가지고 쪄야만 오른 쌀이 나온다고 하지
그래이머는 이기 중한 얘기요	그러면 이게 중요한 얘기에요
네 네	네 네
옌나레 아주 이 지금 통상 저 넥타이 다 매고 뭐 그래도 사오심마넌 짜리 한 뱅마넌 짜리팔시번 짜리 노마이 차꼬 댕기죠	옛날에 아주 이 지금 통상 저 넥타이를 다 매고 뭐 그래도사오십 만원 짜리 한 백만 원 팔십 원 짜리 노망이 차고 다녔지요
뭐 뭘 간다고	뭐 무엇을 간다고
노마이	노망이
노마이가 뭐죠	노망이가 뭐지요
노마이 몰라	노망이 몰라
지금 지금 요 넥타이 하고 댕기는 이름 뭐요 그게	지금 지금 이 넥타이 하고 다니면 이름이뭐에요 그게
뭐라한타고	뭐라고 한다고
마이	마이
마이	마이
지금 마이라 마이라 하조	지금 마이라 마이라 하지요
노마이다 노마이	이 노마이다 노마이
노마이 놈말 이런데 시방 그 다 다 이짜네요	노마이 놈말 이런데 시방 그 다 다 있잖아요
옌나레는 삼베지 적쌈 요 팬때에 빤스 저네 빤스라 하지	옛날엔 삼베지 적삼 이 팬티에빤쓰 전에는 빤스라고 하지
그도 그 이 한겹 이버써	그것도 그 이 한 겹 입었어
그래도 시방은 이부자리가 좀 조아요	그래도 지금은 이부자리가 좀 좋아요
깔고 덥꼬 마리요 뭐 깐주근 아유 조건 구지뿌닌데 옌나레는 그 여자 장식짜리 깔머는 덩덥깨 업따고	깔고 덥고 말이요 뭐  아유 저건  옛날에는 그 여자 장식자리 깔면 덮개없다고
돈 업찌 삼베 적쌈 내가주고 제우알 이 여르메 하복 해 입꾸 그담 겨우레 영광싸람들 믿무 무명하고 광하거버 바꿔가지구 그거 인제 바지 저고리 해구 마라싸 그거또 인는 사라미 해이버따고	돈 없지 삼베 적삼 내가지고 겨우 이 여름에 하복 해 입고 그 다음 겨울에 영광사람들무 무명하고  바꿔 가지고 그거 이제 바지 저고래 하고 말았어 그것도 있는 사람이 해서 입었다고
야들 만코 이러케 큰 사람드른 그름 모타자네요	애들 많고 이렇게 큰 사람들은 그럼 못 하잖아요
그래먼 그 미무를 가메에 쩌가지구 미레가따 땅바다게 여러	그러면 그 메밀을 가마니에 쩌가지고 밀에 갔다 땅바닥에 널어
어디에 넌다고요	어디에 넌다고요
가 가메에 쩌 가주고	가 가마니에 쩌 가지고
구들해요	구들 해요
방에다가 여러	어 방에다가 널어
열곤 장사네 까러	널고는 장산에 깔아
기냥 부를 때머는 그게 뜨신 짐이 야 올러와	그냥 불을 때면 거기에 뜨거운 김이 올라와
어르신 쪼금만 천천히 쫌 말씀해예	어르신 조금만 천천히 좀 말씀해예
그기 그 야기라고 약	그게 그 약기라고 약
사라미 이 바라믈 마즈며는 어디가서 쑥찌물 한다 그래자나 뭐 영기	사람이 이 바람을 맞으면 어디에 가서 쑥찜을 한다 그러잖아 뭐 연기
쑥찜뇨	쑥찜이요
근데 이거는 그런 그런 그 독써게 지물 모임 한다고	근데 이거는 그런 그런 그  김을 모임한다고
그럼 그래구 그 자능겨	그럼 그렇게 하고 그 자는 거야
깨문 새벅 세 시는 추 추울께 아니요	깨면 새벽 세 시는 추 추울 게 아니에요
추우며는 장석 그 미릳 드러가능 기요	추우면 장석 그 밑으로 들어가는 거에요
드레 가 가주고 걷 장석 그걸 떵이라구유	들어 가 가지고 그 장석 그걸 딱 이라고요
시방 바께 사라미 주거 시방은 주거도 조리 이부로 덥짜네요	지금 밖에 사람이 죽어 지금은죽어도 조리 이불로 덮잖아요
조리 응	조리 응 예
시방 다 정는데	지금 다 적는데
그 그때는 뭐냐하머는 아주 읍씨 사니까 장석 짜리 미테 추우먼 거 드러가 잔다구요	그 그때는 뭐냐면 아주 없이 사니까 장석 자리 밑에 추우면 거기에 들어가 잔다고요
자봄 조치	자보면 좋지
그래가주 인제 아드리 한 오형제 사오형제 되자네요	그래가지고 이제 아들이 한 오형제 사오형제 되잖아요
그 마지가 열다서 쌀 되머는 고 다메 두 살 차이 세 살 차 이래머는 망내이먼 이제 두 살그르초	그 맏이가 열다섯 살 되면 그 다음에 두 살 차이 세 살 차이 이러면 막내면 이제 두살 그렇지요
두살 세살 된다구요	두 살 세 살이 된다고요
앙 그래요	안 그래요
망내이가 동생이	막내가 동생이
그래 한 방에 자능거요	그래 한 방에서 자는 거에요
정 추우면뇨	정 추우면요
옌 나렌 이 팬때가 빤 쓰가 업찌마는 그래두 뭐 열쌀 이상 되머는 요 공 방 두 가 이써야 되는디	옛날에는 이 팬티가 빤스가 없지만 그래도 뭐 열 살 이상 되면 이 공방 두가 있어야 되는데
공방줄롱	공방줄롱
요 고댕이 올러오능 거	이 고댕이 올라 오는 거
질게 모태둔 뭐 이핀다구 업써가주구	질게는 못 해도 뭐 입힌다고 없어가지고
네 네	네네
그래 여잘 이푸키문 그 형들 그런데 마지형도 정치네 해 그럼 이버따	그래 여자를 입히면그 형들 그런데 맞이형도 정초에 해서 그럼 입었다
그래먼 네째 다섣 째는 안즉 언내니까 그냥 여 미테 꼬출 내 노코 댕게	그러면 넷 째 다섯째는 아직 어린내니까 그냥 이 밑에 고추를 내 놓고 다녀
그땐 자지라 하지 자지	그때는 자지라고 하지 자지
그럼 그게 자능 겨	그럼 그렇게 자는 거에요
그래 이 가치 인제 형들하고 자고 이러나머는 형드른 여 바지 저 밤바지를 이버쓰니까두루 이끈 낭치미는 그거뚜 미테 동생은 홀딱 뻐꼬 꼬추만 다 내쓰니 자 잘께 아니여	그래 이 같이 이제 형들하고 자고 일어나면 형들은 이 바지 저 반바지를 입었으니까 이 끈 낭침은 그것도 밑에동생은 홀딱 벗고 고추만 다 내 놨으니까 자 잘게 아니요
그 아치메 일라머는뇨 요 꼬추에 문두가 요 문주가 이래씀 형이 툭툭 터리조	그 아침에 일어나면요 이 고추에 문두가 이 문주가 이렇게 있음 형이 툭툭 털어줘
뭐 무더따고 요꿈네틍거 그러케 컨 사람드리 바로 우리 우리래요	뭐 묻었다고 요꿈내 같은거 그렇게 큰 사람들이 바로 우리 우리래요
기가 매키릴 아니요 글쎄	기가 막힐 일 아니요 글쎄
그때 그 당시에 그 세워를 보낸 사라미 지금 우리형이라고 내 뿐 아니라고	그때 그 당시에그 세월을 보낸 사람이 지금 우리 형이라고 나 뿐만 아니라고
지금 팔씹 다선 믿 칠씹 다섣 요 패드른 이걸 다 안다고 지금두	지금 팔십 다섯 밑 칠십 다섯 이 패들은 이걸 다 안다고 지금도
그럼 어르신 다 이 저 도라가 땔깜 땔까메서 소늘	그럼 어르신 다 이 저 돌아가서 땔감 땔감에서 소늘
어르신 그럼 아까 땔깜 중에서 옌날 아까 소 솔코 솔코바리라고 이짜 이써짜나	어르신 그럼 아까 땔감 중에서 옛날 아까 소 솔코 솔코발이라고 있잖아 있었잖아
응 소코바리	응 소코발이 소꼬바리 말소꼬발이 말
소 저 소나무	소 저 소나무
소나무 까는 소코바리 한다고	소나무 까는 소코발이 한다고
소나무 가리를요	소나무 가지를요
소나무 가지 깔래나문 소꼬바리라 한다 소꼬바리	소나무 가지 까고 나면 소꼬발이라 한다소꼬발이
그러면 고 솔 솔 이게 떠러진 그거를 무슨 말링 걸 뭐라고 하나요	아 그러면 그 솔솔 이게 떨어진 그것을 무슨 말린 거를 뭐라고 하나요
그거 소꼬바리라 한다고	그게 소꼬발이라 한다고
소꼬바리요	소꼬발이요
응 그건 소꼬바리	응 그건 소꼬발이
갈비라고 마를 안	갈비라고 말을
갈비는 소꼬바리에서 그 저 저 떠러징 거이 또 소꼬바리 타리찌 파리	갈비는 소꼬발이에서저 저 떨어진 것이 또 소꼬발이 털있지 잎파리
그거 떠래핸 니 갈비라고	그거 떨어진 것이 갈비라고
서꼬바리	아 석고발이
아래 이 떠린 갈비고 그 아지 이 쌔카난 아지래미 깔링 거는 소꼬바리	아래 이 떨어진 것이 갈비고 그 아지 이 새카만 아지랑이 깔린 거는 소꼬발이
아까 그 불 아까 동굴 가튼 데 드러갈 때 불 이러케 하능 거 이짜뇨 불	아까 그 불 아까동굴 같은 데 들어갈 때 불 이렇게 하는 거 있잖아요 불
불 발키는  그건 뭐로 만드능 거에요	불 밝히는 그건 뭘로 만드는 거에요
소나무에	소나무에
아께 소 소까지	아까 소 소가지
소까지 소까지 소까지는 그 소나기 그 그 지니 만차뇨 소나무 지니	소가지 소가지 소가지는 그 소나무 그 그 진이 많잖아요 소나무 진이
소낭간 인제 비구 베 이럭 굴군 소낭가늘 베 치우며는 그 한 심년 시보연 이심 년 그 정도 되머는 다 써거요 끄튼	소나무 이제 베고 베 이렇게 굵은 소나무를 베서 치우면 그 한 십  년 십오 년 이십 년  그 정도 되면 다 썩어요 끝은
다 써꼬 아네 그 속 찌니 아네 속 소끼니 말하자머는 그 소나무 그 내려오는 그 뭐시기지	다 썩고 안에 그 속 진이 안에 속 속진이 말하자면 그 소나무에서 그 내려오는 그 뭐야
소나무 피지 사라마나따나	소나무 피지 사람처럼
피라고 볼 쑤 이써 그 소나 그기 그 속 속 찌니 올라가 올리 댕기면서 소나기 크자네요	피라고 볼 수 있어 그 소나무 거기 그 속 속 진이 올라가 올라가 다니면서 소나무가 크잖아요
그래 그게 인제 마꼬 그 뿌리 근처에 와서 아네 드러가 가주고 아네 보먼 파싹 말러	그래그게 이제 맞고 그 뿌리 근처에 와서 안에 들어 가 가지고 안에 보면 바싹 말랐어
말러 가지고 거게 고애기 이른다 고애기가	말라 가지고 거기에 고액이 흐른다 고액이
바싹 말러	바싹 말라
고애기요	고액이요
고액 고애기	고액 고액이
고애기랑건 바싹 말라따 소가아니 뿌리여 파싹 말림 고 고애기	고액이라는 거는 바싹 말랐다 소나무가아니 뿌리야 바싹 말리면 고 고액이
액 애기	액 액이
고애기 된다고요 고액	고액이 된다고요 고액
그래 그걸 인제 판다고	그래 그걸 이제 판다고
사람드리 가서 파내가주고	사람들이 가서 파 가지고
그 소느로 파면 돼요	그 손으로 파면 돼요
아니 그 고 꼬깨이 가서 패야지 어이	아니 그 고 곡괭이 가지고 가서 패야지 어이
힘드려요 아이	힘들어요 아이
산 따이 뿌리 뿌리가 바로 써거서 거트른 써꼬 아넨 안 안 아네 인능게 그게 고애기라고	산 땅이 뿌리 뿌리가 바로 썩어서 겉은 썩고 안에는 안 안 안에 있는 것이 그게 고액이라고
그래 그걸 인제 파는 데는 심말도 꼬깽이 뭐 이러게 뒤로 짜놔도 돼	그래 그걸 이제 파는 데도 힘 말도 곡괭이 뭐 이렇게 뒤로 찌어 놔도 돼
떠빙기고 이래 해고 저 하는데 걸 인제 파가주 와 가주고 지베가따 은제 그 건 뭐 여러 집파요	떠빙기고 이렇게 하고 저 하는데 그걸 이제 파 가지고 와 가지고 집에 갔다 언제 그 건 뭐여러 집에 팔아요
겨우레 파다가 옌나레는 그 지름도 업쩡 기름	겨울에 파다가 옛날에는 그 기름도 없어기름
소경도 업써따고	소경도 없었다고
일본 시대 때 그 저 배급 배그부로 한 병 두 병 식 우리가 바단는데 고 당시에는 그걸 또개가주고 코끄랑 코끌	일본 시대 때 그 저 배급 배급으로 한 병 두 병 씩 우리가 받았는데 그 당시에는 나누어 가지고 코끄랑 코끌
녜네	녜 나 네
지베 코끌 아니 해고	집에 코끌 아니 하고
네 고거 쫌 이따 다시 설명 좀 해주시고 네 네 코끄를	네 그거 좀 이따 다시 설명을 좀 해주시고 네 네 코끌을
소꼼 소까지 방에	소가지 방에
그 소까지 그기 팔게요	그 소가지 그게 빨게요
아주 발거타고	아주 빨갛다고
그 고애기 돼 가주구	그 고액이 돼 가지고
그래 그 도글 도끼래가주 이 이 똥해 가주고 마치 강간하게 주까치 맨드러 가주고 성냥 뿌리는 나즈보리 탁 그래가주 이래 변해머뇨 꼽 으터	그래 그 도글 도끼를 가지고 이 이 동해 가지고 마치 간간하게 죽 같이 만들어 가지고 석냥 뿌리는 낮으로 탁 그래 가지고이렇게 변하면요
그럼 이만치 묵짜네요 다늘	그럼 이만큼 묶잖아요
무꺼가주구 이래 콱 이래 들머는 그 부리 확 부짜네요	묶어 가지고 이렇게 콱 이렇게 들면그 불이 확 붙잖아요
부틈 요게 이 우리 방에 이래씀 전체가 환하지 뭐	붙으면 여기에 이 우리 방에 이러면 전체가 환하지 뭐
그래가주 구레 드러가 구레 드러가주구 우리가 비둘기 잡꼬 그래따이	그래 가지고 굴에 들어가 굴에 들어가 가지고 우리가 비둘기 잡고 그랬다고
옌나레는	옛날에는
비둘기요	비둘기요
비둘기	비둘기
아께 내 그러자나 비둘기 자버따고	아까 내가 그러잖아 비둘기 잡았다고
네 네	네 네
그러며는 이제 옌나레는바메 부를 캐는 그 건 어떵게 이써요	아 그러면 이제 옛날에는 밤에 불을 켜는 그런 건 어떤 게 있었어요
야간등	야간등
아니 방에	아니 방에
이 정기 업쓸때요	이 전기 없을 때요
정기 업쓸 째는 그 지 지르미 하지 지름	전기 없을 때에는 그 기 기름으로 하지 기름
서구지름	서구기름
그 유교사변 후엔 지르미 마니 나와씀니다	그 육이오 사변 후에는 기름이 많이 나왔습니다
금 지름 저네느뇨	그럼 기름 전에는요
지름 저네 소까지지	기름 전에는 소가지지
마른 소까지라 소까지 줌비를 마니 한다고 겨우레 사네 가서 막 파 파다가 마당까가 졸라매	마른 소가지라 소가지 준비를 많이 한다고 겨울에 산에 가서 막 파 파다가 마당가에 가 졸라 매
해 노코는 심심하먼 나가 도 돌끼로 맨드러 가주고 사랑은 사랑 안빵에 안빵 코꾸리이써 코꿀	해 놓고는 심심하면 나가서 도 도끼로 만들어 가지고 사랑은 사랑 안방에는 안방 코꾸리 있어 코꿀
저 푸대다가 구술 꿰서 사람 코처럼 이러케 저 코대달 쭉 이래 후리고 나서 이러케 해 노코미테다 볼릴 바쳐노코 거다가 불 해나 이 불	저 푸대에다가 구술을 꿰서 사람 코처럼 이렇게 저 쭉 이렇게 후리고 나서 이렇게 해 놓고 밑에다 볼일 바쳐놓고 거기에다가 불을 해놔 이 불
그래 뭐 영기는 구두락 구둘 아네 내문서 매굴짜네요	그래 뭐 연기는 구둘 구둘 안에 내면서 매우자네요
매우께 내 끄네 그치만 거 쪼금 올러 가 가주고 바끄로 나가다 굴뚜기 이써 굴뚝또	매우니까 내  그렇지만 그 조금 올라 가 가지고 밖으로 나가다 굴뚝이 있어 굴뚝도
굴뚝	굴뚝
그렁게 글 나가	그러니까 그리로 나가
그 바라미 되 불며는 꼬만 굴뚜구로 바라미 드러오먼 방에 또 영기가 확 전체는 뭐 그만 아네서 뭐 재채기들 하고 그래 그런 사잔 지드크 사른 끄실지	그 바람이 되 불면 그만 굴뚝으로바람이 들어오면 방에 또 연기가 확 전체는 뭐 그만 안에서 뭐 재채기들 하고 그래 그런  살이 끄실리지
그럼 그 거게 인제 소까지 부를 행타가 그 푸꺼져따	그럼 그 거기에 이제 소가지 불을 하다가 그 불이 푹 꺼졌다
꺼지면 그 부를 살려 가주고 또 불 나야 되자네요	꺼지면 그 불을 살려 가지고 또 불을 놔야되잖아요
그래먼 우리 어머님드른 난 제 뭐 이러게 뭐 이 사흘쓱 사물 사머	그러면 우리 어머님들은난 제 뭐 이렇게 뭐 이 사흘 씩 삼을 삼아
삼 베쌈 한 제를 하머는 꺼지니까 꺼저 불러 우리는 안저서 불 야 니 언니이 좀 불 좀 놔라고 그 불르는다구	삼 볏삼 한 제를 하면 꺼지니까 꺼지면 불러 우리는 앉아서 불 야 니 언니 좀 불 좀 놓으라고 그 부른다고
그리 꺼지머는 그 부를 살리기 위해서 드리대고 그 소까지 부를 부러	그렇게 꺼지면 그 불을 살리기 위해서 들이대고 그 소가지 불을 부러
잉거래가 이쓰니까 드레 후룰 부르다 보먼 확 부리 부틀 께 아니요	인 거리가 있으니까 들어가 후룰 부르다 보면 확 불이 붙을 거 아니요
그래먼 이마게 왜 확 치다라 가지고 머리가 확 끄시능교	그러면 이마에 왜 확 치달아 가지고 머리가 확 끄실리는 거에요
머리가 이래 여 여가 확 끄냥 꺼셔 머리 끄러게 확 난다고	머리가 이렇게 여기가 여기가확 그냥 끄셔서 머리  확 난다고
그런 시저레 그런 그러케 살다가 유교사벼니 난 후에는 지르미 좀 드러가 도랑통으로 오며는동네다가 장사가 나도 지름 장사해따고	그런 시절에 그런 그렇게 살다가 육이오 사변이 난 후에는 기름이 좀 들어가 드럼통으로 오면 동네에다가 장사가 나도 기름 장사 했다고
사변 후에 한 다라 씽 가따가 동네 피고는 한 명씩 너주고 두 명씩 주머는 고 다 시번 씩 내가이영 머꼬 그런 장사 해따구요	사변 후에 한 다라 씩 갔다가 동네에 피고는 한명 씩 넣어 주고 두명 씩 주면 그 다 십원 씩 내가이윤을 먹고 그런 장사를 했다고요
등잔 가튼 거또 이썬나요	등잔 같은 것도 있었나요
그 그러치	그 그렇지
그 그때 쓴 등장이지 바로	그 그때 쓴 것이 등장이지 바로
언제요	언제요
그 유교사변 저네도 이써꼬 시바사뇨 일본시대부텀 등이 이써써찌 등	그 육이오 사변 전에도있었고 시바사뇨 일본 시대부터 등이 있었었지 등
호롱뿌를 크는데 소까지 부른 인제 지르미 마느며는 소까지 안 하지만 지르믈 그때 일본놈드리 배그불 줘따 배그불	호롱불을 키는데 소가지 불은 이제 기름이 많으면 소가지는 안 하지만기름을 그때 일본놈들이 배급을 줬다 배급을
배급 배그비란 뭐이먼 동네 인제 예를 드러서 하청와따	배급 배급이란 뭐냐면 동네 이제예를 들어서 하청 왔다
그래이머는 굴근 지버는 시꾸 마는 집 방 마는 지분 두뵹 자근 지분 병가 평반 또 아주 저  근 지분 한 병 그램 그걸 그냥 쓰접 저 다름 해 노코 호롱에다 쪼끄로 노코	그러면 굵은 집은식구 많은 집 방 많은 집은 두 병 작은 집은 병가 평반 또 아주 작은 집은 한 병 그러면 그걸그냥  저 달아 매 놓고 호롱에다 쪽 따라 넣고
어디 다라나요	어디에 달아나요
방에다 달매 노코 짐 병을	방에다 달아 매 놓고 짐 병을
그래 호롱 소게 오르네 부꼬는 그 불켜 논 땐하자네요	그래 호롱 속에 오르네 부꼬는 그 불을 켜 놓으면 땐 하잖아요
그걸 게속 키머는 다 떠러져짜네 그래모 한 돈지 이먼 그 행사가 나옴 쓸라고 그 지르믈 애끼고 소까지 소까지 그 코끄레 그 코끄리라 한다 코끌	그걸 계속 키면 다 떨어졌잖아 그러면한 돈지 이면 그 행사가 나옴 쓸라고 그 기름을 아끼고 소가지소가지 그 코끄레 그 코끄리라한다 코끌
코처럼 생겨따 코끄레 한다고 아려요	코처럼 생겼다 꼬끄레 한다고 알아요
네 네저 봐씀니다	네 네저 봤습니다
봐써요 고걸	봤어요 그걸
네 네 봐써요 네	네 네 봤어요 네
이 그 그 코글 생겨쪼	이 그 그 코글 생겼지요
그래 코끄리요 거	그래 코끄리요 그게
금 어르신 어르신 그 소도 머기셔써요	그럼 어르신 어르신 그 소도 먹이셨어요
소 머깅 거 보셔써요 소	소 먹이는 거 보셨어요 소
거 소 내가 파는 제가 인제	그 소 내가 팔던 때가 이제
저쪼게도 소 이떤데요 아까도	저쪽에도 소가 있던데요 아까도
이찌 내가 인제 이 집 이 집 지꼬는 지끼 저네 소 이 또 이 집 지꼬는 소 마구깐 마구깐도치워따고	있지 내가 이제 이 집 이 집 짓고는 짓기 전에 소 이 또 이 집 짓고는 소 마굿간 마굿간도 치웠다고
여 여기 인능 거 때려치우니까두루	여 여기 있는 거 때려치우니까
이 소 안 밍게 올해 십쌈 년	이 소 안 먹인 것이 올해 십삼 년
안 메긴지 십 쌈년	안 먹인지 십삼 년
십쌈 년 그럼	십삼 년 그럼
근데 소 한 마니 머길 때는 몀마리 정도	근데 소 한 많이 먹일 때는 몇 마리 정도
소 마니 메길 쩌기는 뭐 십 그 큰 소 두 마리씩 몸 미고 큰 소 하나 송아지 하나	소 많이먹일 쩍에는 뭐 십 그 큰 소 두 마리씩 못 먹이고 큰 소 하나 송아지 하나
응 송아지 두 마리 저 거또 내가 쏘가 쌍둥이라 또 쌍뒹이	응 송아지 두 마리 저거 그것도 내가 소가 쌍둥이라 또 쌍둥이
쌍둥이 나니까 두 마리 그 씨가 서너 마리 술짱 서너 말하고 그래고 뭐 건 아물지	쌍둥이나니까 두 마리 그 씨가 서너 마리  서너 말하고 그러고 뭐 그건 아물지
그니까 옌나레는 그 소를 이제 보통 어트게 기르나요 기를 때는	그러니까 옛날에는 그 소를이제 보통 어떻게 기르나요 기를 때는
뭐 송이를 봐야지	뭐 송아지를 봐야지
겨우레는아께 코 그 콩깍찌에 옥쑤수 꺼 대공 이런 조이 그 소 뭐 이렁건 훌 뫄가주고잡또 쒀 너서 그 뜨레가 소 주고 겨우레	겨울에는아까 코 그 콩까지에 옥수수 그 대공 이런 그 소 뭐 이런 거를 훌 모아 가지고 잡도 쑤어 넣어서 그 뜰에 가서 소 주고 겨울에
그러며는 네 소를 기를 때 그 소를 기를려며는 뭘 지어야 되나요	아 그러면 소를 기를때 그 소를 기르려면 뭘 지어야 되나요
어떵게 이써요 소 소 기를	어떤 게 있어요 소 소 기를
기른 마구 이짜나 마구깐	기르는 건 마구 있잖아 마굿간
그거요	아 그거요
왜 이 한 지베 이러게 여덜 카니라 하머는 마 삼십 평이라 하머는 안빵 우빵 정지문 가매쩡지랑 게 이써 강냉이 가매 끄는 가매 큰 강애	왜 이 한 집에 이렇게 여덜 칸이라 하면 뭐삼십 평이라 하면 안방 윗방 정지문 가마니 정지라는 게 있어 강냉이 가마니 끄는 가마니 큰강애
소주 끼리고 안쩡제는 바케 노쿠 그 가매 가매 인는 담 마램 그 구두리 소 소 방이지 뭐	소죽 끓이고 안정지에는  놓고 그 마니 가마니 있는 담   그 구둘이 소 소 방이지 뭐
근데그 인제 고 재민는게 어떤 나 어떤 도 어떤 지방을 가며는 소 마구까니 따로인는데 저기 제가 아는 조게 강원도 부평이나 이쪼게 가니까 정지는 하난데 요 요 안쪼게는 밥찌꾸 하는 가마도 이꼬 고 바로 뒤에 그냥 나무 하나 뛰에 쳐 노코 마구까니 이써요	아 근데예 그 이제 그 재미있는 게 어떤 나 어떤 도 어떤 지방을 가면 소 마굿간이 따로 있는데 저기제가 아는 쪽에 강원도 부평이나 이쪽에 가니까 정지는 하난데 이 이 안쪽에는 밥 짓고 하는 가마도 있고 그 바로 뒤에 그냥 나무 하나 뒤에 쳐 놓고 마굿간이 있어요
여기는 어떠케 핸나요	여기는 어떻게 했나요
여기도 여게도 인제 처음엔 인제 그러케 하고 내중에는 인제 모두 보머는 마구깐 그 마구에소똥내가 저 마니 난다 해 가주구 그 여페 좀 면 미다 떠러저서 요리 따로 제 가주고 소 여그로 퍼 주기도 하고 그래	여기도 여기에도 이제 처음에는 이제 그렇게 하고 나중에는 이제 모두보면 마굿간 그 마구에 소똥내가 저 많이 난다 해 가지고 그 옆에 좀 몇 미터 떨어져서 여기에따로 지어 가지고 소 여기에다 퍼 주기도 하고 그래
그긴 뭐 그러게 소키미 다 달러 다 다	그건 뭐 그렇게 소 키우는 것이 다 달러 다 다
옌나레는  그 옌나레는 주로 어떠케 하셔써요	옛날에는  그 옛날에는 주로 어떻게 하셨어요
옌나레서 그러케 해따고 우리는	옛날에 그렇게 했다고 우리는
소를 키울 때 그냥 가치 그냥 하나에서 써 썬나요 그냥한 마구깐	아 소를 키울 때 그냥 같이 그냥 하나에서 써 썼나요 그냥 한 마굿간
한 지비	한 집에
그니까 정지 아네다가 그	그러니까 정지 안에다가 그
아니 마구까니 다 카니 달려 이떠그럼	아니 마굿간이 다 칸이 달려 있어그럼
소킴 소 소 마구까니 따로 이찌 방빠니 그럼	아 소 키우면 소 소 마굿간이 따로 이찌 그럼
그럴 때 인제 소 먹기 줄려며는 그 그기 뭘 소 머글 수 이또록 할 쑤 인나요	그럴 때 이제소 먹이 줄려면 그 그게 뭐를 소 먹을 수 있도록 할 수 있나요
그 소영 소구영 이짜나 소구영	그 소영 소구영 있잖아 소구영
소구영	아 소구영
그 저네 다 아페 큰 옌나른 아람두리 이러거 부자짜리 소를 소나무 베 가주고 이 소늘 맨드러	그 전에 다 앞에 큰 옛날은 아람들이 이런거 부자짜리 소를 소나무 베어 가지고 이 손을 만들어
이 이러 고여 쥔다고 요러케	이 이렇게 고여 쥔다고 이렇게
뭘로 치나요	뭘로 치나요
그 저 이 뭐 자구가틍 거 가 가주고 저저 파서 파서 퍼 내고 그럼 고 아네 무리 아무래도그 엄청 드러간다고	그 저 이 뭐 자구 같은 거 가지고 가서 저 저 파서 파서 퍼 내고 그럼그 안에 물이 아무래도 그 엄청 들어간다고
이리 찔 항겨	이렇게  하는 거야
고게 모 뽜써 소영 모뽜써	그거 못 봤어 소영 못 봤어
그래 그 소구영이라고	그래 그 소구영이라고
고거 가틍 그거는 거닥 소 소주  뭐 그래지	그거 같은 그거는 그닥 소 소주  뭐 그러지
그 소드른 주로 어떤 걸 마니 머건나요	그 소들은 주로 어떤 걸 마니 먹었나요
소들 머기능거	소들 먹이는 거
그래 배우러 아께 앙 그래요 콩깍찌 조이껍 조이 저이 머시기 대공 고 담 옥쑤수 요 옥쑤수가 이게 조응 거요 옥쑤수	그래 배우라고 아까 안 그래요 콩깍지  조 저 뭐야 대공 그 다음 옥수수 이 옥수수가 이게 좋은 거에요 옥수수
또 마릉 걸 주나요	또 마른 걸 주나요
아니지 이거는 작뚜 써러 가주구 가매다가 물 부꼬 소 송 마리먼 가매 함 물 그 뚜어 붜요뇨 요통으로	아니지 이거는 작두에 썰어 가지고 가마니에다가 물을 붓고 소 송 말리면 가마니에다가 한 번 물을 그 부어요 요 요통으로
나도 뙈	나도 돼
아잉 도늘 모때도 조를 조를 요 메출부름 메추름	아잉 돈을 못 대도 조를 조를 이
매초롱이요	매초롱이요
응 응	응 응
그래먼 사십 뙤로 버는 사지 뙤	그러면 사십 되로 버는 사지 되
개쑤로 사십 뙤 정도 멍이 인는다고	개수로 사십 되 정도 멍이 잇는다고
그래거드 거다 그래 가서는 저	그렇게 하거든 거기에다 그래 가서는 저
요 요 네 네 소리를 쫌 노금 좀 해야 되서 네	요 요 네 네 소리를 좀 녹음 좀 해야 되서 네
사십 뙤를 부어 가주고 그 그저네는 부자 찌부는 글다가 콩싸래기레 이써	사십 되를 부어가지고 그 그전에는 부자 집은 거기에다가 콩싸라기라고 있어
콩싸라기에 콩 콩 인제 까불고 그 밥 방개가 잘 아주버리기 저 저 싸래기 나가	콩싸라기에콩 콩 이제 까불고 그 밥 반 개가 잘 아주 버리기 저저 싸래기 나가
그래 그걸 모아따가 소를 이제 가끔 타서 주머는 이 보미 되면 소가 털 빨리 뽑꼬 저거에 사리 져 나오고 아주 엄는 사람 그거또 모타머는 그 소를 겨우네 그런 핑냥을 제대로 모 쭌 소는보메 나머는 털도 모 뽑꼬 소가 패래서 매른 업써	그래 그걸 모았다가 소를 이제 가끔 타서 주면 이 봄이 되면 소가 털 빨리 뽑고 저거에 살이 쪄 나오고 아주 없는 사람은 그것도 못 하며는 그 소를 겨울 내내 그런 식냥을 제대로 못 준 소는 봄에 나면 털도 못 뽑고 소가 패래서 매른 없어
그리고 부자 찌부는 곡써글 좀 매 때미네 사리 부하게 자가주고 그러치	그리고 부자 집은  곡식을 좀 먹였기 때문에 사리 부하게 쪄가지고 그렇지
그러며는 그 예저네는 그 나메 집 소를 머기기도 하자나요	그러면 그 예전에는 그 남의 집소를 먹이기도 하잖아요
그 나	그 나
그럼 능사레 나무 시무이지	그럼   나무 심어야지
뭐 업씨 모싸는 사람 소 소도 업따고	뭐 없이 못 사는 사람은 소 소도 없다고
그래 부익 부익 뿌 빈익 삔 하먼뇨 부익삐는 농토도 토지도 만코 그차네요	그래 부익 부익 부 빈익 빈 하면요 부익부는 농토도 토지도 많고 그렇잖아요
이러니까두루 인제 농상 마니 지니까두루 이우써 그 몯 싸는 사라미 쌀 함 말  두 말 가따머꼬는 그 집 이를 해 주능 거요	이러니까 이제 농사를 많이 지니까 이웃에서 그 못 사는 사람이 쌀 한 말 두 말 갔다 먹고는 그 집 일을 해 주는 거에요
그래 자기 이를 할 쑤 업짜네요 자기 농지도 업짜네요	그래 자기 일을 할 수 없잖아요 자기농지도 없잖아요
나무 농토 부체 가주고 도시허자네요	남의 농토 부쳐 가지고 도시하잖아요
노늘 노늘 부치든 그 옥쑤수 하던 하머는 노니 이래도 한 마지기머는 한 모지베서 쌀 딱 세나 서 마른 전주가 저들 꺼 아니요	논을 논을 부치든 그 옥수수 하던지 하면 논이 이래도 한마지기면 한 모지기 에서 쌀 딱 서 말이 나 서 말은 전주가 자기들 것 아니요
그럼 흉년 들먼 그럭 그러케 도중이 주고 나머는 엄는 사람 그 이듬해 가서 배골른다고 이저배골	그럼 흉년이 들면 그렇 그렇게 도중이 주고 나면 없는 사람은 그 이듬해 가서 배를 골른다고 이 저 배골
싱냥이 모자란 사람 하 배 골른다고	식량이 모자란 사람 하 배 골른다고
그래 여 또 업씨니 또 또 그 사람데 꿔다 머꼬 장이 장이는 모냐먼 항 가마이 한 말 가따머금 밤 말 가따 줘 밤말	그래 이 또 없으니 또 또 사람한테 꿔다 먹고 장이 장이는 뭐냐면한 가마니 한 말 갔다 먹으면 반 말을 갔다 줘 반 말
그이 그 이짜가 도느로 말할 꺼 가트면 그기 오십푸로여 오십푸로	그게 그 이자가 돈으로말할 거 같으면 그게 오십프로야 오십프로
마넌 가따 쓰고 오처넌 가따주먼 오처넌	만 원 갔다 쓰고 오천 원 갔다주면 오천 원
아라요	알아요
요 그래 그래다 보니까 우는 우는 사라문 결론저그로 인는 사라메 돈 뻐리 해주구 인는 사람이망 부자 시켜준단 얘기요	이 그래 그렇다 보니까 우는 우는 사람은 결론적으로 있는 사람에돈 벌이를 해 주고 있는 사람들만 부자 시켜준다는 얘기요
아이 고건 쫌 이따 여쭤볼껀데요	아이 그건 좀 이따 여쭤볼 건데요
그러며는 소를 인제 나메 집 소를 마니 가져 오는 경우에 조꺼는 어떠케 돼요	그러면 소를이제 남의 집 소를 많이 가져 오는 경우에 조건은 어떻게 돼요
조꺼는 그 저 농기쇠로 농기쇠로 그냥 농 농기 농사 지으니깐 농기소	조건은 그 저 농기소로 농기소로 그냥 농 농기 농사 지으니까 농기소
농기로 어더 온다고	농기로 얻어 온다고
어더와서	얻어 와서
그걸 농 농	그걸 농 농
농기쇠 농기	농기소 농기
농기쇠라고 하나요	아 농기소라고 하나요
응 농기쇠가 노리 농기소	응 농기소가 노래 농기소
응 우리 시대느뇨	응 우리 시대는요
그냥 이게 어더 온 소를 농기소	아 그냥 이게 얻어 온 소를 농기소
응 농기소 그냥 그 소를 인제 어드가다 내가 가따 암소 거튼 이걸 말하자머는 인제 요 쇠 가져와따	응 농기소 그냥 그 소를 이제 얻어다가 내가 갔다 암소 같은 이걸 말하자면 이제 이소 가져왔다
소를 가져 와씨머는 내 이 농사 지꼬 또 후년 농사 한 일 년 깐 지나가먼 가져와짜네	소를가져 왔으면 내 이 농사 짓고 또 후년 농사 한 일 년 간 지나가면 가져왔잖아
그래먼 소가 또 매놔 송아지를 함 마리 나	그러면 소가 또 매놔 송아지를 한 마리 낳아
그 새끼를 난단그래 옌나레는	그 새끼를 낳는다 그래 옛날에는
그래이머는 이 태 가서 그 새끼난 소하고 저 이 쩌 머리쭘 머리 줘 줄 쩌게는	그러면 이태 가서 그 새끼 낳은 소하고 저 이 저 머리 줌 머리 줘 줄 적에는
인제 지베 마껄리 한 통자 질머지고 또 장보 고삐 해 가주고 은행 해 가주고 저 알푸레 머루기도 하고 거덩 머레 주고	이제 집에 막걸리 한 통자 짊어지고 또 장보 고삐 해 가지고 은행 해 가지고 저   하고   주고
은행기 한다고요	은행기 한다고요
은행기 요 소귀 고삐 잠능겨	은행기 이 소귀 고삐 잠는 거
소귀	예 소귀
그래 가도 모이 주고	그래 가도 모이 주고
요줌 또유교사변 이후로는 그르쏘라고 이써 그르쏘	요즘 또육이오 사변 이후로는그르소라고 있어 그르소
그르쏘란 모냐머는	그르소란 뭐냐면
그르 그르소요	그르 그르소요
내가 가따 매기자네요	내가 갔다가 먹이잖아요
이연 매겨주머는 사지가 일려네 함 마리 나 가는데 그 대신 저 지비 소 준 지비 사지를 함마리 줘	이 년 먹여주면 사지가 일 년에 한 마리 낳고 가는데 그 대신 저 집이 소 준 집이 사지를 한 마리 줘
그러농기로 그러농기	그러농기로 그러농기
그러농기	그러농기
그러농기는 사지를 함 마리 요 이 연 농사 잘 지꼬 소  언는다고	그러농기는 사지를 한마리 요 이 년 농사 잘 짓고 소  얻는다고
그문 유기오 저네는 아예 그냥 아무거또 그런 거 업씨 그냥	아 그러면 육이오 전에는 아이에 그냥 아무 것도 그런 것 없이 그냥
그냥 그냥 그냥 주기만 하고 아무거또 반는게 업썬네요	그냥 그냥 그냥 주기만 하고 아무것도 맏는 게 없었네요
그럼	그럼
더러 농사 젠 사라미 마껄리 해 가주가 지물 쭉 안쩌서잘써써 이러고 예전 지끔 소 좀마니 늘구 이래니까 고저네 건 농기라능 거는 이 태에 가따 그래고 사지를 함 마리 바더따고	더러 농사를 지은 사람이 막걸리 해 가지고 가  쭉 앉아서잘썼어 이러고 예전에 지금은소가 좀 많이 늘어나고 이러니까 그 전에 그거 농기라는 거는 이 태에 갔다 그렇고 사지를 한마리 받았다고
근데 보통 소를	아 근데 보통 소를
그러면 그러면 그 아까소를 기르는 쪼끄로 아까 그농기소도 이꼬 그르	그러면 그  러면 그 아까소를 기르는 쪽으로 아까 그농기소도 있고 그르
그르소	그르소
농기소 다메 그르소	농기소 다음에 그르소
그르소는 인제 자기가 반는 소요	예 그르소는 이제 자기가 받는 소에요
응 그럼 사지를 함 마리 반는 소	응 그럼 사지를 한 마리 받는 소
바까는 쇠를 가따 매게 가주고 사지를 함 마리 반는 기 그르소	밭 가는 소를 갔다 먹여 가지고 사지를 한 마리 받는 것이 그르소
근데 보통 이게 소를 이 가지고 올 때는 암소나	예 근데 보통 이게 소를 이렇게 가지고 올 때는 암소나 어
데러 암소 가주오지	아 암소 데리고 가져오지
암소를요	암소를요
그럼 수쏘는 안 근제 수쏘는 수쏘는 그거또 그러어티고 바깔기가 틀리자네요 수쏘는 만만치아나요	그럼 숫소는 안 가져 와 숫소는 숫소는 그것도 그러어티고 밭갈기가 틀리잖아요 숫소는 만만하지 않아요
수쏘는 그래고 그기 암소처럼 요샌 앙 그런데 수쏘는 낭가니 사람 뜨자네요	숫소는 그리고그게 암소처럼 요새는 안 그런데 숫소는 낭간에 사람 뜨잖아요
수쏘가 사람 뜰먼 그 그 클란다구	숫소가 사람 들면 그 그 큰일난다고
그러니까 수쏘는 인제 옌나레 그 종모소라고	그러니까 숫소는 이제 옛날에 그 종모소라고
수쏘를 함 마리 그 도 이써야 암소 그 발쩡기 할 쩍 발쩡기 할 쩌게 교배를 해야 되자나요	숫소를 한 마리 그 두고 있어야 암소 그 발정기 할 적에 발정기 할 적에 교배를 해야 되잖아요
그래 옌나렌 일본 시대 때는 조은 씨 너어서 그 종자 바들라구 종 종모소	그래 옛날에 일본 시대 때는 좋은 씨 넣어서 그 종자 받을라고 종 종모소
종모소라고	아 종모소라고
그 종자 용이라고 조은쇠로 한다고	그 종자 용이라고 좋은소로 한다고
종자씨 바들라고	종자씨 받을라고
그래서 아주 아주 보먼 뭐 쌔카니 모터 인제 한 사람 매긴다고	그래서 아주 아주 보면 뭐새까맣게 못 해 이제 한 사람이 먹인다고
고걸 화소라고	그걸 화소라고
화소 그럼	화소 그럼
그럼 모두 그럼 인제 소가 발쩡기가 되머는 모두 그 종모쇠한테 가서 교배를 교배를 한다고	그럼 모두 그럼 이제 소가 발정기가 되면 그 종모소한테 가서 교배를 교배를 한다고
그래고 고 다메 인제 그 종모쇠가 업씨머는 동네 인제 어떤 사람드른 그 함 마리씩 가따 매기먼 그래 매기먼 그럼 따러 대략 저 저 암소 매기지	그리고 그 다음에 이제 그 종모소가 없으면 동네 이제 어떤 사람들은 그 한 마리씩 갔다 먹이면 그래 먹이면 그럼 따러 대략 저 저 암소먹이지
용소봉이야 또 송아지 나먼 그 일려네 함 마리씩 나니까두루 그거뚜 팔머는 시방 또느로 뭐사뱅마너니다 이 뱅마넌 바듬 그두 큰 수화기 아니야	용소봉이야 또 송아지 나면 그 일 년에한 마리 씩 낳니까 그것도 팔면 지금 돈으로 뭐 사백만 원 이다 이 백만 원 받으면 그것도 큰수확이 아니야
네 그 소 중에 그 아까 수쏘 수쐬도 이꼬 화쇠도 인나요	네 그 소 중에 그 아까 숫소 숫소도 있고 화소도 있나요
수쏘가 화쇠지	아 숫소가 화소지
화쇠가 수쏘이고	화소가 숫소이고
가튼 마린가요	아 같은 말인가요
어떤 마를 마니 쓰나요	어떤 말을 많이 쓰나요
요 요 와서는 수소라 수소	요 요 와서는 숫소라 수소
수소지	수소지
예 이누니삐먼 수쇠	
누니삐먼 수쇠	눈이 삐면 수쇠
네 수쇠예 수쇠	네 수쇠예 수쇠
이쪽 말론	예 이쪽 말로는
응 수쇠 수쇠	응 수쇠 수쇠
이쪽 마를 제가 저 궁금해 가주구	예 이쪽 말을 제가 저 궁금해 가지고
그러면 소를 지를 드려야 되자나 소 마를 안 드르며는	그러면 소를 길을 드려야 되잖아 소말을 안 드르면
질 드려야지	잘 드려야지
질 드릴라문 어트게 해야 되나요	기를 드릴려면 어떻게 해야 되나요
질 드릴라먼 애 먹지	아 길 드릴려면 애 먹지
질 드릴라머는 그거또	길 드릴려면 그것도
가장 어릴 때	가장 어릴 때
엉 그럼 어릴 때 그럼 한 세살 쯤 되머는 거다 인제 바테 가서 막 막 띠 이 소가 말 안 드찌 막 겅겅 뛰고 마랴	엉 그럼 어릴 때 그럼 한 세 살 쯤 되면 거기에다 이제 밭에 가서 막막 뛰어 이 소가 말을 안 듣지 막 겅겅 뛰고 말이야
말 안 할끼 아냐 지 모르자네요 머이 뭔지	말 안 할 꺼 아냐 자기가 모르잖아요 뭐가 뭔지
그럼 사라미 아페 이끄러야 된다고	그럼 사람이 앞에 이끌어야 된다고
이끈다한다고 이끈다	이끈다 한다고 이끈다
이제 고 고삐를 딱 쥐머는	이제 고 고삐를 딱 쥐면
근데 고삐를 쥘려먼 뭐가 이 이 뚤	근데 고삐를 쥘려면 뭐가 이 이 뚤
그기 코뚱 이걸 코뛰기라 하지 코뛰기야 위에 코	아 그게 콧등 이걸 코뛰기라 하지 코뛰기야 위에 코
이 건들래지 코뚤래	이 건들래지 코뚤래
건들레 쪼글  소 소를 자버	건들래 쪽을 소 소를 잡어
금 언제 코를 뚤른 뚜르능 거	그럼 언제 코를 뚫는 뚫는 거에요
그거는 소가 한 이 한 일 련 한 일 련 그 좌우간 되먼 뜨고 이래	그거는 소가 한 이 한일 년 한 일 년 그 좌우간 되면 뜨고 이래
어트게 뚤버요	아 어떻게 뚫어요
저 머시 나무꼬지 막딸라무 꼬지 이거 가주고 땔까 가주고선 따니 콜	아 저 뭣이 나무꽂이 막달나무 꽂이 이거 가지고 땔까 가지고선 따니까 코를
움지기자나요	움직이잖아요
음들음들 모글 또 매지 여기를	아 음들음들 목을 또 매지 여기를
모글 매요	목을 매요
이 대충 이 매가주 저 남자가 아네 저 이 미트로 구녕 내서 따일매 달며까주 이 씽걸 이래가주 꽉 주 쥔다고	이 대충 이 매 가지고 저 남자가 안에 저 밑으로 구멍을 내서 딱 이렇게 달  아가지고 이 씬 거를 이래 가지고 꽉 쥔다고
그럼 이래가주구 탁해가주 콱도 비자네요 또 비먼 요 군드레 가따 때러 뀌머는 장구 확 꾸머 나도 뭐에 아무쏘리 모타는 거여	그럼 이래 가지고 탁 해 가지고 콱도 비잖아요 또 비면 이군드레 가져다가 때려서 뀌면 장구 확 넣어 나도 뭐라고 아무 소리 못하는 거야
그러면 먼저 코를 뚤코 나서 콛무를	그러면 먼저 코를 뚫고 나서 콧물을
그 꼬지이를 가주 확 뚤짜네요	그 꽂이를 가지고 확 뚫잖아요
뚤버 쑥 빼먼 구녕이 이쓸께 아니요	뜷러서 쑥 빼면 구멍이 있을 게 아니요
그럼 군드래 매맹기서 나문 군들래 이런거	그럼 군드래 만들어서 나무 군드래 이런 거
그럼 군드래 뀌야지	그럼 군드래 뀌어야지
군드를 똥그랑퉁	군들을 똥그랗게
응 그러치 그래 그래가주 이거 그래 이래가주 어능기 이게 어능기라고 요게	응 그렇지 그래 그래 가지고 이거 그래 이래 가지고 어능기 이게 어능기라고 이게
이 어능기로 요러케	이 어능기로 이렇게
응 짜서	응 짜서
네 짜서 요러케	네 짜서 이렇게
응 그럼 그게 큰 소가 될 꺼 아니요	응 그럼 그게 큰 소가 될 거 아니에요
그럼 질 대러 바깔 쩌게 나제 치머는 여를 부뜨래야지 딴델 안 비자네요	그럼 길이 들어서밭을 갈 적에 낮에 치면 여기를 붙들어야지 딴 데를 안 비잖아요
코 이러케 되먼 아파서 몬 해자네요	코가 이렇게 되면 아파서 못 하잖아요
그럼 인제 이래먼	그럼 이제 이러면
어능기를 부뜨는 거에요 어능기 쪼글	어능기를 붙드는 거에요 어능기 쪽을
그래 가주구 질 그래 가주구전 날리지 막 올라따 내려따 이래먼 인제 오늘또 그래고 고다메 그뎌 요 요즈무는 전속 농에에는 모를 마니 무캐가주고	그래 가지고 길을 그래 가지고아 전 날리지 막 올랐다 내렸다 이러면 이제 오늘또 그랬고 그 다음에도 그래 요 요즘은 전속농에에는 모를 많이 묵혀 가지고
멍에 멍에 그 멍에란다 보구래 소 이거	멍에 멍에 그 멍에라고 한다 보구래 소 이거를
보구래 멍에 타줄	보구래 멍에 타줄
저 소가 이래 이래 거러가먼이쩍 여게	저 소라 이렇게 이렇게 걸어 가면이쪽 여기에
목쪼게요	목쪽에요
그 그래 모 모 뽜써 멍에 모 뽜써	그 그래 못 못 봤어 멍에 못 봤어
멍에	아 멍에
멍에예 네 네	아 멍에예 네 네
그게 멍에라구	그게 멍에라고
이건 다주리구	이건 다주리고
그럼 멍에 인저 가머는 뒤에다가 령은 하나 다러	그럼 멍에 이제 가면 뒤에다가 령은 하나달아
저 남갈 토마글 달던지 한 배끈짜리 백 오심 다러가주 싱냥 뭐 자꾸 자꾸 끄러댕게	저 나무토막을 달든지 한 백 근 짜리 백 오십 달아 가지고 식량 뭐 자꾸 자꾸 끌어 당겨
그럼 여게가 소가 여게가 우어기 딱 뜨러 제 여게가	그럼 여기가 소가 여기가 우어기 딱 생겨 제 여기에가
자꾸 인제 이랭 거기 그거만 멍에가 모시 간다고 이게 사라미 요 손도 여게다 자꾸 문지 제  때려먼 그 꾸룯 구둔 살 베기자네요	자꾸 이제 이렇게 거기 그거만 멍에가 모시 간다고 이게사람의 이 손도 여기에다 자꾸 문지르면 제 때려면 그 굳은 살이 베기잖아요
항 가지 모가 딱 드러 친다고	한 가지 모가 딱 들어 친다고
그래 그래간 인제 바테 자꾸 이 사람 아페 이끌지	그래 그러니까 이제 밭에 자꾸 이 사람앞에 이끌지
그래먼 인제 여 어램 한 수를 안 먹짜네요	그래면 이제 여 어램 한 수를 안 먹잖아요
마를 모태 그러치 그럼 저 머꼬가능교	말을 못 해 그렇지 그럼 저 먹고 가는 거에요
아니 끄거는 가 다 가자 모치 하먼 쇠구 도라 선다고 다	아니 그거는 가다가 가자 모치하면 소가 돌아 선다고 다
그러먼 어르신 고걸 쫌 궁금항 게 인는데 소를 인제 부릴 때 소 모는 소리가 이짜나요	아 그러면 어르신 그걸 좀 궁금한 게 있는데 소를 이제 부릴 때 소 모는 소리가 있잖아요
그럼 소가 이제 이러케 가라고 할 때는 뭐라고 하나요	그럼 소가 이제 이렇게 가라고 할 때는뭐라고 하나요
이러 이러 이러지	이러 이러 이렇게 하지
이러	이러
이러이러	이러이러
이러 이러 이램 혼처 가 이러 이러 하먼 모에 뭉기라문 간다고	이러 이러 이러면 혼자 가 이러 이러 하면 모에 뭉기려면 간다고
가다가 가다가 뭉치먼 와	가다가 가다가 뭉치면와
와하 와 이래먼 또 쇠가 서요 가다가	와하 와 이러면 또 소가 서요 가다가
그래요	아 그래요
그럼 저 짜까 맨다 가자네요	그럼 저쪽에 가서 맨다고 가잖아요
맹가 가서는 도라오자나	매러 가서는 돌아 오잖아
오치 오치	오치 오치
요치 오치	요치 오치
오씨	오씨
오취	오취
이러 이써야 오치하고 시방 오치를 아러 머거요	이렇게 있어야 오치하고 시방 오치를 알아먹어요
그럼 이게 도라서나요	아 그럼 이게 돌아서나요
그래 도라서먼 이 보구레 도는 기게가 가 베문 깐또 이 짜게 쇠가 쇠가 질 드리먼 사라문 나한테 그리 자기 꼴 터고 나능거요	그래 돌아서면 이 보구래 도는 기계가 가서 베면  이 쪽에소가 소가 길이 들면 사람은 나한테 그렇기 자기 골을 타고 나는 거에요
골 타곤	골을 타곤
그럼	그럼
제리도 부디 돌 가러 이러 가자네요	아 제리도 부디 돌 갈아서 이렇게 가잖아요
가다가 이여 복 족파네 살미 이러깐 소투 저래 응 오치 하무네 비그래가 딱 뻐러 스고 이게이 도라서 딱 찌가 서 차올라 간다구요	가다가 이여 복 족판에  이러니깐 소도 저래 응 오치 하면 비그래가 딱 뻐러 서고 이게 이 돌아서 딱 지가 서 차올라 간다고요
그 보먼 참 탄보카지	그거 보면 참 탄복하지
그려머는	음 그려면
그래 지를 드린다고 기를 드린다고	그렇게 길을 드린다고 길을 드린다고
그러며는 그 소를 예를 드러서소 모는 데 이 소가 바께 소가 가는데 이 소가 이 똑빠로가기도 하는데 왜 소를 이게 노넨	그러면 그 소를 예를 들어서소 모는 데 이 소가 밭에소가 가는데 이 소가 이 똑바로 가기도 하는데 왜 소를 이렇게
바다기 내려가고 올라가고	바닥이 내려가고 올라가고
이 오른 이 이 쪼그로 가기도 하고 왼쪼그로 가기도 하자나요	이 오른 이 이 쪽으로 가기도하고 왼쪽으로 가지도 하잖아요
야 그래요	아 그래요
소가 함 지를 드릴 기를 드리자네요	소가 한 번 길을 들일 기를 들이잖아요
지를 드리머는 이리 가머는 이 왼쪼그로 돌먼 아라요 소가	길을 들이면 이쪽으로 가면 이왼쪽으로 돌면 알아요 소가
어트게	어떻게
아니 그래간 인제 이러케 가면 오치 하먼 소가 소도 이 미텐 가른 바치고 여기가 안 가른 바치니까두루 오치하먼 보구래 똑 때머는 저 일 도 저 안다고 안 크 그래 연스비지	아니 그러니까 이제 이렇게 가면 오치 하면 소가 소도 이 밑에는 갈은 밭이고 여기가 안 갈은 밭이니까오치 하면 보구래 똑 때면 저 일도 저 안다고 아니 그래 연습이지
고삐가틍 걸로 이러케	고삐 같은 걸로 이렇게
고삐도 이찌	아 고삐도 있지
이찌마는 마냐게 안 드러오고 이램 오치하먼 꼭 말 안 드럼 고삐를 한 번 탁 땡긴다고	있지만 만냑에 안 들어오고 이러면 오치하면 꼭 말을 안 드르면 고삐를 한 번 탁 땡긴다고
그럼 도러오고	그럼 돌아오고
이 산쇠는 잘 도라가	이 산쇠는 잘 돌아가
그럼 이짜가섬도 반대 방향으로 오치하먼 일로 도러오고 해 이 여보시오 소가 한 열 쌀열 쌀 이상 된 소는 바틀 한 사 년 가라짜네요	그럼 이쪽에 가서도 반대 방향으로 오치 하면 이쪽으로 돌아오고 해 이 여보시오 소가 한 열 살 열 살 이상 된 소는 밭을 한 사 년 갈았잖아요
이런 소는 귀시니라고	이런 소는 귀신이라고
사람 편하 가다가 도레 가다 탁 껄리자네 그럼 댕기보먼 자기 보통 나리나보단 탁 걸리자네그럼 가마니 서 인능 거요	사람 편해 가다가 돌에 가다가 탁 걸리잖아 그럼 다녀보면 자기 보통 날이나 보다는 탁 걸리잖아 그럼 가만히 서 있는 거에요
마냑 거게서 탁 뚜 이래문 보섭 뚝 뿌러지지	만약 거기에서 탁 뚜 이러면 보섭이 뚝 부러지지
그러타고 이 꼬추바치 이러먼 협꼴까 쫙 쪄나 저 나가래 봄뇨 뒤꼬레 약 하나 머거요	그렇다고 이 고추밭이 이러면 협골가 쫙 지어나 저 나가서 보면요 뒷골에 약 하나 먹어요
그 그 오른쪼그로 갈 때는 그냥 고삐도 가치	그 그 오른쪽으로 갈 때는 그냥 고삐도 같이
탕케 나도 가 가다가 말 안 드르머는 잘 저기에 모치에 안 도러서머는 도라서라 그래고 그래먼 또 이 받 가다도 이쩌녀 저쪼끄루 되 되자네요	당겨야 나도 가 가다가 말을 안 들으면잘 저기에 모치에 안 돌아서면 돌아서라 그러고 그러면 또 이 밭 갈다가도 이쪽으로 저쪽으로되 되잖아요
시방때 쫌 되가 한 사라미 이래머 질머질버나 되먼 좀 서야 되자네	지금때 쯤 되가 한 사람이 이렇게 짊어 지셔 힘들면 좀 쉬어야 되잖아
가마니 바테 가다가 좀 쉬고선 쫌 자기 되머는 잘 앙가	가만히 밭에 가다가 좀 쉬고서는좀 자기 힘들면 잘 안 가
잘 가 그래먼 요 요 한 곧 더 가라야 되는데 하고선 마리야 빨리 가자 고삐를 탁 때리머는  지가 아푸니까 빨리 가	잘 가 그러면 이 이 한 곳을 더 갈아야 되는데 하고서는 말이야 빨리가자 고삐를 탁 때리면 자기가 아프니까 빨리 가
그 도러와가주 고 다메 도리 세워 노코는 마아 마아 이램 금세 가자도 와 이럼 승거요	그럼 돌아 와 가지고 그 다음에 돌려 세워 놓고는 마아 마아 이러면 금새 가자도 와 이럼 서는 거요
와서 안눈다고	와서 앉는다고
그럼 쉬키지	그럼 쉬게 하지
그럼 어르신 그 소 소를 보며는 소도 보며는 새까리나 모양이 다 다르자나요	그럼 어르신그 소 소를 보면 소도 보면 색깔이나 모양이 다 다르잖아요
다르지요 고럼	다르지요 그럼
옌나렌 어떤 소드리 이썬나요  솜 모양	옛날엔 어떤 소들이 있었나요 소 모양
대략 뽀머는 하누라고 다 누러치 소가	대략 보면 한우라고 다 노랗지 소가
소가 노라치요	소가 노랗지요
하누 야들하고 소 비까레가 껀 누리하지 그차네요	한우 얘네들 하고 그 소 빛깔이 그건 누리끼리 하지 그렇찮아요
그럼 아주 빨건 쇠가 쫌 뻘씩 항거 인는데 그렁건 좀 드물게 오래고 흑 흑 흑쐬	그럼 아주빨간 소가 좀 빨씩 한 거 있는데 그런 건 좀 드물게 오래고 흑 흑 흑소
꺼문쇠 새카망 거 새카망 게 얼뚝쐬 이꼬 아주 아주 새카먼 쇠가 이꼬	검은 소 새카만 거새카만 거 얼둑소 있고 아주 아주 새카만 소가 있고
그걸 얼뚝쐬라고 하나요	그걸 얼둑소라고 하나요
그럼	그럼
얼뚝 얼뚝쐬는 여 호래이 호랑이처럼 주리 시커머꺼 아이네	얼둑 얼둑소는 이게 호랑이호랑이처럼 줄이 시커멓게 있어요
시커머 이카고 고 담 요 요 샏 요노무네하고	시컴해서 이렇게 하고 그 담 요 요  요놈들하고
그 얼뚝쐬가 이쩌 얼뚝쐬	그 얼둑소가 있어 얼둑소
얼뚝쐬도 이꼬	아 얼둑소도 있고
응 이꼬	응 있고
또 새카망게 이꼬 흑쐬	또 새깜한 게 있고 흑소
아주 아주 까망 거 이꼬	아주 아주 까만 거 있고
그걸 흑쐬라 하기도 하고  까문 소라고 하나요	그걸 흑소라 하기도 하고  까만 소라고 하나요
그 끄럼	그 그럼
그래구 또 그 날 처럼 마리 요 머리가 여 여 소타배기라고 여게 또 허 허여꾸 이 모태기도허여코 또 여겨도 허에꾸 거기두 이꼬	그리고 또 그 날 처럼 말이 요 머리가 이 이 소타백이라고 여기에 또 하 하얗고 이 몸탱이도 하얗고 또 여기도 하얗고 거기도 있고
그건 이르미 뭔가요	그건 이름이 뭔가요
건 소타배기라 하지 소타벼이야	아 그건 소타박이라고 하지 소타병이야
소타배기	소타백이
소타배기 아	아 소타백이 아
그럼 종류가 또 누런 소도 이꼬 그 다메 소타배기 이꼬	그럼 종류가 또 누런 소도 있고 그다음에 소타백이 있고
흑쓰 흑씨 흑쐬 흑쐬	흑스 흑시 흑쇠 흑쇠
흑쐬 꺼문쇠	흑쇠 검은 소
얼룩쐬얼룩쐬요	얼룩소얼룩소요
그래 그러치 비까리가 비까리가 그러타 이럼 돼 비까리가	그래 그렇지 빛깔이가 빛깔이가그렇다 이러면 돼 빛깔이가
비까리가 네	아 빛깔이가 네
그태 끄럼	그러게 하면 돼 그럼
그러면 저기 보니까 소도 보니까 뿔 모양이 다 다르드라고요	그러면 저기 보니까 소도 보니까 뿔 모양이 다 다르더라고요
다르조	다르지요
뿔모양이 어특	뿔모양이 어떻게
뿔모양이 정가그로 정가그로 바로 나능 게 이꼬	뿔모양이 정각으로 정각으로 바로 나는 게있고
고거 담	그거 담
고 이르믈 뭐라고 하나요	그 이름을 뭐라고 하나요
그래 그 정가기라 하지 정각	그래 그 정각이라 하지 정각
정각 네	정각 네
정가근 마른 쪼글하고	정각은 마른 쪽을 하고
고 다메 또 하늘 하늘 불쏘라고 뿌리 또 하늘로 올러 옹 게 이써 이러케	그 다음에 또 하늘 하늘 불소라고 뿌리 또 하늘로 올라 온 게 있어이렇게
이러게이 이러케 올라가 이꼬	이런 거가 이렇게 올라가 있고
고 다메 또 어능 거	그 다음에 또 어떤 거
이르믈 모라고 하나요	이름을 뭐라고 하나요
그거는 건 건 모 건 그러치	그거는 그건 뭐 그건 그렇지
하늘 소라도 안 하고 그 뿌리 그래 나먼 몬 나따 그러지 그래 우리는	하늘소라도 안 하고그 뿔이 그렇게 나면 못 났다 그러지 그래 우리는
뿌리 정가그로 바리 쭝 나가주고 이 나이 마느머는 뿌리 처져	뿔이 정각으로 바르게 쭉 나가지고 이 나이 많으면 뿌리 처져
이거가 그래 이런 이러게 처진다구 올러가지 안 하고	이거가 그래 이런 이렇게 처진다고 올라가지 못 하고
그 대략 뽐 뿌리 요러케 좀 올러오능 거는 그건 아들 머 소뿔 쩌 뿌리 잘 잘몬 나꾸나 그래그러이지 뭐 거	그 대략 보면 뿔이 이렇게 좀 올라 오는 거는 그건 이 애들 뭐 소뿔 저 뿔이잘 잘 못 났구나 그래 그러지 뭐 그거
그기 뭐 하늘 뿌리 뭐 그 그렁 거 업써	그게 뭐 하늘 뿌리 뭐 그 그런거 없어
그럼 소가 뿌리 보니까 요기 저쪽 뽀니까 요러케 된능 거또 이짜네요	그럼 소가 뿔을 보니까여기 저쪽 보니까 이렇게 되는 것도 있잖아요
그러치 그럼	그렇지 그럼
그걸 인제 나이 마느니까 처메 날 쩌게는 대략 대략 요러케 모 여헏 쩌 하먼 한 대쌀 가먼 뿌리 요기쯤 오자네요	그거를 이제 나이 많으니까 처음에 날 적에는 대략 대략 이렇게 뭐여 쩌 하면 한 대 살 먹으면 뿔이 여기쯤 오잖아요
그게 크먼 요 올러가주 네조 함 암소고 하쇠고 나이 마느머는 천지강이랑게 이써 이러케	그게 크면 이 올러 가가지고  하면 암소고 하소고 나이 많으면 천지강이라는 게 있어 이렇게
이리 오러가 자 찌우려징기 천지강이고또 아푸로 이래 꼬부랭 거또 저건 또 자퍼지먼 이래  건 건	이리로 올라가 자 찌우려진 거 천지강이고 또 앞으로 이렇게 꼬부랭진 것도 저건 또 엎어지면 이래 그건 그건
처메	처음에
요러케 된 건 천지가기고	이렇게 된 건 천지각이고
천지각 끄럼	천지각 그럼
그 정각또 이꼬요	그 정각도 있고요
정각또 이꼬	정각도 있고
하늘로 올라강 건	하늘로 올라 간 건
그건 뭐 하늘쏘라 하니까	그건 뭐 하늘소라 하니까
이르미 업써요	이름이 없어요
업써요 건	없어요 그건
그럼 요러케 휘어징거는	아 그럼 이렇게 휘어진 거는
아이 그 다 건 천지가기라 구래	아이 그 다 그건 천지각이라 그래
천지가기라구요	아 천지각이라고요
야꾸 올러와딴 얘기지	올라왔단 얘기지
금 소를 소도 보며는 이르미 이짜나 그러게 한 살 머금 한 살 머근 소 이름 이씀니까	음 금 소를 소도 보면 이름이 있잖아 그렇게 한 살 먹으면 한 살 먹은 소 이름 있씁니까
그건 한 살 한 살 그 그러지 아이 한 살 두 살 이런데 그 재보지기 성모지기에 이써	그건 한 살 한 살 그 그러지 아이 한 살 두 살 이런데 그 재보지기 성모지기에 있어
그건 뭐에요	아 그건 뭐에요
재보라능 거는 이 세 발 이 사람 쩨 이거 빠져	재보라는 거는 이 세 발 이 사람  이거빠져
이 빠지먼 재보	이 빠지면 재보
하나 빠지먼 재보져따구 너	하나 빠지면 재보졌다고 너
고담 성모 성모지기는 이가 저 빠지고 업써지먼 성모지기라 구래	그 다음에 성모 성모지기는 이가 저 빠지고 없어지면 성모지기라 그래
이가	아 이가
한 번 빠져	한 번 빠져
한 번 빠지먼	한 번 빠지면
빠지먼재보지기는 한 다서 싸리다 네사리다 그 그래	빠지면재보지기는 한 다섯살이다 네 살이다 그 그래
재보지기는뇨	아 재보지기는요
그럼 성모지기는뇨	그럼 성모지기는요
성모지기는 또 성모털모는 또 다시 올러오먼 서 성모 터따 구래써	성모지기는 또 성모털모는또 다시 올라오면 서 성모 털 있다 그랬어
또 그 메 싸리랑 거 알고 인제 그 그래	또 그 몇 살이라는 거 알고 이제 그 그래
성모 성모지기는 한 며 쌀 정도 되나요	성모 성모지기는 한 몇 살 정도 되나요
재보지기는 그 성모지기는 그게 세간 내선 그 근디 빠져야 되고 재보지기는 다시 올라간 걸재보지기	재보지기는 그 성모지기는 그게 세 살 되어서 그 근데 빠져야 되고 재보지기는 다시올라간 걸 재보지기
대 여서뙈함 그래	대 여섯 돼함 그래
서너 살 되면 성모지기고 한 네 다서 쌀 되면 재보지기예	서너 살 되면 성모지기고한 네 다섯 살 되면 재보지기예
그래 열쌀 너머 가먼나 나따무이라 나따무이라 베꾸나	그래 열 살 넘어 가면나 나따무이라 나따무이라 벴구나
나따보	나따보
나따북	나따북
나따부	나따부
설 열 쌀만 너 너머 가머는그 쇠는 막 나따무이나 되꾸 나따묵	열 살만 넘 넘어 가면아 그 소는 막 나따무이나 됐고 나따묵
나따묵 돼따 나따무기 돼따	나따묵 됐다 나따묵이 됐다
어르신 그 소를 마니 소도  그러셔쪄	어르신 그 소를 많이 소도  그러셨지요
내가 소장수두 좀 핸는데 뭐	내가 소 장수도 조금 했는데 뭐
그럼 조은 소를 고르는 방버비 이껜네요	그럼 좋은 소를 고르는 방법이 있겠네요
이쪼	있지요
어떤 어떤 소를 골라야 돼 조은 소를	어떤 어떤 소를 골라야 돼 좋은 소를
소가 우선 마리야 그 처째 그 생긴 얼구리가 사나와 얼굴레 제대로 생기되고	소가 우선 말이야 그 첫 째 그 생긴 얼굴이가 사나와 얼굴이 제대로 생겨야 되고
암소는 암소답께 좀 코가 이되고 하소는 하소답께 둥굴고 또 생기야 되고	암소는 압소답게좀 코가 이래야 되고 하소는 하소답게 둥글고 또 생겨야 되고
고 다메 이 목 목떨미가 여가 다 생명이요	그 다음에 이 목 목덜미가 여기가 다 생명이요
목떨미가	목덜미가
이 새 새 모가지라고 새 요 가느자네요	이 새 새 목아지라고 새 요기가 가늘잖아요
암소는 암소다이 가능 가늠 부시데	아 암소는 암소가 가늘면 부실해
여 염주리 이 탱기자보텀	여기 염주리 이 태가자가 부터
여 차져 이 차져딴쭈가 여서 부터야 돼 이러케 가주고	여기가 차져 이 차져단주가 여기에서 붙어야 돼 이렇게 가주고
이러 이깐하니께 그래야지 소가 아주 보는 보는 모양이 이꼬	이렇게 이렇게 하니까 그래야지소가 아주 보는 보는 모양이 있고
염 염주는 몬가요	염 염주는 뭔가요
여 여기 택 미테 더러 염주리라 한다구요	아 여 여기 턱 밑에 더러 염주리라 한다고요
택 미테 내려오는 주리 염주리다염주리고 염주리 쭉 터끄리 또 부터야 되나요	턱밑에 내려오는 줄이 염주리다염주리고 염주리 쭉 터끝에 또 붙어야 되나요
어떵 거는 거 안 부꼬 요 그늘해요 이기	어떤 거는 그게 안 붙고 여기가 그늘해요 이게
여가 쭉 부꺼드뇨 그래요 여서부터감 이런 조감 이꼬 하손 다고 그래고 그 다메 모냐먼 그뒤 뒤 광팡이	여기가 쭉 붙거든요 그래요 여기서 부터 가면 이런  있고 하소는 다 그렇고그러고 그 다음에 뭐냐면 그 뒤 뒤 광팡이
광팡 엉댕이	광팡 엉덩이
엉덩 엉댕이 광팡이래 광팡	엉덩 엉덩이 광팡이래 광팡
그기 뒤이 이 일 일짜로 쫭나가야 되기오	그게 뒤가 이 일 일자로 쫙 나가야 되지요
뒤에 궁댕인데 그래 궁댕이라 또 그러자나	뒤에 엉덩인데 그래 엉덩이라 또 그러잖아
네 네	네 네
그래이막 조골 마리야 이 궁댕이 소궁댕이래 우리가	그러니까 저걸 말이야 이 엉덩이 소엉덩이래 우리가
소궁댕이 쪼기 똥 누는 궁댕이 쪼기 짱게 패야 돼 일짜루	소 엉덩이 쪽이 똥 누는 엉덩이 쪼깅 짝 패야 돼 일자로
패야 된다고요	패야 된다고요
응 거 패잔하고 여 광 광방이찌	응 거기가 패잔하고 여기 광 광방있지
광방에서 이러게 이리	광방에서 이렇게 이리
광봥이요	광봥이요
이 이 광방이라 여그가	이 이 광방이라 여기가
그 뒤서부터 이러게 처 꼬부래지머는 쇠가 보는 이 업써	그 뒤에서 부터 이렇게 처 꼬부라지면 소가 보는 이 없어
거 쩜매 패야 된다고	그거 쩜 매서 펴야 된다고
배 하소는 암쇠 앙캐 암쇠도 대략 이 이런데 이래 짜게 패야 아주 여 이 목떨미 이 목떨미 한여서뜽 저 끄까진 아주 턱 짤러야 내가 해준다구 그래야 인제 그기 새로 건 두 번째 보능 기고	배 하소는 암소 암캐 암소도 대략 이 이런데 이렇게 쫙 펴야 아주 여 이 목덜미 이 목덜미한 여섯 드으 저 끝까진 아주 턱 잘라야 내가 해준다고 그래야 이제 그게 새로 그건 두 번 째보는 거고
세 번째는 모냐머는 하족	세 번째는 뭐냐면 하족
하족 발	하족 발
바리 잘 생김두 바리	발이 잘 생겨야 돼 발이
소는 마리 외서 자 지를 잘근 잘해요 마리	소는 말이 외서 자 길을 잘근 잘해요 말이
말 바리 목 목 모꾸저끼 줘때도 모꾸 모꾸라지 아라요 모꾸	말발이 목 목 목구저끼 줬데도목구 목구라지 알아요 목구
제사 지내는 제사 지내는 그 낭기 모꾸라거등 나무 목 짜 음식 꾸 짜	제사 지내는 제사 지내는 그 나무 목구라고 하거든 나무 목 자 음식 구자
고 왜 똥그래야 지지	거기가 왜 동그래야 하지
그기 사람 손끄처럼 나와주 이러능 거 갈바리래 갈발	거기가 사람 손끝처럼 나와 가지고 이러는 거 갈발이래 갈발
그거는 거르믈 모 꺼러	그거는 걸음을 못 걸어
이 아파가주구 그래구 짜두라기 받 바츨 갈머는 가지를 모태요	이게 아파가지고 그리고 짜투리 밭 밭을 갈면 갈지를 못 해요
이 아퍼 들리고 이런데	여기가 앞아 들리고 이런데
이 모꾸바른 말 처럼 생깅 거는 잘 가거든	이 목구발은 말 처럼 생긴 거는 잘 가거든
비끼를 탁 탁탁탁 막 진다고	빗길을 탁 탁탁탁 막 간다고
그래서	그래서
그 그 목꾸발처럼 생겨야 되나 갈발처럼 생기면 안 되고요	그 그 목구발처럼 생겨야 되지갈발처럼 생기면 안 되고요
그럼 세가지 거니문 으뜸소지 뭐	그럼 이 세가지를 거닐면 으뜸소지 뭐
그럼 다 백태 이상이요	그럼 다 백태 이상이요
그 소가 저게 백태라 그러지	그 소가 저게 백태라 그러지
뱅마넌 조 해에 질 잘랑 게 백태이상	백 만 원 조 해에 제일 잘란 게 백태이상 백태라고 백태 소를 백태라고 백태 소를
젤 잘란 소를 백태	제일 잘란 소를 백태
아니 장에 그날 장에 최고 백 뱅 마리 나짜네	어 아니 장에 그날 장에 최고 백 백 마리 나왔잖아
거서 질 소가 질 인제 내 말 따라 여기가도 행 여기 잘 잘 생겨짜네	거기에서 제일 소가제일 이제 내 말처럼 여기다고 행 여기 잘 잘 생겼잖아
그런 소를저 소가 이번 짱에 백태 중에 최고다 이런 얘기지	그런 소를 저 소가 이번 장에 백태중에 최고다 이런 얘기지
뱅 마리 중에 최고다 그 애기고 또 오심 마리 중에 최고다 소리 안 하고 오십 태 중에 최고다	백 마리 중에 최고다 그 얘기고 또 오십 마리 중에 최고다 소리 안 하고 오십 태 중에 최고다
일뜽 쇠다 이기여	일등 소다 이거야
소를 그래 고르지다고 소를	소를 그렇게 골라야 한다고 소를
근데 건 아는 사람만 고르겐네요 모르는 사람	근데 그건 아는 사람만 고르겠네요 모르는사람
모르지	아 모르지
그 아니 시고레 소 키우는 사람 대략 아러	그 아니 시골에 소 키우는 사람은 대략 알어
내래 소를 마니 키우는 사라믄 장사는 아니래도 소 다 임무리 다 아러 그치마는 이 장에 가떤소장산 사 가 사문 제는 그렁 거는 소를 한 갑 더 주지	나처럼 소를 많이 키우는 사람은 장사는 안 해도 소 다 인물이 다 알아 그렇지만 이 장에 갔던 소장사는 사 가 살 때는 그런 거는소를 한 값 더 주지
갑쓸 더 주지	값을 더 주지
마닐 뱅마 넌 짜리라먼 한 심마 넌 더 주지	만일 백만 원 짜리라면 한 십만 원 더 주지
그래요	아 그래요
끄럼	그럼
그 어르신 옌나레는 이게 나메 집 머슴 품두 사라짜나요	그 어르신 옛날에는 이렇게 남의집 머슴 품도 살았잖아요
그런 사람드리 만차나요	그런 사람들이 많잖아요
만치 머스꾸룬	많지 머슴꾼은
그 머슴 나메 집 사는 사람 을	예 그 머슴 남의 집 사는 사람을
메슴 머슴 다 머슴꾸니라그 머슴	메슴 머슴다 머슴꾼이라 그 머슴
맨 년 다니로 사나요 보통	몇 년 단위로 사나요 보통
그건 뭐 대중 업찌	그건 뭐 대중 없지
처메는 그 이연 계뚤 안 한다구	처음에는 그 이 년 계약을 안 한다고
당 당진 당녀네 한다고	당 당진 당년에 한다고
올해 이게	올해 이게
해마다	해마다 예
내가 인제 머슴꾼 둬따	내가 이제 머슴꾼이 됐다
그 저네 이 금녀네 강냉이 두 가마이 콩자가마이	그 전에 이 금년에 강냉이 두 가마니 콩자가마니
그 조꺼니 어트케 돼요	예 그 조건이 어떻게 돼요
그게 인제 월그비라고	아 그게 이제 월급이라고
말하자먼 푸 농 그 머슴꾸니 일련 삼백 육십 오일랄 내 일 해주구 글 머슴사리로 그 품깝쓰로 중 거요	말하자면푸 농 그 머슴꾼이 일년 삼백 육십 오일 내 일 해주고 그렇게 머슴살이  로 그 품값으로 준 거요
그래가 인제 응 그래가 아이 저고리 함 벌 저고리 바지 저고리 함 벌 뚜 개는 주적쌈 함 벌	그래서 이제 응 그래서 아이 저고리 한 벌 저고리 한 벌 두 개는 주적삼 한 벌
여름 주적쌈	여름 주적삼
주적쌈	주적삼
응 매마즘 한 걸 그 두 벌 해 주고	응  한 걸 그 두 벌 해 주고
시누는 저기네 사 싱기고 강냉이 두 가마이 콩 두 가마이  항 가마이 다서 까마이 미물항 가마이 돼지까마이 해 줄테니 너 우리 지베 오너라 주인하고 인제 그기 그기 인제 계야기 된다고	신은 저기에 가서 사 신기고 강냉이 두 가마니 콩 두 가마니  한 가마니 다섯 가마니 메밀 한 가마니 돼지 가마니 해 줄테니까 너 우리 집에 오너라 주인하고 이제 그게 그게이제 계약이 된다고
그럼 그 지베 인능 거요	그럼 그 집에 있는 거요
봄부텀 봄부텀 농사 다 해주고 소 다 매기고 다 해주고는 그 동지 전날까지 그 집 나무다 해 주능 걸	봄 부터 봄 부터 농사 다 해주고 소 다 먹이고 다 해주고는 그 동지 전날까지그 집 나무 다 해 주는 걸
나무 땔 라무 겨울라무 뭐 베찝 오씸 다 해주고는 동지 팓쭉 머금 나가	나무 땔 나무 겨울 나무 뭐 볏짚 오심 다 해주고는 동지 팥죽 먹으면 나가
나가는데는 다시 그 지베 이쓸라머는 또 재계약 또 해	나가는데 다시 그 집에 있을 려면 또재계약 또 해
내녀네 또 씨구게 그래먼 주인 냥반 날 그게 그 곡써글 항 가마니 더 주시오	내년에 또 씨구게 그러면 주인 양반 나한테 그럼 그 곡식을 한 가마니 더 주시오
또 그래든지 또 뭐 도늘 가주 하든지 다시 그래 하문 그 주인하고 인제 일꾼하구 마미 마즈머는 오연도 조쿠 사 팔련도 조아	또 그렇게 하든지 또 뭐 돈을 가지고 하든지 다시 그렇게하면 그 주인하고 이제 일꾼하고 맘이 맞으면 오 년도 좋고 사 팔 년도 좋아
그래 비버니 상하문 한 해 한 해 하구는 그 가능기여	그래 기분이 상하면 한 해 한 해 하고는 그 가는 거야
한 해 하다가 실타가 중동그이 하다 나가면 안 되자네	한 해 하다가 싫어도 중간에 하다가 나가면 안 되잖아
중동그이가 뭐냐며는 중바네 가문 싸글 몯 빠짜네	중동그이가 뭐냐면 중간에 가면 싹을 못받잖아
그래 그렁거여 건 일꾸는 일꾸는 그 만냐게 그러카지 여델 요 모 딴디약처럼 삼년 사이 건안 한다고	그래 그런거야 일꾼은 일꾼은 그 만약에 그렇게 하지 어딜 이 모 딴띠약처럼 삼 년살이 그건 안 한다고
그러며는 그 어르신 그 옌나레 품마시 가튼 경우도 자주 이썬나요	그러면 그 어르신 그 옛날에 품앗이 같은 경우도 자주 있었나요
푸마시는 이쪼 아끼네 그조	아 품앗이는 있지요 아까 내가 그렇지요
내가 오늘 저 집 꼬추 시머 주머는 저 지비 우리 집 꼬추 시무러 오고 내가 저지파고 받 깔문바깔러 여 오고또 그래고 어얼 한다고	내가 오늘 저 집 고추 심어 주면 저 집이 우리 집 고추심으러 오고 내가 저 집하고 밭 갈면 밭 갈러 여기에 오고 또 그러고 어얼 한다고
내가 소가 함 마리 이짜네요	내가 소가 한 마리 있잖아요
저의 쇠가 함 마리 이짜네요	저의 소가 한 마리 있잖아요
그럼 그 집 하고 또 저 저 집또 소 함 마리 세 찌비 올라가주고 아께 말 가트나 제이 저리  소 하 하나 갈고 하난 그 골키고 그 세찌비 올 해 오늘 우리 집 와서 오늘 콩을 심어따 콩나따	그럼 그 집하고 또 저 저 집도 소 한 마리 세 집이 올라 가 가지고 아까 말처럼 제이 저리 소 하 하나 갈고 하나는 그 골 키고 그 세 집이 올해 오늘 우리집 와서 오늘 콩을 심었다콩 났다
오늘 한 이천 평 가라따 하먼 내일로 그적 그 그적 찝 가서 또 언제 모 콩 하든지 모 옥쑤수하던지 그 그 집 해간다 하먼 그기 인저 어울한다 어울러	오늘 한 이천 평 갈았다 하면 내일로그적 그 그적 집 가서 또 언제 뭐 콩을 하든지 뭐 옥수수 하든지 그 그 집 해간다 하면 그게 이제 어울한다 어울러
한 해 농사를 어울러 진는다고	한 해 농사를 어울러 짓는다고
푸마시라는 거는 오늘 가따가 내가 하고 또 바꼬 고 그리 끈나고 말람 마 하고 이래찌머는그 이러게 짜기래짝	품앗이라는 것은 오늘 갔다가 내가 하고 또 받고 그 그렇게 끊나고 말라면 마 하고 이렇게 했지만 그 이러게 짝이래 짝
요 오늘 오랜 그 지파고 짜글 한다	이 오늘 올 해는 그 집하고 짝을 한다
사라미 소짜기래 소짝	사람이 소짝이래 소짝
소말깐 소짜글 해서 일려네 농사를 제보면 그 사람네 시니를 안다 이기여	소처럼 소짝을 해서 일 년의 농사를 지어 보면 그 사람의 심리를 안다 이거야
알자네요	알잖아요
저 지비 지 자기 농사 질쩌게는 하주 애머꺼 응 힘드려 하고 짝찌비레 가서는 히미 듬 꾀꾀 부리고 그차네요	저 집이 지가 자기 농사 지을 적에는 아주 애 먹어 응힘들어 하고 짝집에 가서는 힘이 들면 꾀 꾀 부리고 그렇찮아요
그래 그래서 한 해하구 에이 저 사람하고 해보니까 저 꾀 부리고 나는 안 한다 소그로 그체	그래 그래서 한 해하고 에이 저 사람하고 해 보니까 저 꾀 부리고 나는 안 한다 속으로 그치요
그래먼 떠리질 쑤 이꼬 세 집 다 마미 통해 내 농사나 그 집 농사나 또까튼 그 마믈 가주고농사를 지꾸 심머리 되머는 심년 시보년 팔련 짝 마쳐하지	그러면 떨어질 수 있고 세 집이다 마음이 통해 내 농사나 그 집 농사나 똑같은 그 마음을 가지고 농사를 짓고 십 년이 되면 십년 십오 년 팔 년 짝 맞쳐서 하지
그렁게요	그런 거에요
그로게 짜글 가치 하능 게 인네요	아 그렇게 짝을 같이 하는 게 있는요
그럼 여게 이찌 그럼	그럼 여기에 있지 그럼
푸마시 말또 해지	품앗이 말도 했지
푸마시를 할 때 우리지분 그 한 네 마지긴데 딴 지분 두 마지기에요	품앗이를 할 때 우리 집은 그 한 네 마지기인데 다른 집은 두 마지기이에요
그러며는 고 나머지는 뭘로 보상을 반는	그러면 그 나머지는 뭘로 보상을 받는
아이 푸마시란 건 그러치 아녀요	아이 품앗이라는 건 그렇지 않아요
푸마시 하러 오이먼 내가 인제 이러케 오늘 에 뭘 천 평을 뭘 심는다	품앗이 하러 모이면내가 이제 이렇게 오늘 에 뭘 천 평을 무엇을 심는다
그럼 사라미 마냑 열 싸라미 피료하다	그럼 사람이 만약 열 사람이 필요하다
그래이머는 어느 주 어느 지부는 내가 아푸로 그 지비랑 저 가서 이 이를 하루 해주고 어는사라믄 농사를 안 지꼬 이래 그 사람 또 사지	그러면 어느 주 어느 집은 내가 앞으로 그 집이랑 저 가서 이 일을 하루 해 주고 어떤 사람은 농사를 안 짓고 이래 그 사람은 또 사지
사 사가주 옴 곡썽준데 사가주 그래가주 다 하 하고 그 사람 돈 주고 고수 줘쓰니까 그마니  고 고담 푸마시 완 사람 그 이틀 그 이틀 가 해주고	사 사 가지고 오면 곡식을 주는데 사가지고 그래 가지고 다 하 하고 그 사람 돈 주고 고수 줬으니까 그만이고 그 다음 품앗이 온 사람드 이틀 그 이틀 가 해주고
푸마시 한 사람 고 정도로 푸마시 하고 그 다메	아 품앗이 한 사람 그 정도로 품앗이 하고 그 다음에
돈 줘써 그래 품까지	돈을 줬어 그래 품까지
풍초로요	아 풍초로요
그 일련 다뉘로 이제 머슴 사능 거 말고 그 이를 할 때마다 이러케 사랑을 언는 경우 이짜나요	그 일 년 단위로 이제 머슴 사는 거 말고 그 일을 할 때마다 이렇게 사람을 얻는 경우 있잖아요
골 뭐라고 함니까 날 하루	그걸 뭐라고 합니까 날 하루
그건 제 하루 건너는 거는 아니지마는 하루 건능 거는 그 사람 고 고정임부라 하지	아그건 제 하루 건너는 거는 아니지만 하루 건느는 거는 그 사람 고정인부라 하지
고정 씨킨 사람	고정식힌 사람
마냐게 한 사라미 한 다레 일 하든지 이시빌 이를 그래 꼬하 하 하는 사람 고정임부	만약에 한 사람이 한 달의 일을 하든지 이십 일 일을 그래 하고 하 하는 사람 고정인부
고정임부라 하고 고정 고정임부라에 하고 내가 부레 머꼬 쓰고 고 다메 일 가 하는 사라믄그 고정임부 임부래 날품파리라 날품파리	고정인부라 하고 고정 고정 인부라에 하고 내가 부려 먹고 쓰고 그 다음에 일 가 하는 사람은 그 고정인부 인부래 날품팔이라 날품팔이
나나레 하니까 고러 마짜네 이 지비 더런 해 주구 시름 안 가자네요	나날이 하니까 그게 맞잖아 이 집에서 더러 해 주고 싫음 안 가잖아요
그 날품파리라고 날품파리	그 날품팔이라고 날품팔이
고정임부 날품파리	고정인부 날품팔이
걱쩡하지마	아 걱정하지마
그러네요	아 그러네요
그럼 그 분들 일할 때 간식 가튼 거또 식싸로 가튼 거 주나요	그럼 그 분들 일 할 때 간식같은 것도 식사로 같은 거 주나요
아이 주조	아이 주지요
진노리	진노리
시방은 간시기라 하조	지금은 간식이라 하지요
그건 젠노래라고 젠노래	그거 젠노래라고 젠노래
며 뻔 주나요	몇 번을 주나요
오저네 함 번 오후에 함 번	오전에 한 번 오후에 한 번
그러면 인제 이를 이를 이제 나메 집 이를 하러 오며는 그 지베서 머꼬 오냐요 아니면	그러면 이제 일을 일을 이제 남의 집 일을 하러 오면 그 집에서 먹고 오나요 아니면
자기가 아치믄 식싸는 자기가 하고 오지	아 자기가 아침은 식사는 자기가 하고 오지
짝찌비 해도 그래 짝찝찌리 해도 그러코 돈 바꼬 푸마 뭐시리 가도 그러 품파리 가도 그러코 푸마시는 푸마시는 서로가 가치 도라감 하능기 푸마시고 품파리는 다니 잘가서 돈 바꼬 오능 게 그기 그 품파리요	짝 집이 해도 그래 짭집끼리 해고 그렇고 돈 받고 품아 뭐하러 가도그렇고 품팔이 가도 그렇고 품앗이는 품앗이는 서로가 같이 돌아가면서 하는 게 품앗이고 품팔이는 다니면서 잘 가서 돈 받고 오는 것이 그게 그 품팔이요
그래니깐 품파리든 짝찌기든 자기 지베 조반 머꼬 인제 오자나 오머는	그러니까품팔이든짝찌기든 자기 집에서 조반을 먹고 이제 오잖아 오면
멀 머꼬 온다고요	뭘 먹고 온다고요
자기 자기 지베 조 식쌀 하고 오자나요	아 자기 자기 집의 조 식사를 하고 오잖아요
아침 식싸를 하고 인제 오 오 우저네	아 아침 식사를 하고 인제 오 오 오전에
이 터에 올 께 아니요	이 터에 올 게 아니요
내가 저그네 오는 뭐 한다 하머는 상 어더 놔쓰니 저거네 오늘 내 콩을 시머	내가 저기네 오는 거 뭐 하다 하면 상을 얻어 놨으니 저거네 오늘 내 콩을 심어
거러 온다고요	걸어온다고요
거 오먼 일곱 씨부터 시작 하자네요	그 오면 일곱 씨 부터 시작 하잖아요
그럼 여덜 씨에 아홉 씨 두 시간 하자네 두 시간	그럼 여덟 시에 아홉 시 두 시간 하잖아두 시간
이 아홉 씨 반 열 씨 돼 가주고 두 시간 반 하던지 하머는 찬 뭐냐 하머는 옌나레 마껄리이짜나 마껄리 곡쭈	이 아홉 시 반 열 시 돼 가지고 두 시간 반 하든지 하면 찬이 뭐냐 하면옛날에 막걸리 있잖아 막걸리 곡주
고걸 차미라고 하나요	그걸 참이라고 하나요
아까 제 젠노리	아까 제 젠노리
젠노리 이러 하기도 차미라 그래도 그래 불러요 두 가지 무꺼따고	젠노리 이렇게 하기도 하고 참이라 그렇기도 그래 불러요 두 가지 묶었다고
젠노리 머그러와 이런 사람도 이꼬 차 머그러 와 이런다고	젠노리 먹으러 와 이런 사람도있고 참 먹으러 와 이런다고
그래 그래 그래 인제 마껄리 이씀 마껄리 걸러 가주고 요 나미또 마꺼떠 항 개씩 머꼬 제 주인 때게 거러가고 고 다메 그때는 모	그래 그래 그래 이제 막걸리 있음 막걸리 걸러서 가지고이 남의   한 개씩 먹고 제 주인 댁에 걸어가고 그 담에 그때는 뭐
젠노래는 멀 멍나요	젠노래는 뭘 먹나요
요 모 감자 쪄 가주 가고 모 저 저 저 강 옥쑤수 강냉이 쩌 가주 가고 고 다메 칼국쑤 가씨기 그렁게 해 가주 가 보리밥 그러게 해 가주 가 바테 가따 펴 노쿠 멍는 기요	이 뭐 감자 쪄가지고 가고 뭐 저 저 저 강 옥수수 강냉이 쩌 가지고 가고 그 다음에 칼국수 가씨기 그런 거해 가지고 가 보리밥 그렇게 해 가지고 가서 밭에 갔다 펴 놓고 먹는 거에요
그래머는 열뚜시두 요거는 아무도 업씨 그 지베 안 올라오먼 바테도 전시믈 해야 아주머니 해요 가 저 받 까서 머꾸	그러면 열 두시도 요거는 아무도 없이 그 집에 안 오라오면 밭에도 점심을 해야 해서 아주머니가 해요 가 저 밭 가서 먹고
그래 또 일하구 저녁때 또 네시 되머는 고 그 나제 점심 머거떵 거 남 남능 게 이따고	그래또 일하고 저녁 때 또 네 시가 되면 그 그 낮에 점심 때 먹었던 거 남 남은 게 있다고
그래 젤 조응 거 해 가주고 가지	그래 제일 좋은 거 해 가지고 가지
바비 한 서너 사라미 먼 여나홉 되먼 말게 하먼서 그륻 나무머는 한 반 그르씩 무레 마라 가주구 이래서 마껄리 머꾸 그래 참 머꾸 시방 빵이	밥이 한 서너 사람이면 여나홉 되면 말게하면서 그 남으면 한 반 그릇 씩 물에 말아 가지고 이래서 막걸리 먹고 그래 참을 먹고 지금은빵이
오후에는 젠노래를 언제쯤 멍나요	오후에는 젠노래를 언제쯤 먹나요
거 네 시	그 네 시
네 시요	네 시요
시방 모 빵 그차뇨 우유 전 만차네	지금은 뭐 빵 그찮아요 우유 많잖아
머 과자 꽈제 꽈제 머 차무로 뭐 이 사탕도 멍는 거 주고 이 이러지만 그때는 그 그저네 그그거만 가시기 제 아푸로	뭐 과자 과자 과자 뭐 참으로 뭐 이 사탕도 먹는 거 주고 이 이러지만 그때는 그 그전에 그 그거만 가시기 제 앞으로
가식	가식
으응 오저네 가시기고 오후엔 지금 모	으응 오전에 가시기고 오후엔 지금 뭐
가시기는 뭔가요	가시기는 뭔가요
가시기 에 칼로 가주 미능 뭐 뭐	가시기는 에 칼을 가지고 미는 뭐 뭐
요 홍투깨라 저 무쳐이써	요 홍두깨라 저 무쳤어
네 네 네	네 네 네
뭉쳐 가주구 콩까루 너쿠	뭉쳐 가지고 콩 가루 넣고
네 가시길 가틍거요	네 가시길 가튼 거요
그 저녀근 안 주나요	그 저녁은 안 주나요
다 안 줘요 꺼는	다 안 줘요 그거는
그 엔 그 옌나레 내려오는 얘기가 풍문 바라메 드른 거듣 얘기 아니구 실찌 내려오는 유래얘기를 내가 함 해드리까요	그 옛날에 내려오는 얘기가 풍문 바람에 들은 거 얘기 아니고 실제 내려오는 유래 얘기를 내가 한 번 해 드릴까요
예 그 조씀니다	아그 좋습니다
여기 뭐 전서리나	여기 워 전설이나
전설	전설
네 전서리나 그런 거뜰 네네	네 전설이나 그런 것들 네네
전설전서리 아주 오래된 저 전서리 지금 하며는 한 저 삼뱅 년 아네 저니래요	전설 예전설이 아주 오래 된 저 전설이 지금 하며는 한 저 삼백년 안에 전이래요
그래요	아 그래요
일백 오심년 고 새 전서린데	일백 오심년 그 사이 전설인데
해 주시면 조케씀니다 네네	해 주시면 좋겠습니다 네네
옌나레 그 아께 저네 그 그 정선 부자집 터 이 미테 이따 그래짜네요	옛날에 그 아까 전에그 그 정선 부자집 터 이 밑에 있다고 그랬잖아요
부자	부자
부자 정선 정선 가뿌터에 부테이 이써 집 인는데 거 지비 어뜨케서	부자 정선 정선 갑부터에 있어 집 있는데 그 집이 어떻게 해서
거기가 그 혿	거기가 그
아니 요구 요구 요구 내려가는	아니 요기 요기 요기 내려가는
풍초네 이씀니까	풍촌에 있습니까
아니 요구 내려 이벵메다래요	아니 요기 내려 래요
이뱅메다	아
가따 낭 내려가보먼 알꺼래요	가다 내려가보면 알거래요
그 인왕 전씨드리 그 사리 민 하고 미테 임금 왕인데 이 존소근 이러케 부스로 내 글미처럼  이런 터이 업써요	그 인왕 전씨들이 그 사람 인 하고 밑에 임금 왕인데 이 존속은 이렇게 붓으로 내 그림처럼 이런 터가 없어요
터이 산 이 산세가 조케 잘 드러와찌마는 이런 이런 터이 경상도나 절라도 어데 아프 아뻬널분 바다에 가서 산 이러케 터이 자펴 이씨면 요 큰 대지 터이람니다	터가 산 이 산세가 좋게 잘 들어 왔지마는 이런 이런 터가 경상도나 전라도 어디 앞에 넓은 바다에 가서 산 이렇게터가 잡혀 있으면 요 큰 대지 터랍니다 여이 옌나레 도승이가 자버따하는데 그때는 요래 내 왜 이래쓸꼬 이랟 이래니까 그러며는 거옌나레 거 호짜 준짜하는 그 전씨들 하라버지 내가 그 우리 요 살 쩌게는 칠 형제 칠악짜 아드리 칠 형제고 으 고 다멛 그 노짜함 이러버련는데  여기 옛날에 도승이가 잡았다 하는데 그때는 이렇게 내 왜 이랬을까 그러며는 옛날에 호 자 준 자 하는 그 전씨들 할아버지 내가 그 우리 여기 살 쩍에는 칠 형제 칠  아들이 칠 형제고 그 다음에 그  잃어버렸는데
네 전호준 하라버지	네 전호준 할아버지
호주니요	호준이요
범 호짜 준걸 준짠데	범 호 자 줄말 준 잔데
그 어떤 준 짬니까	그 어떤 준 자 입니까
저 준걸 준	저 준말 준
준말 준짜요 네네	준말 준 자요 네네
그런데 그 양바니 인제 그 아드리 전 교고 두 아드리 인제 주으니고 이래쓸 쫌 이꼬한 삼대어 사는데 옌날 그 옏 내려온 얘기가 심년 응 그 부자 그 내려가먼 잘 내러간다 그런데 삼대 내려가써 삼대	그런데 그 양반이 인제 그 아들이 전 교고 두 아들이 인제  이랬을 좀있고 한 삼대 사는데 옛날 그 옛 내려온 얘기가 십 년 응 그 부자 그 내려가면 잘 내려간다그런데 삼대 내려갔어 삼대
삼대를 내가고 거에 고조 고소니 나까드뇨 고손까지	삼대를 내려가고 거기에 고조 고손이났거든요 고손까지
고손	고손
고소니 멈니까	고손이 뭡니까
고손고손	아 고손고손
고손 아들 손자 징손 고손까지 낟 난 터이라고 그래 그런데 그 그부니 호짜준짜 양바니 인제정서네 인제 그 그 서울 가게보러 댕기고 이럴쩌게 아무 그리 조아도 서울 댕기면서 초시해떼 초시	고손 아들 손자 증손 고손까지 난 터라고 그래 그런데 그 그분이 호 자 준 자 양반이인제 정선에 인제 그 그 서울 가게 보러 다니고 이럴 적에 아무리 그렇게 좋아도 서울 다니면서초시했데 초시
초시는 딱 그 치를 바꼬 마란는데 그래도 인제 강능에 댕기면서 거게 인제 추리파고 댕기는데 거가 전 장구니라고 내 한 분 이써 전 장군	초시는 딱 그 치를 받고 말았는데 그래도 인제강릉에 다니면서 거기에 인제 출입하고 다니는데 거기에 전 장군이라고 한 분 있어 전 장군 전 장구닌데 그 전장구느는 여겓 이 어깨 미테 샐 참새이짜나 전 장군인데 그 전장구는 여기 이 어깨 밑에 새 참새 있잖아
참새 새 나래처럼 보닝기 여 터기 저 짤벌쩨 나떼 이거 양짜게	참새 새 날개처럼 보니까여 털이 저  났데 이거 양쪽에
그래서 저 쪼기 저 요 요 압싼 저기야	그래서 저쪽이 저 요 요 앞산 저기야
아빼이로 아뼝사니 나꺼드뇨	앞 쪽에 앞병산이 났거든요
욜 가성인데 아뼝사네 거기가서 나라가께찌	여기 가장자리인데 앞병산에 거기가서 날아 갔겠지
거기가서 그 장수 무를 머꼬 히물 내가지고 장사해떼	거기가서 그 장수 물을 먹고 힘을 내가지고 장사했데
그 새니미	그 새님이
새님	새님
재니미라 하지 인제	재님이라 하지 인제
장 장수 장수래도 인제 기운만 씨지 도는 업꺼든	장수 장수래도 인제 기운만 세지 돈은없거든
그래니까 그거 인제 일뚜 해주미서 장수 노르탄다 이기여	그러니까 그거 인제 일도 해주면서장수 노릇한다 이거야
그래 호짜 준짜에 하는 하라버지가 강능에 인제 장보러 간다 이기여	그래 호 자 준 자에 하는 할아버지가 강릉에 인제 장 보러 간다 이거야
강능에 강능 인제 하루치 인제 일 쫄까 하머는 이 사라미 그 이튼날 걸 가따 이기여	강릉에 강릉 인제 하루치 일을 하며는 이 사람이 그 이튿날 거기를 갔다 이거야
그리면 그 새니미이 사라마 자네 우째 이루 완는가 지베 이를 안 하고 이러니	그러면그 새님이이 사람아 자네 어떻게 이리로 왔는가 집에 일을 안 하고 이렇니
근데 샌니미 누군가요	근데 새님이 누군가요
새니미 바로 호짜 준짜 이 양바니조	새님이 바로 호 자 준 자 이 양반이죠
아아 이르믈 그 다르게 부르니 샌니미라고 부른건가요	아아 이름을 그 다르게 부른 것이 샌님이라고 부른건가요
응 그럼	응 그럼
옌나레 그레 불러꺼드뇨	옛날에 그렇게 불렀거든요
그러니까 제가 장도 보고 떠기 보고 소앋 아실갈	그러니까 제가 장도 보고 떡이 보고 아십니까
그러케 얘기하니까드루 금 떠글 머께	그렇게 얘기하니까 그럼 떡을 먹게
그래 떠글 그러니까두루 그 시방 모 보통 장에 가머는 마넌 이마넌 머거봐야 안 되게꺼든	그래 떡을 그러니까 그 지금 뭐 보통 장에 가면 만 원 이만 원 먹어봐야 안 되겠거든
그래 큰 말 떠글 딱 주무는 그 사라미 그 전 장구니 그걸 머꼬는 인제 또 지부로 온다 이기여	그래 큰 말떡을 딱 주며는 그 사람이 그 전 장군이 그걸 먹고는 인제 또 집으로 온다이거야
그래이머는 새님 너는 마를 타고 가니까 하루 가고 두 말 가다 자 자고 이려고 쉬지마는 이장 전 장구는 추끼레 강거야	그러면 새님 너는 마를 타고 가니까 하루 가고 두 말 가다 자고이러고 쉬지마는 이 전 장군은 축지해서 간거야
축찌에서	아 축지에서
또 주찌에서 하무는 후카먼 저 훙 나라가고 훙 날라가고 거 또 찌불하는데 꿩 두찌머 와보먼지베 와꺼든	또 축지해서 하며는 훅 하면 저 훅 날라가고 훅 날라가고 거 또 하는데  와보면 집에 왔거든
그날 하루는 땡 그 전 장 전 장구니 가마니 생가카니까드루 중 그 어디 가래 바꼴 중니미라고 이따요	그날 하루는 땡 그 전 장군이 가만히 생각하니까 중 그 어디 가래 밭골 중님이라고 있어요
왜 그때는 얘기가 시방 스 스니미라 하는데 가래 버꼴 중니미라고 해따고 중늠	왜 그때는얘기가 지금 스 스님이라 하는데 가래 밭골 중님이라고 했다고 중늠
가 가래 받	가 가래 밭
바꼴 중늠 중느미 우무카거드뇨	밭골 중늠 중늠이 우묵하거든요
우무캐 그래한다고	우묵해 그래한다고
중느미라고	중늠이라고
중니미라고 또 그래해따고	중님이라고 또 그렇게 했다고
그래 그때 중이 하도 어데 어데 준시 그 전 장군하고 씨름하로 온다는거여	그래 그때 중이하도 어디 어디  그 전 장군하고 씨름하러 온다는 거야
그래 전 장구니 가장 생가하니까드루 자기 키 자기가 장구느로써 드는 걸 몰 궤 두드리는 거는 기운 쎄지마는 마닐 불또로 하는 기술 하는 건 모타게꺼든	그래 전 장군이 가장 생각하니까 자기 자기가 장군으로써 드는 거 뭘 궤 두드리는 거는 기운 세지마는 만일 불도로 하는 기술하는 건 못하겠거든
불또 기술료	불도 기술요
응 고케 하는 그거슨 머시 중 한테는 스님한테는 모타게쓰니까 이 사라미 꾀를 내따구 장구니	응 그렇게 하는 그것은 중 한테는 스님 한테는 못 하겠으니까 이 사람이 꾀를 냈다구장군이 네 네
마당에 나가가지고 마당 마당에 나가주고 큰 돌 돌리쪼 통 통똘	마당에 나가가가지고 마당마당에 나가가지고 큰 돌돌 있죠 통 통돌 돌 큰 늠 아주 아른 돌미를 망치를 가지고 똑또또또독 깨서 그래 자꾸 손때를 올려 소늘 인제 반들반들 만드러돌 큰 놈 아주 알은 돌맹이를 망치를 가지고 똑또또또독 깨서 그래 자꾸 손때를 올려 손을 인제 반들반들 만들어
네 네	네 네
그래노코는 아무나 온다는 거 즉 그 전 장구니 지 집까비 생가기 나거든	그래 놓고는 아무나 온다는 거 즉 그 전 장군이 집값이 생각이 나거든
아이 그 내일 하먼 어딜 갈보꼬 중이 나하구 씨름하러 올꺼다	아이 그 내일 하면 어딜 갈보꼬 중이 나하고 씨름하러 올거다
생가글 하구는 젤 새니믈 보고 제 노려이 이쓰니 오늘 저는 어딜 좀 가야 되게씀니다	생각을 하고는  새님을 보고 제 요령이 있으니 오늘 저는 어디를 좀 가야 되겠습니다
왜 가래 바꼴 중이 씨름하러 옴니다	왜 가래 밭골 중이 씨름하러 옵니다
저하구 저 전 장구니라고 씨름하러 오며는 새님께서 우리 장구는 어디로 가따	저하고 저 전장군이라고 씨름하러 오며는 새님께서 우리 장구는 어디로 갔다
오늘 볼릴 보러 가따	오늘 볼일 보러 갔다
이래카시고 뭐하러 완냐 이러케 무러 보시고 그래먼 멀 할껴미다 그래써	이렇게 하시고 뭐하러 왔냐 이렇게 물어 보시고 그러면 뭘 할 겁니다 그랬어
그래 인제 장구는 가삐리고 인제 중이 그 이튼날 와따	그래 인제 장군은 가버리고 인제 중이 그 이튿날 왔다
언제 오니 그르 무르니까 전제 저 새님 하는 말쓰미 그리문 우리 장구는 어디 간는데 우째 오써씀니까	언제 오니 그렇게 물으니까 전제 저 새님 하는 말씀이 그러면 우리 장군은 어디 갔는데 어떻게 오셨습니까
아이 장구니 아이 기우니 쫌 그래가 내가 어디 가 씨름 한 번 겨루러 와씀미다	아이 장군이아이 기운이 쫌 그래서 내가 어디 가 씨름 한 번 겨루러 왔습니다
아이구 말두 마시오	아이구 말도 마시오
우리 전 장군 지금 씨 씨름 해바야 모따 한 테이니까 그냥 가시오	우리 전 장군 지금 씨름해 봐야 못할 테니까 그냥 가시오
그냥 가라니까드루기 안 되게꺼든	그냥 가라니까 안 되겠거든
그 보고 가야 한 번 보고 가야 된다고	그 보고 가야 한 번 보고 가야 된다고
그 보나마나 우리 장군 솜씨를 볼람미까	그 보나마나 우리 장군 솜씨를 볼랍니까
저 마당에 큰 동똘 저걸 마리여 우리 전 장구니 탁 드러다가 광주에 치뜨린다 이기야 확	저 마당에 큰 동돌 저걸 마리야 우리 전 장군이 탁 들어다가 광주에 치뜨린다 이거야 확
공처럼 확 치뜨러가지고서는 굴러와서 탁 때려 방는다 이기여	공처럼 확 치뜨러가지고서는 굴러와서 탁 때려 박는다 이거야
이제 해데가두씨리	이제
가마니 보니까드룯 중이 가마니 보니 그 씨니미거든 장구니	가만이 보니까 중이 가만이보니 그 스님이거든 장군이
가서 동 또러 가섣 딜라보니 땅띰두 안 하거든	가서 동 돌에 가서 들어보니 땅띰도 안 하거든
땅띰 안 한다 땅띰	땅띰 안 한다 땅띰
땅띠미라 이 이	땅띰이라 이 이
따 띰또 안 한다고요	아 땅띰도 안 한다고요
응 응 아난다 안 헌다 또리	응 응 안 한다 안 한다 돌이
땅에도 이게 안 떠러진다	땅에도 이게 안 떨어진다
안 떠러지지 이게 이찌	안 떠러지지 이게 있지
그 땅뜨미 네 그랟 그래	그 땅뜨미 네 그래 그래
네 땅뜸 네	아 네 땅뜸 네
그래서 손때 걸러 반드르 보다 하는코 보니깐드루 실쩨룬이거 그말 증말 전 짱구니 시뜨라지 안 콜 굴려보다 아니 먼저 이걸 빨리 가야지	그래서 손때 걸러 반드르 하는 거 보니깐 실제론이거 정말 전 장군이  안 굴려보다 아니 먼저 이걸 빨리 가야지
클나게꺼든	큰일 나겠거든
그 나두구 가따 이기여	그거 놔두고 갔다 이거야
간는덷 또 며칠때까드루 중이 가서 가마니 생가켜다 쏘거꺼든	갔는데 또 몇 일 되니까 중이가서 가만이 생각하다 속았거든
그때 동항며네 이레 큰 광무를 피 치띠리려문 치 이륻 확 치뜨린다 하더료 골로 방는다는 거는 고리 깨지두 이꼬 그기 택쏘쭈 일컨두 여 공갈로 쏘거따는 거 알거든	그때 동학면에 이렇게 큰 광무를 치띠리려면 이렇게 확 치뜨린다 하거든 골로 박는다는 거는 골이 깨지기도 하고그게   공갈로 속았다는 거 알거든
장구니 그러고 가쓰니까중이 가마니 생가카니까드로이걷 아무래도 안 되게꺼든	장군이 그렇게 하고 갔으니까중이 가만이 생각하니까이거 아무래도 안 되겠거든
다시 또 인제 다음날 또 와따 여 여기를	다시 또 인제 다음날 또 왔다 여 여기를
와가지고 그 다음 장구늘 만나따 이기여	와가지고 그 다음 장군을 만났다 이거야
완는데 장구니 와서 쪼차 쪼께 갈 쑤도 업꼬 너 왜 완느냐	왔느데 장군이 와서 좇아 좇겨 갈수도 없고 너 왜 왔느냐
나 또 씨름 좀 하러 와따고요	나 또 씨름 좀 하러 왔다고요
그럼 해보자	그럼 해 보자
그래 그 나두고 요기 올러가먼 요게 한 일 한 한 사 한 유칠뱅 메다 가먼 여 이써요 여게	그래 그 놔두고 여기 올라가면 여기에 한 일 한 한 사 한 육 칠백 미터 가면 여기에 이써요 여기에
큰 싱냥 구리가요	큰 식량 굴이가요
이 이런 구리따고요	이 이런 굴 있다고요
네 구리요	네 굴이요
응 구리 인는데 거게 보먼 이걷 뼈에 뺑때라 이써 뺑때	응 굴이 있는데 거기에 보면 이거 뼝에 뺑대라 있어 뺑대
뼝때아세요 뼝때	뼝대아세요 뼝대
네네 뼝때 그 아주 볃 이게 볼 돌 이러케 노푼 벼락 뼝때	네네 뼝대 그 아주 이게 볼돌 이렇게 높은 벼락 뼝대 예
그건 뼝때라 한다고 옌날 우리 과거에 뼝때	그건 뼝대라 한다고 옛날 우리 과거에 뼝대
요즈문 벼랑인데 뼝때라고 하조 뼝때	요즘은 벼랑인데 뼝대라고 하죠 뼝대
그래 인젣 걸르쓰 씨름 쫌 하다 가서 그 중이 전 장구늘 보고서는 저 꼭때기에 가서 함 네뛔 봐라	그래 인제 걸려서 씨름 쫌 하다 가서 그 중이 전 장군을 보고서는 저 꼭대기에 가서한 번 너 뛰어 봐라
나러 내 와봐라	내려와 봐라
장구니 머 머 내려봐라 이카두루 응 껄 가게따 이기야	장군이 뭐 뭐 내려와 봐라 이렇게 하니까 응 거기를 가겠다 이거야
그러고서 나중에 메짜썽 무거	그러고서 나중에 몇 자씩 먹어
부굴 둥 둥 데니까 그니까 장구거튼 그래 하주화  하준 하게꺼든	북을 둥둥 데니까 그렇니까 장구 같은 그래 하주화 하준 하겠거든
부굴 둥 둥 확 쩡말 내러오니 이 내러오는데 아이 너는 중이 마리얃 창 창 찌를 창 이쪼대창	북을 둥둥  확 정말 내려오니 이 내려 오는데 아이 너는 중이 말이야 창 창 찌를 창 있죠 대창 차을 가지고 장구늘 확 낭내로 치니깐뇨 창을 가지고 장군을 확  치니깐요
그름 저 자불라고 한줄 알지요	그럼 저 잡을라고 한 줄 알지요
그래요이 장구니 시물 쪼끔 내도 훌쩍 나라서는 저 쪼그로 나라꺼던	그래 장군이 힘을 조금 내도 훌쩍 날아서는 저 쪽으로 날았거든
날개가 이쓰니까 나라서 그래 모짜바따 이기여 중이	날개가 있으니까 날아서 그래 못 잡았다 이거야 중이
이제 그래 그래드니 이제 장구니 또 뭐이라하냐머는 야 나는	이제 그래 그랬더니 이제 장군이 또 뭐라고 하냐면 야 나는
근데 왜 주기 주길려고 그래써요	근데 왜 죽이 죽일려고 그랬어요
옌나레는 씨 씨 기우니 씨고 이래머는 그	아 옛날에는 기운이 쎄고 이러면 그
주길라고	아 죽일라고
그러초 옌나렌 인전 뭐 이 장구니라고 그러면 서로가 까마비로 그 그 그래꺼드뇨	그렇죠옛날엔 인제 뭐 이 장군이라고 그러면 서로가 까마비로 그 그랬거든요
그리니까 그저 그러니까 그러니 이노므 중이 가마니 생가커니까 장구늘 모 짜버꺼든	그러니까그저 그러니까 그러니 이놈의 중이 가만이 생각하니까 장군을 못 잡아거든
그러초 이 인제 클라꺼든	그렇지요 이 인제 큰일 났거든
저 봉종타기 나는 나는 내러와쓰니까 너도 너 중늠 놈 중늠 너도 마리요 나도 내러온다 이기여	저 봉종탁이 나는 나는 내려왔으니까 너도 너 중놈 중놈 너도 말이요 나도 내려온다 이거야
이 저 씨름 절금 저게 저거메기니까 기술 저겐니 저금하니까 기술로	이 저 씨름 절금 저게 저거 메기니까 기술 저게 저금하니까 기술로
절그미 뭠미까	절금이 뭡니까
어우로 노 이케	어울러 놔 이렇게
서로 절금하는거요	아 서로 절금하는 거요
쫌 저금하는 걸 그걸 절그미라 한다고	쫌 저금하는 걸 그걸 절금이라 한다고
그 씨름 저그미지	그 씨름 저금이지
씨름 저금 네	아 씨름 저금 네
그래 인제 올라가요 인제	그래 인제 올라가요 인제
미테는 참 부굴 둥둥 치니까드루 이늠 중이 안 드러 올 쑤 이짜네요	밑에는 참 북을 둥둥 치니까 이놈 중이 안 들어 올 수 있자나요
네네	네네
그 주떼럳 인저 내 때들 꺼 아니요	그 죽 대드러 인제 내 때릴 거 아니요
훙 나라 내러오는데 그 쌔를 고만 모시 전 장구니 그 대창 대창 이짜네	훅 날아 내러 오는데 그 새를 그만 전 장군이 그 대창 대창 있잖아
대드러서 콱 찌르니 주구무는 지팍 치지를 건드롣 장구는 후 떠가져 가는데 이늠 모시기는중은 나는 갈 쑤 업짜네	대드러서 콱 찌르니 죽으면 집 밖   장군은 훅 떠가져 가는데이놈 뭐시기는 중은 나는 갈 수 없잖아
요 탁 찔체가지고 요지를 자버따고	요 탁 질러가지고 요지를 잡었다고
자버가주고 바로 귿 중에 시 시 사체 사체조	잡어 가지고 바로 그 중의 시 시 사체 사체죠
사체를 가따가 어데 무더주고 그 진녕꾸리라 이써요	사체를 가져다가 어디 묻어주고 그 진녕굴이라 있어요
어느 굴	어 어느 굴
지 진장굴 천장굴	진장굴 천장굴
천장굴 네	아 천장굴 네
천장구레 그 가둔다가 지버너서 거기서 그 써거 중이 썽는데 그 뻬가 뻬가 우리 내가 우리가봐따고	천장굴에 그 가둔다가 집어 넣어거기서 썩어 중이 썩는데 그 뼈가 뼈가 우리 내가 우리가 봤다고
시바는 엄는데 우리가 한 삼십 쌀 될 쩌게 고 아넫 토 토닥 비둘기가 걷 가 자요	지금은 없는데 우리가 한 삼십 살 될 적에 고 안에 토 토닥 비둘기가 거기 가 자요
지부로	집으로
비둘기가요	아 비둘기가요
그럼 우리가 청년시저레 이 소까주굴 부쳐 가지고 거 비둘기 자부러 가무는	그럼 우리가 청년 시절에 이 소까지를 부쳐 가지고 거기에 비둘기 잡으러 가며는
솔깝 소까불 부쳐따고요	솔갑 솔갑을 부쳤다고요
소 소 소까지 소까지	소 소 소까지 소까지
소까지 자바서요예	아 소까지 잡아서요예 예
소까지 뿌리라는 건 부쳐가지고 소나무 속 뿌리파서 부쳐가지 건디 거 이러먼 자넫 이럭 삐러박따망거	소까지 뿌리라는 건 부쳐가지고 소나무 속 뿌리 파서 부쳐가지고 거 이러면  이러케 박다만거
뼈가 이써써요	어 뼈가 있었어요
응 그럼 그럼 그럼	응 그럼 그럼 그럼
근디 요즘 모 그냥 사는지 모른두 그래서 하늘 천짜 천자이거든	근데 요즘 뭐 그냥 사는지몰라도 그래서 하늘 천 자 천 자 이거든
장사진는 거 장사 짜 그래 그래서 천장구리요	장사 진는 거 장사 자 그래 그래서 천장굴이요
구리 그루 크게 인는데 그 이르미 천장구리라구	굴이 그렇게 크게 있는데 그 이름이 천장굴이라고
그 유래가 한 역싸가 그루 되우	그 유래가 한 역사가 그렇게 되우
그래 그 장군 그 장구는 대략 뽀면 무래요 무	그래 그 장군 그 장군은 대략 보면 무래요 무
장게를 안 가 안 가짜네 장가를 머 장군 장군찝 장군짐 장군 뭘 하다 보니까 장가를 몯 까따구유	장가를 안 가 안 갔잖아 장가를 뭐 장군 장군집 장군집 장군 뭘 하다 보니까 장가를 못갔다고요
그럼 무허고 제 지끔 제가 늘거짜뇨	그럼 무하고 제 지금 제가 늙었잖아요
무 무	무 무
아드리 업쓰니까 뭐 어들껴	아들이 없으니까 뭐 얻을꺼야
무 무 업쓸 무짜무가 되짜뇨	무무 없을 무 자무가 됐잖아요
그래서 장구느 묘가 저 이씀니다 저 우리 요게	그래서 장군의 묘가 저기에 있습니다 저 우리 요기에
그래요	아 그래요
시방도 가 보먼 인는데 옌나레 크게 젠는데 그 무거써요	지금도 가 보면 있는데 옛날에 크게 지었는데 그 묵었어요
요러구 치먼 소리 망 나거든 이러케 타구	이렇게 치면 소리가 막 나거든 이렇게 타구
그래 유래가 그런 이 이 동네 유래 유래라구 그게	그래 유래가 그런 이 이 동네 유래 유래라고 그게
그런게 이써요	아 그런게 있어요
으이 이 미테 쩌기 요 암 미테 터에 전씨드리 울리는 터이 지끔 고 고향 호짜 준짜하나 아드리 소 손자가 칠형제가 실무자 칠학짜 실무자란 모이미 이러구서 일고비 다 살림사리 괜찬탄 얘기고 학짜라는 거는 그리 세 일곱 싸람 다 칠형제가 다 그리 조탄 얘기요	으이 이 밑에 저기요 앞 밑에 터에 전씨들이 울리는 터가 지금 고 고향 호 자 준 자 하나 아들이 소 손자가 칠형제가 실무자 칠학자 실무자란 뭐냐면 이러고서 일곱이 다 살림살이 괜찮단 얘기고 학자라는 거는 글이 일곱 사람 다 칠형제가 다 글이 좋다는 얘기요
그러케 전 전 전씨드리 오래 살다가 오댄마네 떠 떠나가따구	그렇게 전 전 전씨들이 오래 살다가 오 대 만에 떠 떠나갔다고
서울로 막 떠나가버려찌 그 저네가 전씨들 드러 가지고 또 고만 그 또 마하고 또 전씨가드러가 마하구이루 그 털 지버 떠비여따고	서울로 막 떠나가버렸지 그 전에가 전씨들 들어 가지고 또 고만 그 또 뭐 하고 또 전씨가 들어가 뭐 하고 이래 그 터를 집어 떠비였다고   그 인자 아푸로 그 이직 후세에 인짇 여기 나오꺼요 그 인제 앞으로 그 이직 후세에 인제 여기에 나올거요
그런데 그 터이 뭐냐먼 이 뒤에 일본 싸람드리 옌나렌 그 연하부수형국 고 아페 찌리 도로가나는데 일본 싸람드리 도로를 구찍 전 저늘 끄너따구	그런데 그 터가 뭐냐면 이 뒤에 일본 사람들이 옛날에 그 연화부수형국 고 앞에 길이 도로가 나는데 일본 사람들이 도로를 구직 전 전을 끊었다고
멀 끄너요	뭘 끊어요
주 주룡 주룡	주 주룡 주룡
주룡은 뭐에요	주룡은 뭐에요
주룡이요 직 직 사늘 산 이겨 싼데논 이 읻 제 용주를 주룡이라 함니다	주룡이요 직 직 산을산 이겨 싼데 놓은 이 제 용주를 주룡이라 합니다
직때 옹주를	직때 옹주를
주룡 주룡 주룡 주룡	주룡 주룡 주룡 주룡
주룡이라고 쓰나요	주룡이라고 쓰나요
그 한짠가요	그 한짜인가요
주룡이라군 쩌 이 쩌 이 저 용 용짜는 용 용짜를 쓰지 주룡이 주룡이 이레 타나 내려 타내려 온다능거	아 주룡이란거는 저 이 저 이 저 용 용자는 용 용 자를 쓰지 주룡이 주룡이 이렇게 타나 내려 타 내려 온다는거
산 산세에서	산 산세에서
아주룡이라는 그 불근 용이 내려온다고요	아 주룡이라는 그 붉은 용이 내려온다고요
그러치 그러요	그렇지 그래요
그래 요 요 요 그런 유래는 머 이거는 유래가 현재 지금 내려오는 유래 유래가 아니 한 삼뱅년 이백오심 년 고 고 새에 내려오는 머 역싸란 역 역싸라고 볼 쑤 이쓸까	그래 요 요 요 그런유래는 뭐 이거는 유래가 현재 지금 내려오는 유래 유래가 아니 한 삼백 년 이백 오십 년 고 고사이에 내려오는 뭐 역사란 역사라고 볼 수 있을까
네네 아	네네 아
요 그리구 또 요 고령터 이써요 고령터	여기 그리고 또 여기에 고령터 있어요 고령터
고래 고래장	고려 고려장
고래장터	아 고려장터
칠씨베 고래하는 고래장터	칠십에 고래하는 고래장터
요 이따구 지금	여기 있다고 지금그래요그래요
그거는 응 꼰 고려장 고려 고려 때 해께찌 그런데 시방 거 터 이따구 터이	그거는 고려장 고려 고려 때 했겠지 그런데 지금 거기에 터가 있다고 터가
그래요	아 그래요
지금도 이러케 이러케 해난 터 이따구	지금도 이렇게 이렇게 해 놓은 터 있다고
고려장 이거 우리 마으레	고려장 이거 우리 마을에
고런 고런 전서리 또 인네요	그런 그런 전설이 또 있네요
혹씨 고렁 거 말고 또 아시능 거 이쓰세요	혹시 그런 거 말고 또 아시는 거 있으세요
이 쪼게	이 쪽에
그래 아께 그 여나부수형구기라구 그거이 참 얘기껀데 그래 그래니까드루 인제 그 연하부수형구근 모냐하머는 아께 그 전 전씨들 귿 장 전장구니 거기 나고	그래 아까 그 연화부수형국이라고 그거 참 얘기인데 그래 그러니까 인제 그 연화부수형국은 뭐냐면 이까 그 전 전씨들 장전장군이 거기에서 나고
고 난 터가 네 연하부수형국	거기 난 터가 네 연화부수형국
고마니 연하부수인데 그건 그건 도승이가	연화부수인데 그건 그건 도승이가
누가요	누가요
도 도승이	도 도승이
도승이	도승이 도승이 그래 도승이가 거저건 잘 아는데 여겐 여겓 그지불 지꾸 터글 자부며는 삼나메 이르믈 날리게따 도승이 그래 도승이가 거저거는 잘 아는데 여기에는 여기에 그집을 짓고 터를 잡으며는 삼남에 이름을 날리겠다
그래건두 시미에는 남 따는 안 바꼬 씽 도라가메 동서남부그론 자기 소유를 가제꼬 삼나메이름 날려도 이 이레 정선 땅에 귿 서울 댕기며 광야를 보러 댕기게따 그 얘기여	그래 그건 시미에는 남 땅은 안 받고 씽 돌아 가며 동서남북으론 자기 소유를 가져 지었고 삼남에 이름 날려도 이 정선 땅에 서울 다니며 광야를 보러 다니겠다 그 얘기야
삼나문 어디 정도에	아 삼남은 어디 정도에
삼나문 인제 말하자머는 그읻 여기 지여 카고 고다으메 머 위읻 머 읻 서울 가며는 이 제 제처느로 해나가던 그러차네요	삼남은 인제 말하자면 그 여기 지역 하고 그 다음에 뭐 위 뭐 이서울 가며는 이 제 제천으로 해 나가던 그러찮아요
형서불 해 나가던지 깜 꺼 가 이름 날리면 서울가 날리고 삼나메 겓 군데군데 이름 날리게따	형섭을 해 나가던지 감 거기 가서 이름 날리면 서울 가 날리고 삼남에 군데군데 이름 날리겠다
그럼 귿 그래가주 거게서 치럭짜 칠부자가 나고 그래서 연하부수형구기라 해서 그 이러케 내가는데 고다메 뜰 뻠짜 꼬 톼짜 하다가 인제 호며니라고 인제 중도가 제꼬 그래가지고 저 지금 저 여게 내다 봄 우리 경로당이찌요	그럼 그 그래가지고 거기에서 칠억자 칠부자가 나고 그래서 연화부수형국이라 해서 그 이렇게 내 가는데 그 다음에 뜰 범짜 꽃 화짜 하다가 인제 호면이라고 인제 중도가 지었고 그래가지고 저 지금 저 여기에 내려다 보면 우리 경로당 있지요
저긴 여놔당임니다 여놔당	저긴 연화당입니다 연화당
저걸 내가 제써요	저걸 내가 지었어요
아녜	아네
옌 나레 그 심양 올라가먼 이 쪼그로 응어리집 또 이기 연꼬치 요레 하나며니 가이짜네요	옛날에 그 심양 올라가면 이 쪽으로 응어리집 또 여기 연꽃이 이렇게 하나 면이 가 있잖아요
연꼬치 연꼬치 무레 떠 이쓰니까 무레 연꼬또 무레 이찌 따 읍짜네요	연꽃이 연꽃이 물에떠 있으니까 물에 연꽃도 물에 있지 땅에 없자나요
그 써 연꼬치 모세 인는데 연모세 인는데 연꼬치 하 항 개가 인능게 아니라 이기여	그 연꽃이 못에 있는데 연못세 있는데 연꽃이 한 개가 있는게 아니라 이거야 킁 거 이꼬 두 개 이쓸 꺼 아니요 큰 거 있고 두 개 있을 거 아니요
그래 큰 부자찝 터에 한 제일 킁기고 요 올러오먼 해 요거또 존소가 이 엳 연꼳 모 모 모  야이래요 요러케	그래 큰 부자집 터에 제일 큰 거고 여기 올라오면 해 이것도 존소가 이 연꽃모양이래요 이렇게
그런디 그래서 저거 저걸 요 여놔 부수형구기라고 그걸 내가 내가 제써그래	그런데 그래서저거 저걸 연화 부수형국이라고 그걸 내가 내가 지었어그래
아그러쿠나	아 그렇구나
어르신 요 가까운 지여게 보니까 그 여긴 호처닌데 저 저 오다 보니까 모르는 데도 이꼬 소금강도 이짜나요	어르신 여기 가까운 지역에 보니까 그 여긴 호천인데 저 저 오다 보니까 모르는 데도 있고 소금강도 있잖아요
그런 쪼게서 내려 온 전설가튼 건 엄나요	그런 쪽에서 내려 온 전설 같은 건 없나요
거게 모루니라는 거는 그 몰 모짜 구름 구름 운짜 구르미 모 모여 대긴다고 해서 거겐 모루니라구 으 그러케 개명을 핸줄 알고	거기에 몰운이라는 거는 그 몰 모 자 구름 구름 운 자구름이 모 모여 다닌다고 해서 거긴 몰운이라고 그렇게 개명을 했는 줄 알고
고 다으메 그구르미건 한치 한치 미치 바로 소금강 이꺼드뇨	그 다음에 그 구름이건 한치한치 밑이 바로 소금강 있거든요
소금강 문짜 그대로 여 금강산 아니래 금강산	소금강 문자 그대로 여기 금강산 아니래 금강산
그 그르 내려가먼 그 그림바우래요 그림바우	그 그쪽으로 내려가면 그 그림 바위래요 그림바위
면 소재지까지 그림바우라고 내려가면 그림바우	면 소재지까지 그림바위라고 내려가면 그림바위
바우가	바위가
바우가 그림처럼 생겨짜네요	바위가 그림처럼 생겼잖아요
그러쵸 아주 예쁘고 조쵸	그렇죠 아주 예쁘고 좋죠
응 그러니까 그림바우	응 그러니까 그림바위
그래서 거 화아미래요	그래서 거기가 화암이래요
그림 화짜 바우 암 짜 그래서 거 화암며니다	그림 화 자 바위 암 자 그래서 거기가 화암면이다
그래요	아 그래요
화아미고 그래서 화아미고 동면 화아민데 장녀네 장녀네 와서 똥며늘 역싸에의 이 이르믈 까무데고 화믈 해따고	화암이고 그래서 화암이고 동면 화암인데 작년에 작년에 와서 동면을 역사의 이름을 까무데고 화암을 했다고
그래 존속 우레가 나는 반대해씨요	그래 존속 우리가 나는 반대했어요
반댈로 이 모읻 왼손 존속 반대 하다가 뭐 강능 이장드리 머 그따고 그러는데 요 읻 화아미라는거는 그림 화 짜 으 으 바우 암 짜 그림 그린 그림 그링 거 처럼 생겨따하냐 행 그걸 동며니라 써 노면 안 되잔냐 얘기야	반대를 이 뭐 왼손 존속 반대 하다가 뭐 강릉 이장들이 뭐 그랬다고 그러는데 여기 이 화암이라는 거는 그림 화 자 바위 암 자 그림 그린 그림 그린 것 처럼 생겼다해서 한 그걸 동면이라 써 놓으면 안 되잖냐 얘기야
그래서 그래서 그 소굼 소굼강이 그 내려가면 금강산처럼 이러케 바우가 잘 생겨짜네요	그래서 그래서 그 소금 소금 강이 그 내려가면 금강산처럼 이렇게 바위가 잘 생겼잖아요
그래 그 소굼 그 물거니라지 물 그 물 쪽 끄 끄래 저 읻 소굼강이라고 소긍 거 소굼강	그래그 소금 그 물건이라지 물 그 물 쪽 그 그래 저 이 소금강이라고 소금 거 소금강
그래 소금강이라 하지	그래 소금강이라 하지
네잘 드러씀니다	네잘 들었습니다
