dialect	standard
어르신 이 마 이 마으레 대해서 쫌 이야기를 해 주십씨요	어르신 이 마을이 마을에 대해서 좀 이야기를 해 주십시오
이 마으리 언제 형성이 데어꼬 어떠케 형성이 데에꼬 그 다음메주로어떤 성씨드리 사시는지 이 마을 유래에 대해서 함 번	이 마을이 언제 형성이 되었고 어떻게 형성이 되었고 그 다음에주로 어떤 성씨들이 사시는지 이 마을유래에 대해서 한 번
삼뱅 년 저니이께네아 지금부터 그몀 면 녀이롱 이천시빌 려네 삼뱅 녀느얼빼먼 데잔냐	삼백 년 전이니까 지금부터 그러면 몇 년이냐 이천십일 년에서 삼백년을 빼면 되잖아
한 은 삼뱅 년 삼뱅 년 전도 이퍙은 한 삼뱅 년 정거 데께려 동네게 생에에헤 여어께 에헥 그르코 여 동네 사는 사람드런 추 주로 인제 으성 깅가드리 여게 인제 우 와 가주고 이 이퍙한 제가 삼뱅 녀이라 그능 게고요	한 어삼백 년 삼백 년 정도 입향은 한 삼백 년 정도 될거야 동네가 생긴여기가어 그렇고 여기 동네 사는 사람들은 주 주로 인제 의성 김가들이 여기에 이제 와와 가지고 입향 입향한 지가 삼백 년이라 그러는 것이고요
그아문 지굼 한 삼배 이퍙한 지가 한 삼뱅 년 데션는데 그암며너 처음 이마으레 인제 의성 김씨 하라버지께서 이리로 오셔쓸 꺼 아님미까	그러면 지금한 삼백 입향한 지가 한 삼백 년 되셨는데 그러면은 처음 이 마을에 인제 의성 김씨 할아버지께서 이리로 오셨을 것 아닙니까
이퍙하실 때 어어 어디서 오션는지 혹씨 아심미까	입향하실 때어디에서 오셨는지 혹시 아십니까
크게 상주서 와쩨	그게 상주에서 왔지
상주 상주서 그어 상주서 그르익 개암 할배미 여어 처뻔 두오시찌 안나	상주 상주에서 거기 상주에서 그러니 개암 할아버지께서 여기에 첫 번째로 들어오셨지 않나
후래 그엄믄 저으아 저게 저 어르이 파론 할배밈 미리 오시꾸나	후야그러면 저 저기 저 어른이 팔오헌이며 년에 개암선생의 현세손으로 태어나서 년에 운명했다 자는 덕휴이며 호가 팔오헌이며 벼슬은 부제학에 이르렀다 자연부락 이름이 바래미인 이 마을을 개척한 인물이  다 할아버지께서 미리 오셨구나
그으또 아이고 그믄 누구로	어 그것도 아니고 그러면 누구냐
그업 그 어느 하럴버이 어느 할배라고예	그 그 어느 할아버지 어느 할아버지라고요
개암	개암
개아암 호를 호를 익	아 개암호를 호를 이제
개암 할뱀	개암 할아버지
개 짜 암 짜 이르케	개 자 암 자 이렇게
예 예아	예예
암개 짜르 므승 개 짜를 써씀미거	암개 자는 무슨 개 자를 썼습니까
거릉 개 짜	시내 계 자
아 에 그렁 거 그렁 게 짜 바이 암 짜	아예 시내 시 시내 계자 바위 암 자
바우 암 짜	바위 암 자
개암	개암
개암 스생님께서 인제 이리로 처음 이퍙하션는지 앙 그아믄 더 위때 오션는지느 정화카진 안치마넌	개암 선생님께서 인제 이리로 처음 입향하셨는지 안 그러면 더 윗대에서 오셨는지는 정확하지는 않지만은
어역 정왁 찬체이으그	예 정확하지 않지요
고 고 다으메능 꼬어 파로언 할뱀 안 아임 두 분 중에 드옹 그넌 아매 미리옹 거는 개암 할배미 미리 옹 거 거튼데 그걸러	그 그 다음에는 그팔오헌할아버지 아니면 아니면 두 분 중에 들어온 것은 아마 미리 온 것은 계암 할아버지께서 미리 오신 것 같은데 그것을
그래서 이퍙하러 이퍙하신 어르신께스너 어째뜬 개암 하라버지시나 어이거나 앙 그러며넘 파론 하라버지 두우 뿐 중에 함 부니시다 그제	그래서 입향하러 입향하신 어르신께서는 어쨌든 개암 할아버지이시거나 아니거나 안 그러면은 팔오헌 할아버지 두 분 중에 한 분이시다 그렇지요
예에	예
파 어더익 그업 개암 하라브지에 대해서 함분 마 어이 아시는 데로 함번 이야기해 주실 쑤 이씀미까	팔 어떻게 그 개암 할아버지에 대해서 한 번 말아시는 대로 한 번 이야기해 주실 수 있습니까
인지 개암 선생이음선조가 여게	예 인제 개암 선생님께서선조가 여기에
열 개 짜에다가바이 암 짜임	열 개 자에다가바위 암 자입니까
아이 아이래여 이 양바안 겨 마자이 열 개 짜래 열 개 짜이와 바우 암 짜래	아니 아니에요 이 양반 그래 맞아요 열 개 자야 열 개 자에 바위 암자야
열 개 짜 바으 만 짜고	열 개 자 바위 암 자고
그레 이 양바니 여게 인데	그래 이 양반이 여게 인제
개암 그아므 개암 쓰앵님께서 인제 일로 오 이퍙을 하실꺼나 앙 그암파론 쓰앵님 하싱 검미까	예 개암 그러면 개암 선생님께서 인제 이리로 오셔서입향을 하셨거나 안 그러면 팔오헌 선생님께서 하신 겁니까
이퍙 에 응 선조넘 파롼 선조고요 에 개암공은 그르 인제 에 이 끼 개암공어 현소니에 이 양바니	입향 선조는 에팔오헌 선조고요 에 개암공은 그래인제 이 그 개암공의 현손이야 이 양반이
파루오니	팔오헌이
기 에 개암 할배므유 현소니 파로언 선새인데 거어서 여어겐 인젱 이퍙 선조로 데 인네 여가	개개암 할아버지의 현손이 팔오헌 선생인데 거기에서 여기가 인제입향 선조로 되어 있네 여기가
이퍙 선조로 데 이꼬	입향 선조로 되어 있고
파로언 스애임께서 인제 스애잉께서 이리로 입 이퍙을 하셔 가주고 지웅 그암며너 여기에입	팔오헌 선생님께서 인제 선생님께서 이리로 입향 입향을 하셔 가지고 지금 그러면은 여기에입향
예예 예	예예예 예
그르이 파로오느니 인제 으이 개아므 현소니고 휘 짜는 선 짜 구 짜라 구누여 이그 그 파로옴뿐 아이래 에 에뜨 그 저 휘는 소리 성 짜 고리 구 짜라꼬데에스 성구라꼬 데 이써에 곤	그러니 팔오헌이 인제개암의 현손이고 휘 자는 성 자 구 자라고 그러고 이것 그 팔오헌 뿐만 아니라어 그 저 휘는소리 성 자 오랠 구자라고 되어서 성구라고 되어 있어여 고것은
소리 성 짜	소리 성 자
바로옹파로	팔오헌팔오헌
소리 성 짜 무승 구 짜예	소리 성 자 무슨 구 자인가요
옹 오리 구 짜용	옛 오랠 구 자요
오래 구 짜	아 오랠 구 자
으야 야 오 오리 오리 구 짜요	예오랠 오랠 오랠 구 자요
파로어는 호고 이 여느 인제흐 휘 짜는 성 짜 구 짜시고 그 호가파러오이구 그래요	팔오헌은 호고 이 여기는 인제휘 휘 자는 성 자 구 자이시고 그 호가 팔오헌이고 그래요
지금 그럼며너 인제 파러온 스애잉께서 은자 이 마을 이 마을 이르미 바래밈미까 해즈	지금 그러면은 인제 팔오헌 선생님께서 인제 이 마을 이 마을 이름이 바래미입니까 해저리
바라미 에 이 그 바라미	바라미 에 이 그 바라미
바 에 짐며	바라미 에 지명
옌날 치명으로는 속칭 브르기는 바라미라 그고 또 여우 관명으로는 관청에서 부릉 언 해저리라 그고	옛날 지명으로는 속칭 부르기는 바라미라 그러고 또여기 관명으로는 관청에서 부르는 것은 해저리라 그러고
해저리예	해저리요
바다 해 짜 저 저어 짜	바다 해 자 밑 저 자
그르이 그래 부르니더	그러니 그래 부릅니다
거며 인제 업 파로언 스애잉께서 은제 여기 이퍄을 하셔 가지고한 삼뱅 년쯔은 야 삼뱅 년 저네 이퍙을 하셔 가주곧 의성 인저 김씨 김문들리 인제집썽촌임미까	그러면 인제 팔오헌 선생님께서 인제 여기 입향을 하셔 가지고 어한 삼백 년쯤 약 삼백 년 전에 입향을 하셔 가지고 의성 인제 김씨 김씨문들이 인제 집성촌입니까
그러치 이퍙하셔찌	그렇지 입향하셨지
메이 집성초니지 그케요	예 집성촌이지 그러게요
지궁 그럼며너 여기에 그거 사시늠 분드너 의성 김씨들 웨에는 다름 분드러업씀미까	지금 그러면은 여기에 그것 사시는 분들은 의성 김씨들 외에는 다른 분들은 없습니까
웨요 이찌용	왜요 있지요
마네여 인지 저거 이 지 옌나레는	많아요 인제 저것 이 저 옛날에는
지 지금믕 그 당시는 쪼꿈 저끼 사럳찓 지그므롭 바서는 우성 깅가들보다타성에어 어응 으 더 만타끄 바에 시방은뇨	지금 지금은 그 당시는 조금 적게살았지 지금으로 봐서는 의성 김가들보다 타성이으 더 많다고 봐요 시방은요
우리 깅가드른 모도 대구 부산 서울 마이 나가 사고 근데 현제 여읻 쩌이집뜨러 거 크 큰 집뜨른 깅가드리 즈 이에이 지비라 할 쩨라등 나미 사는 지비더 마네 시방용	우리 김가들은 모두 대구 부산 서울 많이 나가서 살고 그런데현재 여기 저 집들은 그 큰 큰 집들은 김가들이 저 이 집이라 할 지라도 남이 사는집이 더 많아요 시방은요
실쩨이 그래 데 이꼬요 거우 머 우우 구 지비 비 이씨께 남 주고 사고	실제로는 그래 돼 있고요 그 뭐그 집이 비어 있으니까 남에게 주고 살고
끄래 현제로 바서는 여 한 배 칸 이시 포저 이 저네 반는데 요샌 에읍백이시 포도 쪼끄머 이기 이 여리요	그래 현재로 봐서는 여기 한 백 한 이십 호 어저 이 전에는 봤는데 요새는백이십 호도 조금 이게 이 여려요
배기시 포도 여린 내에서 우 깅으 우릭 깅가들 사능 게 오시비 안 데 께래용	백이십 호도 여기 내에서 우리 김가 우리 김가들 사는 게 오십이 안 될 거에요
한 사십 정도 보고 저 사암들 한은 한 오시 폰 게음 마즈 꺼 테이 지그므로바 가주언녀	한 사십 정도 보고 저 사람들 한 한 오십 호 보면 맞을 것 같아요지금으로 봐 가지고는요
사는 호수 수짜로 바 가즈어넌	사는 호수 숫자로 봐 가지고는
끄엄며는 지금 어째뜬 처음 이프 이 마을 시작뗑 그너 아까 파로언 스애앵께서 먼저 어여 의성김무네서 인제 파로언 스애앵께서 이 마으를 개처글 하셔꼬 그 다으메 집성초느로 쭝 뉴지데다가 이제 타성바지들도 께 드롸 가지우 산다 그지예	그러면은 지금 어쨌든 처음 입향 이 마을이 시작된 것은 아까 팔오헌선생님께서 먼저 의성 의성김씨문에서 인제 팔오헌 선생님께서 이 마을을 개척을 하셨고 그다음에 집성촌으로 쭉 유지되다가 이제 타성바지들도 꽤 들어와 가지고산다 그렇지요
끄르서 그러믄 찌굼 한 타성바지드른 주로 어떤 사암들 머 그 머 드롸가 이씀미까	그래서 그러면 지금 한 타성바지들은 주로 어떤 사람들 뭐 그 뭐 들어와서 있습니까
각성이든 찌웅 각성이래 이에읻 지금 바서너 농사지은 타성들또 농사진는사라민 한 메 단 데곧 주버 인데 머 장터어 가서 장사도 하고 운전도 하는 사람들 먿 주로 인제 그래에 사고 이찌 머에 지금 바서는	각성이든 지금 각성이야 이 지금 봐서는 농사짓는 타성들도 농사짓는 사람은 한 몇 안 되고 주로 인제뭐 장터에 가서 장사도 하고 운전도 하는 사람들 뭐 주로 인제 그래 살고 있지 뭐요 지금 봐서는
으베서 가까우니까웨지으 타성바지드리 드롸서 마니 산다 그지에	아 읍에서 가까우니까외지의 타성바지들이 들어와서 많이 산다 그렇지요
그러면 지금 인저으 어르싱 그엄며너 이 한 해방 전후나 이때엔 쯔엄메넌 해방 저누나 유기오 전후 때는 여기 집성처 집 완전 집성초니여씀미까	그러면 지금 인제 어르신 그러면은 이 한 해방 전후나 이때쯤에는 해방 전후나 육이오 전후때는 여기 집성촌 집성 완전 집성촌이었습까
글때능 끄어 거이가 멛 칩 메 찝 써께 사라찌히	그때는 거기 거의가 몇집 몇 집 섞여 살았지
타성드리 사러도 주루 깅가드리 마이 사러쩨요	타성들이 살아도 주로 김가들이 많이 살았지요
유기오 사변 전후 해 가지오넌	육이오 사변 전후를 해 가지고는
그럼며너 어째뜬 지금머 타성바지드리 제범 마니 사는 그런 마으리다 그지예	그러면은 어쨌든 지금은 타성바지들이 제법 많이 사는 그런 마을이다 그렇지요
그러쳐 마자 마이 사능 마이 살제 그으거	그렇지요 맞아요 많이 사는 많이살지 그것
어째뜨 그래도 머 어째뜬 요즘 다른 마으레 비해스너의성 김씨드리 마니 모이서 사는 집성초니라 할 순 읻슬 정도로 마니 사시능 그 까씀미다	어쨌든그래도 뭐 어쨌든 요즘 다른 마을에 비해서는의성 김씨들이 많이 오여서 사는 집성촌이라 할 수 있을 정도로 많이 사시는 것 같습니다
그르체요 응 그르체머 타동네 대믄 마이 사제	그렇지요 응 그렇지음 뭐 타동네 대면 많이 살지
어르싱 그럼며넌 이 마을 이르메 대해서 함분 머 아시는 대로 혹시 함분 이야기해 주실 쑤 이쓰므 이야기해 주십씨오	어르신 그러면은 이 마을 이름에 대해서 한 번 뭐 아시는 대로 혹시 한 번 이야기해 주실 수 있으면 이야기해 주십시오
웨 받 웨 바라미가 데엔지 또넙 머 해저가 데엔지 그거 함번 이야기해 주실 수 이쓰미 함분 아시는 대로 함번	왜 바라미 왜 바라미가 되었는지 또는뭐 해저리가 되었는지 그것을 한 번 이야기해 주실 수 있으면 한 번 아시는 대로한 번
그게 설명하기가안 난흐 어리푼시 드릉 게 떼 가주 마리야 퍽 에룹뜨라꼬	그게 설명하기가 나는 어렴풋이 들은 것이 돼 가지고 말이야 퍽 어렵더라고
옌나레 여어가 머 바라미라 그능 게 마리제아 그으 은네 게 효 확씰 차네도옌나레 어데 여그 멉파라라 그러 가주고 머 파라 미치 머 뻥어바라미라그르따 소리도 나안데 므 파라라 그능 걸 어델 가주오 파라라 그능 거	옛날에여기가 뭐 바라미라 그러는 게 말이지요 그그 확 확실하지 않아도 옛날에 어디 여기 뭐용두레라그래 가지고 뭐 용두레 밑이 뭐어 바라미라 그랬다는 소리도 나왔는데 뭐 용두레라 그러는 것을 어디를 가지고 용두레라 그런 것인지
파래 미치는 파래 미츠넌 바다 미치이께네 바라미라 그러꼬 그래 지인느 꺼 테요	아 파도 밑은 파도 밑은 바다 밑이니까 바라미라 그랬고 그래 지었는 것 같아요
끄 바 바다 해 짜 해서 머 바다 해 짜 하고 저 엄 미 쩌 짜 써 가주	그 바다 바다 해 자 해서 뭐 바다 해 자 하고 저밑 저 자 써 가지고
미 쩌 짜해저다 그래여	밑 저 자해저리다 그래요
파다그 멈미까	파다가 무엇입니까
저 무럴 이래 대에 노코옴 무리 이비 이쓰먼 여게 무로 우로 퍼 올리능 게래	저 물을 이래 대 놓고 물이 있 있으면 여기에 물을 위로 퍼 올리는 거야
이그래 퍼 올리 가주아이그 그걸	이래 퍼 올려 가지고 그것을
보 퍼 올레 물 푸어능 기구	보 퍼 올려 물 퍼는 기구
므 엉 그 마자 그으래여	뭐그 맞아 그거에요
물 펴능 기구 마자 빠아 파라아 그애능 게	물 퍼는 기구 맞아 용두레 용두레라 그러는 게
그엄머 그게 그업 몸미 물 푸능 기구 그읍 파닥 그어는 마언등 게 오래뒈에씀미까	그러면 그게 그 뭡니까 물 퍼는 기구 그 용두레 그것은 만든 게 오래됐습니까
이 예저 이 이 그래 매엄	어 이 예전 이 이 그렇게 만든
오래데찌 거게엄	오래됐지 그것이
여게 그게 나온다 여 파로온 하파로온 할배미 여게 마리지 이퍙한지가 언제냐 하게 데먼 에 이 경진년 천칠뱅 녀네 여게 동리임 이퍙을 하시꾸만 녀게	아 여기에 그게 나온다 여기 팔오헌 할아버지팔오헌 할아버지께서 여기에 말이지 입향한 지가 언제냐 하게 되면 에 이 경진년 천칠백 년에 여기에 동리에 입향을 하셨구만 여기에
천칠뱅 써이	천칠백이라고 써 있으니
끄어며 쩌어기 이 동리에 혹시 머 주위에 드리 널븐데들 말고 이 산도 야트마칸 산드리 쪼옴 인는데 혹시 산 이름메 대해서 사 알고 게신 산 이르메 대애서 함분 이야기 쫌 함 해 주이소	그러면 저기 이 동리에 혹시 뭐 주위에들이 넓은데들 말고 이 산도 야트막한 산들이 조금 있는데 혹시 산 이름에 대해서 산 알고 계신 산 이름에 대해서 한 번 이야기 좀 한 번 해 주십시오
여 우리 바래므 저 저 보인느 저 사니 바로 학쩡봉이러 그래임비덩	여기우리 바래미 저기 저 보이는 저 산이 바로 학정봉이라 그럽니다
저 학쩡봉을 웨 학쩡보이라 그인머이 저 사늘 보 꺼 트음마 하기 나라가느 형상이래야	저 학정봉을 왜 학정봉이라 그러냐 하면 저 산을 볼 것 같으면 학이 날  아가는 형상이에요
사니 저언 이이 저게 보마 하기 나라간는 사니라 그래 가주고 여이 이동네그에에에엠 아페 사늘 학쩡보이라꼬 그래불러꼬	아 산이 저 이 저기보면 학이 날아가는 산이라 그래 가지고 여기 이 동네 앞에 산을 학정봉이라고 그래음 불렀고
또 저어짜게 저게 보움 쩌 시내 아페 저짜아 또 둥그러여 추 저건누 호골사니라 그으러 호골산	또 저쪽에 저기 보면 저 시내 앞에 저쪽에 또 둥그런 저저것은 호골산이라 그래 호골산
끄르 호골사니라 그능 거는 뜨선 모르게써	그래 호골산이라 그런 것은 뜻은모르겠어
옌나레 저 범두리가 머 호평이라 그른데 범 호 짜가 드르 가주 즈 저걸 호구사니라꼬 지이따 소리도 이꼬 므 그커 그른 소리도 나온데 그게 화실치는아네어우우	옛날에 저 범들이 뭐 호평이라 그러는데 범 호 자가 들어 가지고저 저것을 호골산이라고 지었다는 소리도 있고 뭐 그 그런 소리도 나오는데 그게확실하지는 않아요
으 이 그 그르코 응 으 그 그게배께 머 사네 대항 건는 응 거 벨룸 멍	어이 그 그렇고 응그 그것밖에 뭐 산에 대한 것은 응 그 별로 뭐
산 사늠 머 한두 가지 두 개바께 업씀미까 이 근처에는	산 산은 뭐 한두 가지 두 개밖에 없습니까 이 근처에는
에혜예	예예
감태보이라 그능 거또저 감태봉은 맹 응 맹 학쩡보 산줄기이께네 끄언	감태봉이라 그러는 것도저 감태봉은 역시 응 역시 학정봉 산줄기니까 거기는
그어느 머 감태봉어 웨 감태봉임미까	거기는 뭐 감태봉은 왜 감태봉입니까
그기 옌나레 그으 으 끄 그 사네 대해 가지으우 읻 저 유래가 그미은 저 양밤 말뜨나 그 인제 그으 감투럴 마이 해따 그래 가주 감투보이라 큰다꼬도 어아 보늠 모애이세이 그래이	그게 옛날에 그그 그 산에 대해 가지고 이저 유래라 그러면 저 양반 말마따나 그 인제 그 감투를 많이 했다 그래 가지고 감태봉이라 그런다고도아 보는 모양일세 그래 예
거염 하저 학짱봉이 이꼬 호골사니 이꼬	그러면 학저 학정봉이있고 호골산이 있고
사니 이꼬	산이 있고
그다이미 감투봉 이꼬	그 다음에 감태봉 있고
고다임미 머 엉 이 감투봉이고	그 다음에 뭐이 감태봉이고
에머 다름 머 사으넉 크게 사니 그르케 여기너	어뭐 다른 뭐 산은 크게 산이 그렇게 여기는
업찌 머여	없지 뭐요
으 드리 널브서 잘 업쩐	어 들이 넓어서 잘 없지요
어이 어이예	예예예
혹시 골짜기 골짜기에 대해서 머 아심면 머 여 이 동네 골짜기 이르메 대  해서 인는 대로 함 이야기해 주십쑈	혹시 골짜기 골짜기에 대해서 뭐 아시면 뭐여기 이 동네 골짜기 이름에 대해서 있는 대로 한 번 이야기해 주십시오
요 디 꼬오릉 바로 드간느 산수꼬르어 그으고 은 저짜아 드가능 건능 건 머응어 신시꼬르에 글고 저 우에 가서느 모꼬리라 그으공 윽 그래 부른데 귿뜨슨 모르게썽언	요기 뒷 골에 바로 들어간 곳은 산수골이라고 그러고저쪽으로 들어간 것은 뭐신시골이라고 그러고 저 위에 가서는 못골이라 그러고 어그렇게 부르는데 그 뜻은 모르겠어
먼 띠므 그런지	음 뭐 때문에 그러는지
사 산시꼬리여	산 산수골이요
산수꼬염	어 산수골
산수꼬리르 산수꼬엠	산수골이야 산수골
웨으 산수꼬른 머 웨 그런지름 모르은다 그지에	왜 산수골은 뭐 왜 그런지는 모른다 그렇지요
모르제 그케용	모르지 그러게요
그다으미 산수꼬 리꼬 그다엠 모꼴 리꼬	그 다음에 산수골이 있고 그 다음에 못골이 있고
모꼬 리꽁	못골 있고
모꼴도 뜨슨 잘 모름미까	못골도 뜻은 잘 모릅니까
웨 모꼬린지	왜 못골인지
그르쩨으에 그에 지금도 모선 이이써써 거게가 모꼬 저 모꼬레아	그렇지어 그 지금도 못은 있어 거기에 못 저 못골에
요래 쩌 그 머 물 땔라끄 노네 물 때앤 내애 머 어어 즈 인저 쪼끄머 인제그이 이쓰께쩨	요래 저 그 뭐 물 대려고 논에 물을 대 내는 뭐저 인제 조그만 인제 그게 있었겠지
또 여게는 디 그르코	또 여기는 저 그렇고
여 산수꼬른 근 믄 자시 모르게써 그 사네서 무리 난다구 산수꼬라 그르 짠나구 나는 생가깐데 귿 뜨슨 확씨리 모르게써에	여기 산수골은 그것은 뭐 자세히모르겠어 그 산에서 물이 나온다고 산수골이라 그랬지 않나 하고 나는 생각하는데그 뜻은 확실히 모르겠어요
그다엠 모 모꼴레늠 모시 예저넫 이스꺼 지음도 조그만항 게 이꼬 그다음메 여쭈어 산수꼬리고 그담 저쭈게 신시꼴 그래쓰미	그 다음 못 못골에는 못이예전에 있었고 지금도 조그만한 게 있고 그 다음에 요쪽에 산수골이고 그 다음 저쪽에 신시골 그랬습니까
신시꼴 씨에이 시내그 신시골	어 신시골 신 신 신시골
그거는 자시 모르게써 금 무 웨 신시꼬러 그은지	그것은 자세히 모르겠어그 뭐 왜 신시골이라 그랬는지
자시 모르게써여 그 뜨선 모르게따꼬	자세히 모르겠어요 그 뜻은 모르겠다고
여게느 그름 표시기 이쓰이께네 이으 저으도 무리 나이게 산수꼬리고 저짜아늠 모시 이께느 모꼬래 그르따욱 보는데 현재도 그언 이쓰이께네	여기는 그런 표식이 있으니까 이 저기에도 물이 나니까 산수골이고 저쪽에는 못이 있으니까못골이라 그랬다고 보는데 현재도 그것은 있으니까
그릉꺼 어째뜬 점부 골짜기너 주로 그런 머 디 꼬홀모꼴 산수꼴	그러니까 어쨌든 전부 골짜기는 주로 그런 뭐 뒷 골못골 산수골
산수꼴 시내시꼴	산수골 신시골
신시꼴	신시골
평꼴	신시골 예
이을 세 개가 이꼬 머 또 다릉 꼴짜기는 잘 업씀미까	이렇게 세 개가 있고뭐 또 다른 골짜기는 잘 없습니까
업써 다릉 골싸기 그 머 어데 다는 몰씨더 그	없어 다른 골짜기 그 뭐 어디 다는 모르겠습니다 그
사니 그르케 만치가 아너서	산이 그렇게 많지가 않아서
예아	예
그러며 혹씨 여기 들강은 강에으 강은 여기 쫌 이씀미까	그러면 혹시여기 들강은 강 강은 여기 좀 있습니까
강에이 아이래 여 내성천 거랑이지 머예	강이 아니라 여기 내성천 개울이지 뭐요
내성처네서 나오능 거이기 이게 흘러 가주고 저 예천 아프로 저리 간데 이게 내성처니러 강이라 그진 난내 여 내성천 또라이라 그르지	내성천에서나오는 것이 이게 흘러 가지고 저 예천 앞으로 저리 가는데 이게 내성천이라 강이라 그러지는 안 안 해 여기 내성천 도랑이라 그러지
그어므 여기 지옴 봉화 읍내 아프로 흐르능 큰 이게	그러면 여기 지금 봉화읍내 앞으로 흐르는 큰 이게
내성처니지요	내성천이지요
내성처니고 그다으메 혹씨 이내성처느로 흘러 드르가는 조옴만한 그랑이나 이렁 건 업씀미까	내성천이고 그다음에 혹시 이내성천으로 흘러 들어가는 조그만한 개울이나 이런 것은 없습니까
여어서 나어능 게 저 정꼴써 나오능 게 쪼매항 게 이 이 이 아프르도 내리가능 게 쪼매낭 건 이써도우 그건느 이르미 업짜네 그건능	여기에서 나오는 게저 정골에서 나오는 게 조그마한 게 이 이 이 앞으로도 내려가는 게 조그마한 것은 있어도 그것은 이름이 없잖아 그것은
그르지 기냥 거라이라 그르지 머요	그렇지 그냥 개울이라 그러지 뭐요
매병처니러 글기드 하구 머으 그른데응엥으 연 우리 동네 어이 그 거압 또라이라 그기도 하고 그래 응에 근	매봉천이라 그러기도 하고 뭐 그런데예여기는 우리 동네그 그 앞 도랑이라 그러기도 하고 그래그
절루 아프로 가니까 압 또랑이라구  그지에	아 저리로 앞으로 가니까앞 도랑이라고  그렇지요
예 이이예	예예예
압 아페 스네 압 또랑을 마니	압 앞에 있으니 앞 도랑을 많이
그 어디 그으그너 어디서 흘러나온다고에	그 어디 그것은 어디에서 흘러나온다고요
매봉사네서 나와 매봉	매봉산에서 나와 매봉산
매봉사네서	매봉산에서
매봉사는 아업 어디 멈	매봉산은어디 멉니까
무량	물야면
아이래이 여 맹 봉화군 무랴며니	아니야 여기 역시 봉화군 물야면
며니 다르당게 쪼끄믕 고 등을 너머가믄 무랴며니데 거계서 수우니 내리온다 그래 가주우 인제 그 매벵처네서 나온다 그렁에	면이 다른데 조그마한 그 산등을 넘어가면 물야면인데 거기에서 수원이 내려온다 그래 가지고 인제 그 매봉천에서나온다 그러는 거야
끄암 매병처니고 끄다음메쪼움 저네 어르싱께서 이야기하시기로너 정꼬레서 흘러나온다 핸더이 정고른 어뎀미까	그러면 매봉천이고 그다음에조금전에 어르신께서 이야기하시기로는 정골에서 흘러나온다고 했는데 정골은 어딥니까
정꼬르아 그능 그느 인제 매뵹산 바로 여핀데 그 동네 옌나레 거 이딩 머에 거 거에 즈 쯔겓 쯔읻 저릉 걸 머 그락또 맨드고 마엗 므얼 꾸움몸 매이라	정골이라 그러는 것은 인제 매봉산 바로 옆인데 그 동네에서 옛날에 그 이 뭐 어그 그 저 저 저 저런 것을 뭐 그릇도 만들고 말이야 무엇을 구웠는 모양이야
끄으 정꼬리러 그른 므네	그래서 정골이라 그런 모양이야
옹기도 꾸우꼬 머 이릉 걸 꾸우 가주 인제 그 동네얼 정꼴 동네라 그르따꼬 얘기하고	옹기도 굽고 뭐 이런 것을 구워 가지고 인제 그 동네를 정골 동네라그랬다고 말하고
그 인제 월리느 인제 에으 그어서 매병천하꼬 그 동네학 함몽 내려오능 무리래	그 인제 원리는 인제그 매봉천하고 그 동네하고 한목에 내려오는 물이야
그아므 그 정꼬리라능 고시 에어 거기 어디 동네 이르미다 그지야	아 그러면 그 정골이라는 곳이거기 어디 동네 이름이다 그렇지요
동네 이르미래염	예 동네 이름이에요
동네 이르미래여	동네 이름이에요
그 해저삼니라 그으기도 하고 그래임 머에	그 해저삼리라 그러기도 하고 그래요 뭐요
해저삼니고	아 해저삼리고
예아	예
해저이리도 그람 이씀미까	해저이리도 그러면 있습니까
이리인 여얻 어으 소라 나베 기 역쩐 아페	이리는 여기솔안 앞에그 역 앞에
여 가페가 거 그 퍼게 인제 해저이리고 여어가 일리고 그래로	역 앞에 거기그 그게 인제 해저이리고 여기가 일리고 그래로
그업 검 해저 지움 해저이어 거 혀에 행정명으로너 행정 이르므로	그 그러면 해저 지금 해저 그 행 행정명으로는 행정 이름으로는
해저일 리 삼니야이	해저일리 해저이리 해저삼리에요
해저일 리 삼니래여	해저일리 해저이리 해저삼리에요
이 쯔 요우게 그아므 해저일리넘 바라미고	이 저 요기 그러면 해저일리는 바라미고
바라미공	바라미고
그더음메 해저이리는 머러라고 부름	그 다음에 해저이리는 뭐라고 부릅니까
소라니라 그애찌 소르	솔안이라 그랬지 솔안
소라	솔안
역쩐 아페 소란	예 역 앞에 솔안
소라는 웨 소란닌지	솔안은 왜 솔안인지
이 솔뚱저니 이따 그래 가주우 소라니라 그르따 그래드라고예	이 소나무가있다고 그래 가지고 솔안이라 그랬다 그러더라고요
무스 무스은녜	무슨 무슨요
소리 소낭기 시머노응 게 마리장겨 아뻬 드 라뻬 거 요새 거이 여기 생기뿌레 가주우 그르채이 그어 소리 서 이써써요	솔이 소나무 심어놓은 게 말이야앞에 들 앞에 거기 요새 거기에 역이 생겨 버려 가지고 그렇지 거기에 소나무가 서있었어요
그래 소라니러 그르따 그래이띠더	그래서 솔안이라고 그랬다고 그러다라고요
그아믄 솔 그 소나무를 시르 나앋 소나무거 시르머 나으니가 소나무 안쪼기라 해서 소란닝고	그러면 솔 그 소나무를 심어 놓은 소나무를 심어 놓았으니까소나무 안쪽이라 해서 솔안이고
으에 소란소란 동네러 그으꼬이	예 솔안솔안 동네라고 그러고
소란 동네라 하고	솔안 동네라 하고
그다음 해저삼니느 아까 이야기핻따시피 고	그 다음 해저삼리는 아까 이야기했다시피 그
정꼬리이 그아지	예 정골이라 그러지
정꼬리고	정골이고
이 찡에 지 정꼬리고	예 이 정 저 정골이고
끄암 찌움 해 행정명으로너일따느 해저일리 바라미고 해저이리가 소라미고 그다음 해저삼니가	그러면 지금 행 행정명으로는일단은 해저일리가 바라미고 해저이리가 솔안이고 그 다음 해저삼리가
으 정꼬리고	어 정골이고
처 정꼬리우 그르타 그지예	정 정골이고 그렇다 그렇지요
그러며너 인제 그 어르신 여기에 혹씨 그거 저수지 가틍 거느 쫌 이씀미까	그러면은 인제 그 어르신 여기에 혹시 그것 저수지 같은 것은 좀 있습니까
이이 여게는 저수지가 엄니더	이 여기에는 저수지가 없습니다
그어 좀 이 이서따	아 거기 좀 이 있었다
그 요샌 업써저 뿌레쓰이께네 그을제	그 요새는 없어져 버렸으니까 그렇지
항 개도 업쪄 뿔쩌유	한 개도  없어져 버렸어요
다 그어 바치 데 뿌구 노니 데 뿌구	다 거기가 밭이 돼 버리고 논이 돼 버리고
녜 예저네 어으 저수지 이선능 그	예 예전에저수지가 있었던 그
야이	예 예
함 저즈 어떵	하면 저수지가 어떤
녜쪼맨해써 저이 참	예조그마했어 저기 참
이름	아 이름 예
이르미 그 머라 그르짜	이름이 그 뭐라 그랬지
모시라 그르째	못이라 그랬지
아헨뜽모시라 그르짜나 그 옌나레	아현댁못이라 그랬잖아 그 옛날에
아현띠기라꼬 태코럴 떠 가주고 그 저수지 땅기 이 그 집 땅이래 가주곰 아현뜩모시라 그르따꼬 떼겨 거어가	아현댁이라고 택호를 따 가지고 그 저수지땅이 이 그 집 땅이여 가지고 아현댁못이라 그랬다고 거기 거기가
모 짜리러	못 자리를
아현땍끼랑응 거 분 태코너 무슨 어디	아현댁이라는 그 분 택호는 무슨 어디
태코가 아현띠이래	택호가 아현댁이야
아현띠기	아현댁
아현뜩	예 아현댁
아현느 어디 짐명밈미까	아현은 어디 지명입니까
땅 이르밈	땅 이름입니까
지명이게께찌오	지명이겠지요
어딛 어딛	어디 어디
아혀니 크흐 크게 잉 그 지명엔는에이 자시 몰래야	아현이 그 그게 이 그 지명은 자세히 몰라요
자시 모른 아현	자세히 모르고 아현
하이튼 아현 아현띠기모시다 그지에	하여튼 아현 아현댁못이다 그렇지요
이예예	예예
아에 그으 거 집주이늘 타 가주	어 그 그 집주인의 택호를 따 가지고
은자 이 그 그래 그 그 집 응으 그 집 소유기 때무레 고맘 아현뜩으흠모시라그러콩	이제 이 그 그래 그 집그 집 소유이기 때문에 그만 아현댁못이라 그랬고
지그믐 어째뜬 모슴푸 업따 그지에	지금은 어쨌든 못은 없다 그렇지요
녜아 지그믄 쩜 페지 다 뎅으 농토로 변해 쁘래꼬	예 지금은 전부 폐지가다 되고 농토로 변해 버렸고
그러면 혹씨 여기에 그어 들판넌이름 부르은 드얼를 이럼먼아시는 대루 함모 이야기해 주십쑈	그러면 혹시 여기에 그 들판은이름 부르는 들이름은아시는 대로 한 번 이야기해 주십시오
더리 인제 요오로 말할 껀 조 우에 가무은 개떠바골더리아 그고요 어그어 잉	예 들이 인제 요기로 말할 것 같으면 저 위에 가면 개따박골이라고 그러고요그 이
므슴 바	무슨 바
개따바꼴료	개따박골이요
해저삼니드리여 그르꼬 개따바꼬	해저삼리들이 그렇고 개따박골
조 우에 쁘까뜽 소란 아뻬 거 이 저 왕도이드리러 그으고 거우 왕도이드으래 그으고 요 미테 너러우므 장성거리드리라 그으공 이 그래 인제 세 가지을 표현해 가주 새암머	저 위에 가면 솔안 앞에 그 이 저 왕동이들이라고 그러고 그왕동이들이라 그러고 요 밑에 내려오면 장승거리들이라 그러고 이 그래 인제 세가지로 표현해 가지고 사용을
그엄므여 거 개빠딱개빧따꼴 그래씀미까	그러면 그 개따박개따박골 그랬습니까
개따바꼴	개따박골
아어 개따바꼴 가틍 경우너 우 웨 개따바꼬리라고 해쓰므그	아 개따박골 같은 경우는왜 개따박골이라고 했습니까
그게 그게 이르믈겨 부처 가주우 머 잉 기양 인 항 겜 모인데 머으 그속칭명으로 특수한 말헌은 자시 몰래여 그게	그게 그게 이름을그 붙여 가지고 뭐 이 그냥 이 한 것인 모양인데 뭐 그 속칭으로 특수한 말은 자세히 몰라요그게
그엄 개따바꼴드리 이꼬 그다임 머 장승꼴	어 그러면 개따박골들이있고 그 다음에 뭐 장승거리들
장승거리드른 요게 저 소란 아피로 소란 으이 역 아프로 이리 내로이 이 더리고	장승거리들은 요기 저 솔안 앞으로 솔안 이 역 앞으로 이리 내려오는이 들이고
조 무떼 솔뚱천 요거 너머가믄 조 우에 감 장승거리드 요 학짱봉 미테 드리또 이써 고게 장성거리뜨리 논니 논나꼬 바찌 그 드레 거	저 밑에 솔뚱천 요것 넘어가면 저 위에 가면 장승거리들 요 학정봉 밑에 들이 또 있어 거기에 장승거리들이 논이 논하고 밭이 그들에 거기
그 장성거리돌 그어느들팡 그거는 웨 장성거릳들파니	그 장승거리들그것은들판 그것은 왜 장성거리들이
장서이랑 게 그 어데 옌나레 이릉 거 머 장성을 그 어데 서와 나아떵 으으으머시래 가주오	장승이라는 게 그 어디 옛날에 이른 것 뭐 장승을 그 어디 세워놨던무엇이라 가지고
망 네앙 마저 그래으 그래 태캔너므 거테요 장성거리라등 게	맞 네 맞아그래 그래 택한 것 같아요 장승거리라던 게
낭글 까꺼 서웅 거 이릉 게 이차나여 크어케	나무를 깎아 세운 것 이런 게있잖아요 그렇게
마자 장성거리아 그래꾸나	맞아 장승거리라 그랬구나
거이가 장성거리다 그지야	거기가 장승거리다 그렇지요
장성거리 거 더리공	예 장승거리 그 들이고
그다임 장성거릳뜨 고 아페 장성거리가 이서쓰니까 장성거리드리고	그 다음 장승거리들 그 앞에 장성거리가 있었으니까 장승거리들이고
녜드리고	예들이고
그다으메 아까 뚜 하나늠 머라고 하셔씀미까	그 다음에 아까 또 하나는 뭐라고 하셨습니까
저 왕디이뜰	저 왕동이들
와예 왕디이뜨르 웨 왕디이뜨	예 왕동이들은 왜 왕동이들
왕도이라 그능 그 동미는 느기 여어서으기 교수니미 말항 거고 왕디이라 그능 걸 끄 속칭이 우 웨 부쳔노 하는 소린데 글 자시 모르게따고 그 웨 웨 부처언지	왕동이라 그러는 그 동민은 이게 여기에서 교수님이 말한 것이고 왕동이라 그러는 것을 그 속칭이 왜 왜 붙였느냐 하는 소리인데 그것을 자세히 모르겠다고 그 왜 왜 붙였는지
멍 왕이 이써 가주 왕도이들또 안 데스 께고 근 머 어데 구마 옌날브어뜽 그래 왕디이라 그능 게 어데 그마 속칭 기양 내루옹 거 거태이	뭐 왕이 있어 가지고 왕동이들도 안 됐을 것이고 그 뭐 어디 그만 옛날부터 그렇게 왕동이라 그러는 게 어디 그만 속칭으로 그냥 내려온 것 같아요
금 머 금 머 와 특쑤한 명칭은 어꼬요 그꺼 구 왕딛더르아 이야기 역쩐아뻬 이 드어를 가주 말하고 요 우에 개따바구요 저언 장성거리더리 요 세 드어를 요겍 끼고 사라써 요에	그 뭐 그 뭐 왜 특수한 명칭은 없고요 그그그 왕동이들이라 이야기 역 앞에 이 들을 가지고 말하고 요 위에 개따박골 저기는 장승거리들 요 세 들을 요기에서는 끼고 살았어요 요기에
거 왕드이뜰르리아 함미까	거기를 왕디이들이라 합니까
왕디이뜨리라 함미까 앙 그아므 왕동이뜨리라 함미까	왕디이들이라 합니까 안 그러면 왕동이들이라 합니까
왕동이뜰	왕동이들
왕도이라 그그 속칭 부루기느 왕디이뜨어리라 거후 꺼 엄 마 우 부루기 시운 대르 원치기 말해우 왕도이더리래	왕동이라 그그 속칭으로 부르기는 왕디이들이라 그러고 그뭐부르기 쉬운 대로 원칙으로 말하면 왕동이들이야
이 저 동네가 왕도이라 그그더요	이 저 동네가 왕동이라 그러거든요
왕도이께네어 왕도이 아페 떠리이께네우 왕도이떠레 그능 게 만니덩	왕동이니까 왕동이 앞에 들이니까 왕동이들이라고 그러는 것이 맞아요
그 그은데 여기도 저 해저리라고 잘 암 부르고 사암드른 바라미라고 마니부르지예	그 그런데 여기도 저 해저리라고 잘 안 부르고 사람들은 바라미라고많이 부르지요
바라미	예 바라미 예
바라밉 마이 부을뜨시 거기도 거 왕동이라고 마니 부름미까 앙 그암 왕드이라고 마니 함미까	바라미라고 많이 부르듯이 거기도 그 왕동이라고 많이 부릅니까 안 그러면 왕디이라고 많이 합니까
왕디이리라고 마니 함미까	왕디이라고 많이 합니까
왕도이라꼽 부르제 주로요	왕동이라고 부르지 주로요
왕도이러 쪼	왕동이라 주로
왕 왕도이라 함미까 왕디이라 함미까	왕 왕동이라 합니까 왕디이라 합니까
그기 인제 읍 부른 사러미 자기 표혀늘 곰 왕디이 왕동이 이이 이이 이래데 뿌능 꺼테	그게 인제부르는 사람이 자기 표현을 그만 왕디이 왕동이이 이 이래 돼 버린 것 같아
와따 가따 한다 그지에	왔다 갔다 한다 그렇지요
와따 가따 하능 기 거테요	예 왔다 갔다 하는 것 같아요
거우 왕동이나 왕드이뜰 이꼬 그암 장승거리뜰 이꼬 개따박꼴 개따 머라고해쓰미까 그어 어우 거	그러면 왕동이나 왕디이들 있고 그다음 장승거리들이 있고 개따박골 개따 뭐라고 했습니까 그그
응 개따바꼴덜	응 개따박골들
어어 개따바꼴떨하우 세 개가 드리 이따 그지에	어 개따박골들하고 세개가 들이 있다 그렇지요
세 개가 드어를 끼 끼고 사랃서요	예 세 개의 들을 끼 끼고 살았어요
거믕 귿 그 당시에 그어 인제 주로아까 우리 의성 김씨 김무네서 그쪽들 마니 소유하고 이서씀미까	그러면 그 그 당시에 그 인제 주로아까우리 의성 김씨 김문에서 그쪽 들을 많이 소유하고 있었습니까
으예 그르초에 주로 여게 소유해쪄	예 그렇지요 주로 여기에 소유했지요
주로 여게 오 개따바꼴덜 왕디이떨 장성거리들 그 소유어뜬 쥐인드른 우리깅가드리 주로 가저 이써쑤	주로 여기에개따박골들 왕동이들 장승거리들 그 소유 주인들은 우리 김가들이 주로 가지고 있었어
금면 주로 인제 그어 들파닌 중에스 세 들 중에서 어디가 제일끄 너름미까	그러면 주로 인제 그 들판 중에서 세 들 중에서 어디가 제일 넓습니까
왕디이드리 젤 러리제요	왕동이들이 제일 넓지요
거기가 제일 러르고	거기가 제일 넓고
그다으메너	그 다음에는
장성거리고 고다음 개따바걸드리요 고래요	장승거리고 그 다음 개따박골들이고 그래요
머 어째뜽 이 세 가짇 세 들파니 거이 머 그 의성 김무네서 대개 소유하고	뭐 어쨌든 이 세 가지 세 들판이 거의 뭐 그 의성 김문에서 대개 소유하고
소유하고 또 으 그 거기서 위주해 가즈 생화럴 해꼬요 그 토지를 위해저 생화를 해써 그 머꼬 사고 그래써이	예 소유하고 또그 거기에서 위주로로 해 가지고 생활을 했고요 그 토지를 위해 저 생활을 했어 그 먹고 살고 그랬어요
그럼며느 여기에 그거어으 그 멈미까 이으 녿 소작핸는 소장민들도이서쓸 꺼 아임미까	그러면은 여기에 그것어 그 뭡니까 이 논 소작했던 소작민들도 있었을 것 아닙니까
이찌여 그케	있지요 그러게
의성 김씨뜨리 다 지찌르 모 하니까 그 소작하는 사암더른 어느 동네에 주로 사라씀미까	의성 김씨들이 다 짓지는 못 하니까 그 소작하는 사람들은 어느동네에 주로 살았습니까
여기 사는 사럼도 이꼬 개따바꼴 사는 사럼도 이꼬 왕디이 사는 사럼도  이꼬 더러 사라찌마느 주로 인제 소작인드리 여게 마이 사라쩌유 맹	여기 사는 사람도 있고 개따박골 사는 사람도 있고 왕동이 사는 사람도 있고 더러 살았지만은 주로 인제 소작인들이 여기 많이 살았지요 역시
소작인들또 머 소자기라 그려 타서이 하능 거또 아이래 맹 이 깅가 우윽 저그 또까뜽 깅가끼리도 맹 쫌	소작인들도 뭐 소작이라 그래서 타성이 하는 것도아니고 역시 이 김가저 그 똑 같은 김가끼리도 역시 좀
소 소자글 하는 데에	아 소 소작을 하는 데에
소자칸 사암더 이꼬 그래여찌	예 소작하는 사람도 있고 그랬지
그래 으어 또 타성도 소자카은 사암도 이꼬 그르서	그래또 타성도 소작하는 사람도 있고 그랬어
그러므 어째뜬 여기에그거 이 마을레 사는 타성바지나 앙 그아머 가튼 의성 김씨 중에스도 소작하어시늠 부니 게셔꼬	어 그러면 어쨌든 여기에 어그것 이 마을에 사는 타성바지나 안 그러면 같은 의성 김씨 중에서도 소작하시는 분이 계셨고
앙 그아믄 저쪼게 저 저으 왕딩에	안 그러면 저쪽에 저 저 왕동이
어헤예 왕 에이에 왕대 개뜨바꼴두 이써꼬 그르치 므	예어예 왕왕동이 개따박골도 있었고 그렇지 뭐
그쪼우 분들도 하고 그래따 그지에	그쪽 분들도 하고 그랬다 그렇지요
예호	예 예
그리고 고로고로 붐배데 이써찌 머 글때	그리고 고루고루 분배돼 있었지 뭐그때
모두 그	모두 그
그름며느 여기 지검 그거 봉화 가틍 경우에 쫌 그어 유명한 집성초니 여게의성 김씨 여 바라미하고 그다으메 저 여페 닥실	그러면은 여기 지금 그것 봉화 같은 경우에 좀 그 유명한 집성촌이 여기 의성 김씨 여기 바라미하고 그 다음에 저 옆에 닭실
다실하코예	닭실하고요
다시이라 그끼 타구에 유고리라 글따 야	닭실이라 그러기도 하고 유곡이라 그러기도 하고 예
한짜로 하먼 유고기고그다으메 그냥어 따 일반저으로 다실 다시리라고하는데 에 그르서 이 닥씰 닥씨를을 사는 사암드런 이쪽 펴네 머여기싣이야기해떤 세 가짇 음내 뜰 이쪼게넘 별로 농사를함	한자로 하면 유곡이고그다음에 그냥은 닭 일번적으로 닭실 닭실이라고 하는데그래서 이닭실 닭실에 사는 사람들은 이쪽 편에 뭐여기에서 이야기했던 세 가지 읍내들 이쪽에는 별로 농사를 안 합니까
그르치여 농사진능 거는 쩌 읻 주로 그 지역 황경에 따러 사러쓰이께네여	그렇지요 농사짓는 것은 저 이 주로 그 지역 환경에 따라 살았으니까요
그 지이 지역 토지를 가주 사러찌 머 다실 싸러미 여게 와 지꼬 그릉 건  은 업서따꼬 이게	그 지역 지역 토지를 가지고 살았지 뭐 닭실 사람이 여기에와서 짓고 그런 것은없었다고 이게
거므 안동 그 웨 다실 사암드 안동 권씨드른 주로 그어기 어딛 쪼게 그아면 땅을 경자을 주루 마이 해씀미까	그러면 안동 그 왜 다실 사람들 안동 권씨들은 주로 거기 어디 쪽에 그러면 땅을 경작을 주로 많이 했습니까
그여쪽쓰	그쪽
아이윽 거긴 또 그 그 지방에 땅을 가주 소유해쩌에기	아니 거기는 또 그 그지방에 땅을 가지고 소유했지
그 거이 점부 집썽초이러 그능 게 옌나레 그래끄더 토지러 가진 사러멈 며뺑 마지쓱 가주꼬으 그르이 엄는 사럼 어꼬 그래이께 인제 엄는 사럼 그 토지를 빌레 가주 인저 소자케 가주 그어삭 가치 사고 그래쓰이께네 머 곧 지역찌여게서 어어 사라찌 머 여기저기 농사지꼬 그 끄릉 건 드무러따 그이께네	그 거기 전부 집성촌이라 그러는 게 옛날에 그랬거든 토지를 가진 사람은 몇 백마지기씩 가지고 그러니 없는 사람은 없고 그러니까 인제 없는 사람은 그 토지를빌려 가지고 인제 소작해 가지고 거기에서 같이 살고 그랬으니까 뭐 그 지역 지역에서살았지 뭐 여기저기 농사짓고 그 그런 것은 드물었다 그러니까
그르치예	그렇지요
그러므 지금 어째뜽 봉화군느 봉화우 음내 쪼게너 아까 그 안동 권씨들머 닥씰하고 여 다으미 바라미에 의성 김씨하고 이 얻 두 성잉이 집성초니고또 다른 또 다른 데도 이씀미까	그러면 지금 어쨌든 봉화군은 봉화읍 읍내 쪽에는 아까 그 안동 권씨들 뭐 닭실하고 여기 다음이 바라미에 의성 김씨하고 이어 두 성이 집성촌이고 또 다른 또 다른 데도 있습니까
이쩨 참 마네	있지 참 많아
만치요 저 안쪼그로 감며너	많지요 저 안쪽으로 가면은
예 예아	예예
에 그으서 이 음내 근처에넌 두 성씨가 아주 유명한 집성초니고 그르네그지예	어 그래서 이 읍내 근처에는 두 성씨가 아주 유명한 집성촌이고 그렇네요그렇지요
예예	예예
그다으메 어르신 여기 그 들판하고 이야길 해 주션는데 혹씨 여기에 머 유명한 머 사니나 또음 머 바위나 나무나 이런 거에 읻쓰서 그런 데 머 전서리나또너 그으 머 유래 괄련 그른 머어	그 다음에 어르신 여기 그 들판하고 이야기를해 주셨는데 혹시 여기에 뭐 유명한 뭐 산이나 또는 뭐 바위나 나무나 이런 것에 있어서 그런 데 뭐 전설이나 또는 그 뭐 유래 관련 그런 뭐
그릉 거는	그런 것은
바이 가틍 거또 별로 업쓰	바위 같은 것도 별로 없습니까
어업 업 업찌 시프이더	없 없 없 없 없 없지 싶어요
업찌 시퍼이	없지 싶어요
여기 혹씨 나무 가틍 경운또 머 오래덴 나무나 이렁 걷 머 이르미	여기 혹시 나무 같은 경우도 뭐 오래된 나무나 이런 것 뭐 이름이
업써여 나머	없어요 나무
저게 인제 소꺼리라 그는 데가 여 두오다 봄 저 소리 선 데 이쩨예 싱냐누 까에 거가 여기서 부르능 게 소꺼리라 그래여	저기 인제 소꺼리라 그러는데가 여기 들어오다 보면 저기 솔이 서 있는 데 있지요 신작로 가에 거기가 여기에서 부르는 게 소꺼리라 그래요
소꺼리 근데 요새 거 수세 꼉시늘 해 가주 그르체 옌나레 낭기 이른 아람도리 소리 서 이써이 저	소꺼리라 그러는데 요새 거기 수세 경신을 해서 그렇지 옛날에는 나무가 이런 아름드리 솔이 서 있었어요 저기
글땐 그 참참 조완는데 크거윽 그 위치르 그 위치를 소꺼이라 그랜느	그때는 그 참참 좋았는데 그것 그 위치를 그 위치를 소꺼리라 그랬는데
그 낭기읻 또 어뜬냐 어으뜨믕나무 유래는 은 내갇 드른 데으 이게 인는데 그 낭글 여 파론 할배미 끄어 저 이 제주도 어데 그게 머 이 형가므러가 게셔뜬제 그 당시 이링가 머 그 해송을 가조 와다 시머따 그래드라꼬 그게	그 나무가 또 어떠한가 할 것 같으면나무 유래는내가 들은 적이 있는데그 나무를 여기 팔오헌 할아버지가 그 저 이 제주도 어디 그게 뭐 이 현감으로 가 계셨던지 그 당시 일인가 뭐 그 해송을 가져 와서 심었다고 그러더라고 그게
그어서 제주도 묘모글 가따 여 시믕 기에 여여읍 므 은 저 인제 더레시머 노응 게 이마꿈 커따 그게 인제	거기에서 제주도 묘목을 갖다 여기 심은것이 여여 뭐저 인제 들에 심어 놓은 것이 이만큼 컸다 그게 인제
지금도 끄게 세 낭깅가 네 낭근 시방 버 이 이따고 거어 시방	지금도 그게 세 나무인가 네 나무 시방도 뭐 이 있다고 거기 시방
그게 소꺼림미까	그게 소꺼리입니까
아응 그게 인제 소꺼리러 근다꼬	어 그게 인제 소꺼리라 그런다고
솔 소꺼리	솔 소꺼리
므 그게 인제 표시가 데고 그 묘모기 해송이래 여기에 소리 아이고 제주두서 가저 옹 게래 그 소리	뭐 그게 인제 표시가 되고 그 묘목이 해송이야 여기의 솔이 아니고 제주도에서 가져 온 것이야 그 솔이
그러므 소꺼리고 그어 소나무가 인제 쫌 멱 쭈 이쓰니까 소꺼리고 그다음미 혹씨 여기에 머 그러므 예즈 여기도 예저네 그거 당 당제나 이렁 거	그러면 소꺼리고 그 소나무가 인제 좀 몇 그루 있으니까 소꺼리고 그 다음에 혹시여기에 뭐 그러면 예전 여기에도 예전에 그것 당 당제나 이런 것
스나으	서낭
서낭당이라 그능 게 여기 이써 서낭다이러 그능 게	서낭당이라 그러는 게여기 있어 서낭당이라 그러는 게
서낭다	서낭당
그어기느 당나무가 업씀미까	거기는 당나무가 없습니까
여게는	여기에는
당낭근 어꼬온 당찌블 지이 가주 이따 까 당찌블 지이 가주고 그 읻 지이가주구 거게서 제살 지낸데 그 사모	당나무는 없고 당집을 지어 가지고 있다 하니까 당집을 지어 가지고 그 이 지어 가지고 거기에서 제사를 지냈는데 그 사뭇
마자 정월따레 인제 정월보름 데먼 동네써 인제 그 읻 제무럴 거츄럴 해따꼬 그얼	맞아 정월에 인제 정월보름이 되면 동네에서 인제 그 이 제물을 거출을 했다고 그것을
이래 머구또 치고 도라뎅기믄 동네써 인제 거출해 가주고 바아 가주그여 제살 지내구 핸는데 여 바로 디에 여이	이래 뭐굿도 치고 돌아다니면 동네에서 인제 거출해 가지고 받아서 그래 제사를 지내고 했는데 여기 바로 뒤에여기
그래다가 박쩡히 대통녕 지꿘하고 글때 에 그 머러 저 미신 철뻬한다 그러가주 마아지 각 동네 그 어으 그거 사 서낭을 점 페지해 쁘래끄더	그러다가 박정희 대통령 집권하고 그때 에 그 뭐야 저 미신 철폐한다 그래서 말이지 각 동네그그것 서 서낭을 전부 폐지해 버렸거든
혹뜨 혹 그으그이 지금도 어뎅음머 그 저 머르 안동 저런 덴 혹 지낸 데거이그 이따 소릴 드께덕	혹 혹 그게 지금도 어디뭐 그 저 뭐냐 안동저런 데는 혹 지내는 데가 있다는 소리를 들었어
그은나 여게는 다실또 페지데꾸 요도 폐지데이따꼬	그러나 여기는 닭실도폐지됐고 요기도 폐지됐다고
다 다 안 지낸다꾸 이제	다 다 안 지낸다고 이제
그라므 인제 지금 어엳 어째뜬 이 마으레너 그 예저네는 스 그 서낭다응 응당을 당찌블 해 가주고 머  모션는데 지금 당나무나 이렁 거느 여기느 업쑤따 그지에	그러면 이제 지금어쨌든 이 마을에는 그 예전에선 서 그 서낭당은 응 당을 당집을 해 가지고 뭐  모셨는데 지금 당나무나 이런 것은 여기는 없다 그렇지요
당나무넌느 어서꼬이 지블 지이 가즈 모셰뜨래꼬 그으또 페지데 쁘려꼬이진	어 당나무는 없었고 집을 지어 가지고 모셨더랬고 그것도 폐지돼 버렸고 이제는
그다으메 혹씨 요주멈 머 이 마으레 아까도 이야기하셔씀다마너 의성 김문드리 한 마 한 삼 부네 일 쪼금 넘꼬	그다음에 혹시 요즘은 뭐 이 마을에 아까도 이야기하셨습니다만은 의성 김문들이 한 뭐 한 삼 분의 일 조금 넘고
에 그다으메 타성바지 웨지 사암드리 드롸서 또 저 나머지 사람들 살고 인는데 이 마을 사암드러 주로 그엄 어떠케 해서 머꼬 사라감미까	예 그다음에타성바지 외지 사람들이 들어와서 또 저 나머지 사람들 살고 있는데 이 마을 사람들은 주로 그러면 어떻게 해서 먹고 살아갑니까
여게 사는 사람드른 그리 살기가 참 이 이으 부끄러엄 말러 벨로 넝넉찌인모타다꼬용	여기 사는 사람들은 그리 살기가 참 이 이 부끄러운 말로 별로 넉넉하지는 못하다고요
웨 그르냐 인지인 모도 나이 망코 또 이 옌나리아 토지드리 여게 상다이 마이역 가진 사럼들또 마내앤데 이 토지 붐배가 데 가주고 이 토지일 구마 머 소자긴드르 붐밸 해 조 뿌래써	왜 그러냐 인제는 모두 나이가 많고 또 이 옛날에는토지들이 여기에 상당히 많이 가진 사람들도 많았는데 이 토지 분배가 돼 가지고 이토지를 그만 뭐 소작인에게 분배를 해 줘 버렸어
토 으예 이후에 거 해방 이후에  해방 뉴워	예 해방 이후
예예 해찌에	예 했지요
그 토지 붐배 제도거 생기고 나이께네 동네가 그마 자연니 피빠캐 지드라꼬	그 토지 분배 제도가 생기고 나니까 동네가 그만 자연히 핍박해 지더라고
웨 그른냐 그 도지 바뜽 거또 모 빠찌 그와 돈 쪼매 타재 가주구 다 써 쁘래찌 그르이그 그른 집뜨리 옌나레 저 부호라 호칭으 참말 드뜬 집뜨릉그거이가 고마 자꾸 주드라꺼 재사니	왜 그렇냐 그 도지 받던 것도 못 받지 그 돈조금 타 가지고 다 써 버렸지 그러니까 그런 집들이 옛날에 저 부호라 호칭을 참아 말 듣던 집들은 거의가 그만 자꾸 줄더라고 재산이
주이께네쓰 소자긴들도 주기 매 라이데	주니까 소작인들도 죽기는 역시 한가지더라고
토지가 예를릅 부자 잘사는 지베 가서 열 마지이 이 그 이이이 참 쯔 지지뜬 사러미 토지 붐배데거 바낀 바더쓰너 어더이 지임 파라 머어 뻐래꼬 이러이 자여니 브이 그 으데 그 읃 이 동네가 쉐태해지거 또 요주모 황경으롭 바서느 우리 여 모도 서이가 다 이찌마는 나도 마내지고 또 은제 겨겝 벨 기본 재산도 어꼬 그르이 넝넉찌느 모태여	토지가 예를 들어 부자 잘사는 집에 가서 열마지기 이 그 이 참 저 짓 짓던 사람이 토지 분배되고 받기는 받았으나 어디 지금은 팔아 먹어 버렸고 이러니 자연히 그 그 어디 그이 동네가 쇠퇴해지고 또요즘의 환경으로 봐서는 우리 여기 모두 셋이 다 있지만은 나이도 많아지고 또 인제 여기 별 기본 재산도 없고 그러니 넉넉하지는 못해요
너 에 긱 게와 그저 아아드리 머 객찌이 나가서 또 머 머 떰 마니 벨 엄머머 직짱 가지고 머 여러 직짱아 가주 이찌마 나가 인 사럼드이 그른싸응 가 아드리 인제 동릴 위해서 인저 부모를 위해서 좀 보태 주고 이래 가주은제으 사라가고 머 실쩨 여어써에써언느 생산해 가주 사는 지븐 며 찝 안 덴다꼬	뭐겨 겨우 그저 아이들이 뭐 객지에 나가서 또 뭐 뭐 또 많이 별뭐어 뭐 직장 가지고 뭐 여러 직장을 가지고 있지만 나가 있는 사람들이 그런 사람그 아이들이 인제 동리를 위해서 인제 부모를 위해서 좀 보태 주고 이래 가지고 인제 살아가고 뭐 실제 여기에서 생산해 가지고 사는 집은 몇 집 안 된다고
아아들한떼 주로 위타캐 가주우 사는 집또 망코 또 게 이 쪼꿈 노려캐 가주우 머 게와 그저 밤 머꼬 사는 지비 그에 데 이꼬 이런 실쩌이시더 웨요	아이들한테 주로 위탁해 가지고 사는 집도 많고 또 그 이 조금 노력해 가지고 뭐 겨우그저 밥 먹고 사는 지비 그렇게 돼 있고 이런 실정입니다 왜요
거람 여기에 그엄므 지곰인제 어르신 절머슬 때너 주로 농사를 주로 하이쓰미까	그러면 여기에 그러면 지금인제 어르신 젊으셨을 때는 주로 농사를주로 하셨습니까
농사지예째용	예 농사지었지요
그엄 농사 예저네 농사지을려며너 그냐음 그냥은 혼자서 지끼느 힘드니까아까 머 소자글 해읃씨든지 또너 앙 그러며넏 머 토지 붐배하고 나스너 아무래두 또 이 쪼곰 토지 소유가 주러드러스니까 진는 양둗 즈 주러들기느 해찌마너예저네 그거 입 아까 쪼그믄 이야기하시다 마란는데정월 보름미나 이르 때  거 스 서낭당에 그거 그암며으 그어때 동네 고사인 솀미지예 그케	그러면 농사예전에 농사지으려면은 그냥 그냥은 혼자서 짓기는 힘드니까 아까 뭐 소작을 하셨던지 또는 안 그러면은 뭐 토지 분배하고 나서는 아무래도 또 이 조금 토지 소유가줄어들었으니까 짓는 양도 줄 줄어들기는 했지만은 예전에 그것 이 아까 조금은 이야기하시다 말았는데정월 보름이나 이럴 때 그 서 서낭당에 그것 그러면은 그때 동네 고사인 셈이지요 그렇게
어에 동네 고사 지내지여	예동네 고사 지내지요
그그너 크 커 동네 고사에 대해서 그 서낭신 모시면서 그어때 그 부우네 대해서 쫌 함무 이야기해 주십쑈	그것은 그 그 동네 고사에 대해서 그 서낭신 모시면서 그때 그 부분에 대해서 좀 한 번 이야기해 주십시오
그 인제 그 서낭당 제살 치내능 거능 그 서낭당에 가서 어어 엉 그그 그 모돋 추주 추궈널 하고 또 구우 머 아에 제무레 에 어이 그 여 이으 도늘 혐쫄좀 내고 그래믄 보골 반는다 카능그 그래한 유래거 이써써요	그 이제 그 서낭당 제사를 지내는 것은 그 서낭당에 가서어 그 그 모두 축 축원을 하고 또 그뭐제물에어 그 여 이 돈을 협조를 좀 내고 그러면 복을 받는다고 하는 그런 유래가 있었어요
그래 노이께네 동니써 모도 모에 가즈어 노오기도 함 겸 구설 웨 지긍 거뚱구어 그 머 이래 상투도 돌리고 하능 거 응 거 커른 니 적 저 농악때가 창서리응 그 농악때를 며침 맨드르 가주우 구또 치고 은제 동네윽 그 지베즏 드가서은제 지신도 발바 준다 그래 가저으 그 지임 마다아 가서 구 치고 머 이게 이이래고 나먼 커 지베서 또 인제 그 오신 손님들 접때도 하고 또 옴 므 그읃치 찬조를 또 머 쓰써이 이 도느로 하능 거능 그 드무러 주로 고마 쌀로 즈쌀로 고맘 한두 대씨그 에 찬조도 하고	그래 놓으니까 동네에서 모두 모여 가지고 놀기도 할 겸 굿을 왜 지금 같으면 그 그 뭐 이래 상모도 돌리고 하는 것 어그 그런 이 저 농악대가 창설이 그 농악대를 몇이서 만들어 가지고 굿도 치고 인제동네 그 집에 들어가서 인제 지신도 밟아 준다 그래 가지고 그 집 마당에 가서 굿치고 뭐 이게 이 이러고 나면 그 집에서 또 인제 그 오신 손님들 접대도 하고 또어 뭐 그 찬 찬조를 또 뭐 저 이 돈으로 하는 것은 그 드물어 주로 그만 쌀로저 쌀로 그만 한두 대씩찬조도 하고
그래 민저으 그걸 또 팔고 해 가주고 머독 고기도 사고 어물또 사고 해 가주고 그음 머 걷 제살 그래 당제살 지내고 당제사알 지나고 나멈 그 떠기 인제 쪼꼼신 나와요	그러면 인제 그것을 또 팔고 해 가지고 모두 고기도 사고 어물도 사고 해 가지고 그 뭐 그 제사를 그래 당제사를 지내고 당제사를 지내고 나면그 떡이 인제 조금씩 나와요
그 떠기 그으 머으믄 조타이더 그게	그 떡이 그 먹으면 좋답니다 그게
당제살 지냉 그 떠글 어른드리 가따 온 분드리 인제 제관드리 쪼꿈씨 농게가주우 동네 므 농기 주이게도 하기도 그래 머끼도 하고으 그른 녜가 이써써요	당제사를 지낸 그 떡을 어른들이 갔다 온 분들이 인제 제관들이 조금씩 나눠가지고 동네 뭐 나눠 주기도 하기도 그래 먹기도 하고 그런 예가 있었어요
그엄며느 그 당 당제사 가틍 얻 당제윽 까틍 경우너 그으 누가 모심미까	그러면은 그 당 당제사 같은당제 같은 경우는 그 누가 모십니까
서낭당 끄언	서낭당 그것은
어에이 그겅 모시능 그너 동니서 모에 가주으 그을그 그해에 이 그 인제제과늘 으 그 당제살 지낼 제과늘 선정을 해용	어 그것을 모시는 것은 동네에서 모여 가지고 그 그해에 이 그 인제 제관을그 당제사를 지낼 제관을 선정을해요
선정을 하머이 예를 뜨르 내가 선정이 데따 그믕 그 그날 정월딸 버트멍에음 참 모멀 깨끄시 하고 마리야 그 제사이 제관 자겨글 가차 가주고 그 지베 머 황토도 칠해 노코 마아쩨 이래 가주 인제 제과니 선정데믕 그에 지 즈파럴 제사 지닐 때까지느 그어으 모멀 청결히 하고 으 그래으 조심스러끼이 으이 읻 제사알 지내고 해싸요	선정을 하면 예를 들어 내가 선정이 됐다 그러면그 그날 정월달 같으면참 몸을 깨끗이 하고 말이야 그 제사 제관 자격을 갖추어 가지고 그 집에 뭐 황토도 칠해 놓고 말이지 이래 가지고 인제 제관이 선정되면그 저 저 팔월 제사 지낼 때까지는 그 몸을 청결히 하고그래 조심스럽게 이 이제사를 지내고 했어요
그럼며느 그어기 에 그어긷 제관 정하능 거슨 도라가면서 함미까 앙 그암면 어뜨게 동네에서 어떠게	그러면은 거기거기 제관 정하는 것은 돌아가면서 합니까 안 그러면 어떻게 동네에서 어떻게
결과에쩌그러 그으 동네써 올개능 고만 지 자네 해라니에 니 해라 고마 이 이래 가주 구마 정하능 게래에 머요	결과적으로 그 동네에서 올해는 그만 자 자네가 해라 아니면 너가 해라 그만 이 이래 가지고 그만 정하는 거에요뭐요
또 그릉게으 그 트키 인제 그어 인 지 찌 에 이 제주로 선저잉덴 사래미으 상주도 아이고 보기니 아이래이 데그 처째 상주로 그능 게 에 짇 쩌 머부몰 이러따든지 그른 보기니 아이래이 데고 그 머 그여 저 어옌느 현서판 므어씨갑 이쓰먼 그걸 모 타고 그래써요	또 그런게 그 특히 인제 그 이 저 저어 이 제주로 선정된 사람이상주도 아니고 복인이 아니라야 되고 첫째 상주라그러는 게저 저 뭐 부모를 잃었다든지 그런 복인이 아니라야 되고 그 뭐 그저부정한 무엇이 있으면 그것을 못 하고 그랬어요
어째든 도러가면서	어쨌든 돌아가면서
예아	예
그어 할 수 인는 위치아 데에쓸 때 동네에스 정해서 한다 그지에	예그것을 할 수 있는 위치가 됐을 때 동네에서 정해서 한다 그렇지요
아앙아먼 동네 정애 가주 하주	아아무래도 동네에서 정해 가지고하지요
그엄면 그 정해서 그 제광니 정해지며너 어터게 정월대보름메 인제 그거 고사를 지내고 하는데 그암머여 보통 어디 쯔 그거 정성 드려 가주고 머 기도도하고 함미까 제관넌	그러면 그 정해서 그 제관이 정해지면은 어떻게 정월대보름에 인제 그것 고사를 지내고 하는데 그러면은 보통 어디 저 그것 정을 들여 가지고뭐 기도도 하고 합니까 제관은
제관드리 그래 가주 은제엗 정월 머 이 열라흘랄 열사흔날 그 인제 거 당찌벌 뜽 그이다 동네 뎅기미쌍 농악때가 뎅기십쌍 거출한 미를 가주 파라 가주  고 정성을 뜨레 제무를 장만하우 그 제관드러 또으 그 그날 창관할 제관드른그 모멀 단저이 하고 머 험항 걸 보잔뜨록 하고 그래 가주우 그 지베서 이점부 그 인제 그 이 제물을 맨드고 거 이 제사 지낸 꺼집 당에 가주 가능 꺼징 그어서 다 이 주과느 하고 그래 지내이더	제관들이 그래 가지고 인제 정월뭐 이 열나흗날 열사흗날 그 인제 그 당집을 저 그 인제 동네를 다니면서 농악대가다니면서 거출한 쌀을 가지고 팔아 가지고 정성을 들여서 제물을 장만하고 그 제관들은 또 그 그날 참관할 제관들은 그 몸을 단정히 하고 뭐 험한 것을 보지 않도록하고 그래 가지고 그 집에서 이 전부 그 인제 그 이 제물을 만들고 그 이 제사 지낼때까지 당에 가지고 가는 것까지 거기에서 다 하 이 주관을 하고 그래 지냅니다
그엄며 혹씨 당제 지낼려며너 매년 그 거두우 가주고 거출해 가주우 그르게 함미까 앙 그러며너 당제 그거또 하기 위해서 당제 지내기 위해서 으아 게를 게 형시그로 그러케 해짜니시머	그러면 혹시 당제 지낼려면은 매년 그 거두어 가지고 거출해 가지고 그렇게 합니까 안 그러면은 당제 그것도 하기 위해서 당제 지내기 위해서계를 계 형식을 그렇게 했습니까
그러치	그렇지
커릉 거는 업써써요	그런 것은 없었어요
업써꼬 웨 그른냐 하게 데므 그 당제사에 으 고사에 에 추기그믈 내기 데먼 재수도 이꼬 보글 반다 그러 가주고 점부가 거게 대해써능 애끼지 안 해써모도오요	없었고 왜 그러냐 하게 되면 그 당제사에고사에축의금을 내게되면 재수도 있고 복을 받는다 그래 가지고 전부가 거기에 대해서는 아끼지 안 했어 모두요
고마 머 즈 자기 형편 대러 두 대 내은 사람데 구 서 대 내은 사럼도 이꼬 그거 내능 거능 애끼질 안 해따끄 보골 반다 카능 혀그 그게 이써 가주우요	그만 뭐 저 자기 형편 대로 두 되 내는 사람도 있고 세 되 내는 사람도 있고 그것을 내는 것은 아끼지를 안 했다고 복을 받는다고 하는 것 그것이 있어 가지고요
그염 어째뜸 그워거는 따로 게를 결성해가 하능 게 아이고	그러면 어쨌든그것은 따로 계를 결성해서 하는 것이 아니고
동니 동니 자체서	예 동네 동네 자체에서
그날 동네에슫 머 자체에서 거출해 가주고스 성이껀 내애서 그냘 해따그지예	그날 동네에서 뭐 자체에서 거출해 가지고성 성의껏 내서 그냥 했다그렇지요
예아	예
그라면스 제수 장만하우 그르케 하능 그고 요즈믄 머 끄어 그렁 게 적씀미다마느 어르신 머 에저네 한 절머쓸 때나이럴 때너 동네에 게 가틍게 쫌 이써찌에	어 그러면서 제수 장만하고 그렇게 하는 것이고 요즘은 뭐 그그런 게 적습니다만은 어르신 뭐 예전에 한 젊었을 때나이럴 때는 동네에 계같은 게 좀 있었지요
게 모임 가틍 게	계 모임 같은 게
게 모임 거틍 이써쩨요 그렁 거밍	계 모임 같은 것이 있었지요 그런 것이
게라 그능 거는 마내찌어 그릉 게 게 모임 쪼구미하이 이래	계라 그러는  것은 많았지요 그런 것이 계 모임 조그마하게 이래
어뜬 게가 이서씀미까	어 어떤 계가 있었습니까
그 미 여러 가지 워에 예를 뜨러 우리 거트머 인제 게끼리 모에 가즈엗 또래 또래 인제 그 열령별로 모엔다든지에 머 이 이래 가주고 머 이 도늘 거출해가주 아이예 한 다레 함 머 이 에 금 일 려네 은 으 한 다레 함 번씨 모엔다든지 머 그 크래 가주우 그걸 또 쪼꿈 머꼬여 늘구끼이도 하고 또 그래 머 장녀삐지라 그음 또 그래 가주우 그걸 마아 가주 또 인제 그 에 이 게원들끼리이자를 조 가주 이자 바다 가주우 도흔 늘구코 므 그 끄 그릉 게도 마내꼬	그 뭐 여러 가지 뭐 예를 들어 우리 같으면 인제 계끼리 모여 가지고 또래 또래인제 그 연령별로 모인다든지 뭐 이 이래 가지고 뭐 이 돈을 거출해 가지고한달에 한 뭐 이그 일 년에어 한 달에 한 번씩 모인다든지 뭐 그 그래 가지고 그것을 또 조금 먹고 늘이기도 하고 또 그래 뭐 장리빚이라 그러면서또 그래 가지고 그것을 모아 가지고 또 인제 그 이 이 계원들끼리 이자를 줘 가지고 이자를 받아 가지고 돈을 늘이고 뭐 그 그 그런 것도 많았고
그음 어트에 동갑 까틍 경우 동갑께라 함미까	그러면 어떻게 동갑 같은 경우에 동갑계라 합니까
에야 동가께도 이기 이쩨여이	예 동갑계도 있지요
주로 동가께고	주로 동갑계고
그담메 혹시 도 고로 께 인지 동갑께고 혹씨 여기에 머예저네너 여기엗 장네 가틍 경우에 어르신뜨 누가뜨 동네에 어르니 도라가심며는 장네어 거 치러야 데니까 이 요즈미얌 머 장이업체드리 마암 벼 영안실레도 가고 머 지베서 하늠 분들도 이찜마너 주로 벼 병원 영안시레 가서 마니 하는데	그다음에혹시 동갑 그런 것이 인제 동갑계고 혹시 여기에 뭐예전에 여기에 장례 같은경우에 어신들 누가 동네에 어른이 돌아가시면은 장례를 그 치뤄야 되니까 이 요즘이야 뭐 장의업체들이 많이 병원 영안실에도 가고 뭐 집에서 하는 분들도 있지만은주로 병 병원 영안실에 가서 많이 하는데
마인 주로 그르치 머 여세	많이 주로 그렇지 뭐 요새
그은데 예저네는 동네에서 다 해쓰니까 도라가심므 그때에너 혹씨 이 상녀게나 이렁 건 업서씀미까	그런데 예전에는 동네에서 다 했으니까 돌아가시면 그때에는 혹시 이 상여계나 이런 것은 없었습니까
상여게그이드 이서쩨용	상여계도 있었지요
끄어 상녀게에 대해서 함분 이야길 해	그 상여계에 대해서 한 번 이야기를해 주십시오
상여게라 그능 거는 인제 우리 동네 사는 사러므로썽능 거겐 상에게늠머어 아이 아인 떼금 머 타성도 다 안 해다이 다 덴다꼬 그게요	예상여계라 그러는 것은 인제 우리 동네 사는 사람으로서 거기에는 상여게는 뭐 어어어 그 뭐 타성도 다 안 해당이 다 된다고 그게요
머우 그은 머 자기가 비용 내 가주 하능 이게네 게를 모을 때능 게그믈 거출해 가주고 그거또 늘구키도 하 하고 또 협쪼도 바끼도 하고 해래 저 상포게라 그르 상이게가 아이거이	뭐 그것은 뭐 자기가 비용을 내 가지고 하는 것이니까 계를 모을 때는 계금을 거출해 가지고 그것도 늘이기도 하 하고 또 협조도 받기  도 하고 해서 저 상포계라 그래 상여계가 아니고
끄 옌날 상포게러 그럼미거	그 옛날에는 상포계라 그랬습니다
상포게러 근데 끄 그릉 게를 마아 가주 인제 머참 상을 다하다은지으부모에 상을 당한다은지 머 형제 가이라든지여 머 어데 머 대소가에 상을 당하믄 똡 부조도 하는 수도 나오고 또 거게서 또우 그 사러믈 은 사이게에서 저사러미 상을 다해씨이께네 군새까에 참 쪼꿈 웅 어려으이낀네 보태 주규도 여여찬조도 내 주고 참 으음 찬조가 아이래 부이제 그리웁 부이도 내 주고 그 그릉 게가 상포게랑 게 동네에 다 이써써에 글때느	상포계라 그러는데 그 그런계를 모아 가지고 인제 뭐참 상을 당했다든지 부모의 상을 당했다든지 뭐 형제간이라든지 뭐 어디 뭐 대소간에 상을 당하면 또 부조도 하는 수도 나오고 또 거기에서 또 그 사람을상여계에서 저 사람이 상을 당했으니까 궁색하니 참 조금 어어려우니까 보태 주기도찬조도 내 주고 참찬조가 아니고 부의지 그러니까부의도 내 주고 그 그런 계가 상포계라는 게 동네에 다 있었어요 그때는
요즈믄 상포게느 업써져씀미까	요즘은 상포계는 없어졌습니까
요샌 머 상포게가 여게느 업써여 누가 상포게 할 사럼도 엄 어꼬요 또 인제능 게원 머어듬 모을 사럼도 어꼬요	요새는 뭐 상포계가 여기에는 없어요 누가 상포계 할 사람도 없 없고요 또 인제 계원 뭐 모을 사람도 없고요
연세드리 마능	연세들이 많이
연세도 망코 또 인제늠 머 그르코 또 절믄 사암드 마카 객찌이 가 이꼬	예 연세도 많고 또 인제는 뭐 그렇고 또 젊은 사람들은 모두 객지에 가 있고
그어므 혹씨 인제 상포게고 혹씨 머 인제 예정네느 그거 어르신 절머쓸때에너 자녀들 호닌시키이 위해서 호닝게 이렁 거또 드러씀미까	그러면 혹시 인제 상포계고 혹시 뭐 인제 예전에는 그것 어르신 젊었을 때에는 자녀들을 혼인시키기 위해서 혼인계 이런 것도 들었습니까
호닝게는 옌나른 이써언지 모를두어이 요주안뉴 우리 철하곤능느 업서쩨	혼인계는 옛날에는 있었는지 모르지만은 요즘에는 우리 철에는 없었지
업써쓰 께테이더 그 호닝게러 그능 거느	없었을 것 같습니다 그 혼인계라그러는 것은
그암며 혹씨 인자 아까 이야기하션는디 그암미 상포게나 동갑께에 그릉 거혹씨 그람며 여기느 의성 김씨 집썽초느이기 때무레 혹씨 의성 김씨들끼리 모이늠 머 화수게나 이렁 거느 이서씀미까	그러면 혹시 인제 아까 이야기하셨는데 그러면 상포계나 동갑계 그런 것 혹시 그러면은 여기는 의성 김씨 집성촌이기 때문에혹시 의성 김씨들끼리 모이는 뭐 화수계나 이런 것은 있었습니까
이씀니다	있습니다
그거느 어뜨에	그것은 어떻게
짇 처에게 지금도 화수훼라 그릉 거너 으성 깅가들끼리 모이느 화수훼갇따로 이꼬 또 여 우 우리 이 으 여 저 얻 가튼 으성 깅가라도 멀리 떠러진데더 이꼬 한 한 종파허아 아인 파갇 또 이끄더	어 지 저기 지금도 화수회라그러는 것은 의성 김가들끼리 모이는 화수회가 따로 있고 또 여기 우 우리 이 어여기 저같은 의성 김가라도 멀리 떨어진 데도 있고 한 한 종파가 아닌 파가 또있거든
그른 데는 요 우리 도니게라 그릉 걸 또 마아 가주 이써용	그런 데는 요우리 돈의계라 그러는 것을 또 모아 가지고 있어요
우리 동네러 말할 꺼 텀 여 머 도니게러 건능 거늠 이 으 즈 쯔아 머 으두터울 도 짜드 에로울 위 짜 그으 도니기 뜨스 짐 머 끄 가따고 인제 그 도니게라 그래요	우리 동네로 말할 것 같으면 여기 뭐 돈의계라 그러는 것은 이 어저 저 뭐도타울 돈 자 의로울 의 자 그 돈의 뜻은 저 뭐 그 같다고 인제 그돈의계라고 그래요
끄 그릉 게를 마아 가주오 초보게에 찌 중보게암 하내 한 철씨 그 중보게모에 가주 개를 자바 가주요 이 에 기 개를 자바 가주고 으 그 동네끼리모에 가주움 머꼬 엉 그 노오고 거른 응 게가 인니더요	그 그런 계를 모아가지고 초복에 저 중복에 한 해 한 철씩 그 중복에 모여 가지고 개를 잡아 가지고이개 개를 잡아 가지고그 동네끼리 모여 가지고 먹고그 놀고 그런어 계가 있어요
우리느 황저니러 근 동네하꼬으 우리 동네하꼬 가치 마아가 진니더	우리는황전이라고 그러는 동네하고 우리 동네하고 같이 모아서 지내요
여 황저니라고 요 우에 가다 보므 안동으녀 사안 나가또 오믄 요포저리 지나 가주어 가다 멍 응 그으 공옥 단지 이찌 안틍겨 그에 코 꼬 고 아페게아지비 만치 안팅껴 고 동네가 황저니러 그랜니더 검	여기 황전이라고 요 위에 가다 보면 안동 산 나가다 보면 요기포저리를 지나 가지고 가다 보면 어그 공업단지 있지 않던가요 거기에 그 그 그 앞에 기와집이 많지 않던가요 그 동네가 황전리라 그랬어요 거기가
그 동네도 으성 깅가씨더	그 동네도 의성 김가에요
거게그 그 동네하꼬 으성 깅가들끼리 우리가 인제 옌나레 어른드리 쯔도니라 겔 거이 뜨시 뚜텁떠락 한다그 도니게라 건느 게를 맹그르떼 하 하머수십 으우 커게 하맙 퍽 오래데 수뱅 년 덴는 그 유래를 지긍까지두 내리와서음 내리와요	거기그 그 동네하고 의성 김가들끼리 우리가 인제 옛날에 어른들이 저 돈의라 그런 것이 뜻을 두텁게 한다고 돈의라 그러는 계를 만들어서 벌벌써 수십그것이 벌써 퍽 오래돼 수백 년 된 그 유래를 지금까지도 내려와서음 내려와요
응어 맹 금녀에도 인제 줌복 금년 주 중보겐 맹 이이 으 게를 벙가라감 금녀네늠 바러미써 하먼 내이네는 저어서 하고 이래 벙가라감 마 하는데올개드 매 함니다 그건	어 역시 금년에도 인제 중복 금년 중복 중복에는 역시이 이 계를 번갈아 가면서 금년에는 바러미에서 하면 내년에는 저기에서 하고 이래 번갈아 가면서 뭐 하는데 올해도 역시 합니다 그것은
도니게라 그능 거느	돈의계라 그러는 것은
도니게가 이꼬머 혹씨 머 다른른 게느 머 송게나 이렁 건 어꼼 머 그이 여기는	돈의계가 있고뭐 혹시 뭐 다른 계는 뭐 송계나 이런 것은 없고 뭐그 여기는
숟 송게라 그능 게 읻 이싸써요	송 송계라 그러는 게 있 있었어요
송게라 그으능 게 이 사늘 괄리한 게그더요	송계라 그러는 게 이 산을 관리하는 것이거든요
이 이 사니 점부 우 우리 으성 깅가들 소유루 데 이써요	이 이 산이 전부우 우리 의성 김가들 소유로 돼 있어요
흐레 가주 이 써 이 이 케 사이 그 참 상 이 산 어이 꺼 산게에를 마아 가주 이썬데 요지가네 와선으 종 고마 해이해저 뿌래써요	그래 가지고 이저 이 이 그 산이 그 참 산 이 산그 산계를 모아 가지고 있었는데 요즘에 와서 좀 그만 해이해져 버렸어요
그더이 그검 머야 맹 은 소유는 엥에읍 으이 깅가들 소유이께네 그금 머 여이 게가 머 피료 이껜나 이른 시규롣 데 가주써며참음 머 유명무씨라이 데 이쎄 이젠뇨	그러니 그것 뭐야 역시소유는어 김가들 소유니까 그것 뭐 여기 이 계가 뭐 필요 있겠나 이런 식으로 돼 가지고참음 뭐 유명무실하게 돼 있어 이제는요
예저네느 그람마	어 예전에는 그러면
이 이낀 이써써요	예 있 있기는 있었어요
예저네 그음 그 게 므 송게 하며늠 머 어떵 법 머 함미까	예전에 그러면그 계 뭐 송계를 하면은 뭐 어떤 것 뭐 합니까
그 인제 송게를 하기 뎀먼 동네서 인제 이 옌나레는 낭기 귀해짠니껴 그나무 사네 가서 엄 멈 무 왐 맘 데르 몬 다억 가서 인제 동네끼림느 쫌매 그인느 지여글 롱기 가주우 마래 요만느 산느 요게 산뜽그어레 그먼 마냐엡 배코러 금 요 사늘 백 깨르 쪼갈라 가즈으 마리야 요거는 니가 해 떼에라 요겐내가 해 따르수융 나무드 그릉 거 은지 예도 이써꽁	그 인제 송계를 하게 되면동네에서 인제 이 옛날에는 나무가 귀했잖아요 그 남의 산에 가서뭐 뭐 어마음대로 못 하고 가서 인제 동네끼리 조금 그 인제 지역을 나눠 가지고 말이야 요만한 산을 요게 산등성이 그러면 만약에 백 호라 그러면 요 산을 백 개로 갈라 가지고 말이야 요것은 네가 해 때라 요것은 내가 해 때겠다 나무도 그런 것 이제 예도 있었고
또 그을 카구 그어서 인제 머 도니 생겸 머 혹 그은 머 기 개가늘 한다든지 인자 마레여 옌나렌느 요주뭄 머 어데 토지가 무능 게 만치만 메 태 해방전후에 해 가주우넌 사늘 개간하능 게 마내꺼드요	또 그렇게 하고 거기에서 인제 뭐 돈이 생겨서 뭐 혹 그 뭐 그 개간을 한다든지 말이에요 옛날에는 요즘은 뭐어디 토지가 묵는 게 많지만 몇 해 해방 전후에 해 가지고는 산을 개간하는 게 많았거든요
그래 산비안비싸이 개간해 가주우 머으멍 거게두 인제 도질 머 싸리 머오방 가미임 방 가마 항 바다 가주우 이걸 늘가 가즈으 또 게운들끼리 머 쓰기도하고 이른 녜도 더러 이꼬 그랜니더 우게 그께에라등가	그래 산비탈을 개간해가지고 먹으면 거기에도 인제 도지를 뭐 쌀이 뭐 반 가마니면 반 가마 한 받아 가지고 이것을 늘려 가지고 또 계원들끼리 뭐 쓰기도 하고 이런 예도 더러 있고 그랬어요 그게 그렇게
그어 요즘 하이뜬 그렁 게가 머 별로	그 요즘 하여튼 그런 계가 뭐 별로
별로 업써 이으게	별로 없어 이게
이끼는이써더 지그믕 머 우명무씨라이 데 이써요	있기는있어도 지금은 뭐 유명무실하게 돼 있어요
그르치야	그렇지요
이음 머 거이 요주엄먼 머 유명무실하고 머 거이야말로다릉 거느 거이어꼬 인제느 화수게	이것 뭐 거의 요즘에는 뭐 유명무실하고 뭐 그야말로어 다른 것은 거의 없고 인제는 화수계
예예 화수게하꼬 도니게거든	예 화수계하고 돈의계거든
도니게 거뜽 거느 우때 어런드리 어으 거 으제 정해 노응 게이께네 업쎌쑤거 업써요	돈의계 같은 것은 윗대 어른들이그 인제 정해 놓은 것이니까 없앨 수가 없어요
그래 가주 사문 내리오고요	그래 가지고 사뭇 내려오고요
화스헤 하능 그으늠 머 으연 거이가 다 하능 게고 그르티여	화수계라고하는 것 그것은 뭐거의가 다 하는 것이고 그렇데요
머 그으 빼고 나며는 게 모이믄 별로 안 한다 그지예	뭐 그것을 빼고 나면은 계 모임은 별로 안 한다 그렇지요
게 모이미 업찌 머어요	계 모임이 없지 뭐요
동니 드러 모에 바야 머 머 초상이 난다든지 일 때느 인제 초상찌벵에 문상을 가니까 마리에요 글때 모도 모에고 머 또 길륭사 가네 주로 마이 모에고그랙규오	동네 더러 모여 봐야 뭐 뭐 초상이 난다든지 이럴 때는 인제 초상집에문상을 가니까 말이에요 그때 모두 모이고 뭐 또 길흉사 간에 주로 많이 모이고 그랬고
머 옏 뚜려탄 혹 한내 한 쩔찌그 동훼가 하이그 동웨	뭐 이래 뚜렷한 혹한 해 한 철씩 동회를 하거든 동회
동훼를 한 때 글때 모도 모에가 또 머 기탄 엄는 얘기도 하고	동회를 할때 그때 모두 모여 가지고 또 뭐 기탄 없는 얘기도 하고
어르신 혹씨 이 마으레 다름 마을하고 쫌 달리 머 문하재 가틍 거 이씀미까	예 어르신 혹시 이 마을에 다른 마을하고 좀 달리 뭐 문화재 같은 것이 있습니까
다른 머달릉 게 문하재라 그능 게 여 인제	다른 뭐다른 게문화재라 그러는 게 인제 어
동네와 달리 무나재	동네와 달리 문화재
집 꺼틍 거 이 내내그 구택 고태기 인제 그 잉 문하재라	어 집같은 것 이 내나그 구택 고택이 인제 그 이 문화재야
마내	만회
만해 고땍 에 그른 인제 고태근 또 이꼬	만회 고택그런 인제 고택은또 있고
만해 고태어건 만해 고태게 대해서 함무 이야기를 해 주십씨요 그암머	만회 고택은 만회 고택에 대해서 한 번 이야기를 해 주십시오 그러면
만해라 그능 게 그 우 우때 어르니 그 어응 막 엉어 호럴믐 만해러 그러저 만해 고태기러 근데 머 별 기 유래엔 업써유 겁	만회라 그러느 게 그 윗윗대 어른이 그만호를 만회라 그래서 만회 고택이라 그러는데 뭐 별 그유래는 없어요 그
그 양반드 머어데어 김해 꼬을 사라쩨	그 양반도 뭐어디 김해 고을에 살았지
에 김해 고을 형가므로 가 이또 가아주 거 태코을 김해띠이라 그으고 또 그만해 고태기라 그고 그 지븐 만해 고때기라 그 우때 어르 호를 따 가주 만해고태기라 그으고	어 김해 고을 현감으로 가 있어 가지고 그 택호를 김해댁이라그러고 또 그 만회 고택이라 그러고 그 집은 만해 고택이라 그 윗대 어른 호를 따가지고 만회 고택이라 그러고
만해 고택 그 만훼야 그 호를 머 만 짜 므슴 만 짜을 씀미까	만회 고택그 만회 그 호를 뭐 만 자를 무슨 만 자를 씁니까
느즐 만 쩌	늦을 만 자
느즐 만 짜	늦을 만 자
훼 훼는  훼 짬미까	회 회는  회 자입니까
아 응 거 응 그뭄 훼 짜	아어 그그믐 회 자
그믐	그믐
응혀 무이실 헤 짜쎄 그케 마이아	어 뉘우칠 회 자일세 그러게 말이야
에 뉘으 그릉까 느즐 만 짜 뉘우치느 해 짜을 썬능 그어 마내	어 뉘우그러니까 늦을 만 자 뉘우칠 회 자를 쓴 그 만회
호 호루 호	호 호야 호
호래 마으죠	호라는 말이지요
혼데 그 만해씅 그아므 그 분너 언제쩍쓰 부 사러떤 부님미까	호인데 그만회 그러면 그 분은 언제 적 분 살았던 분입니까
천칠배 칸 오륙심 년 전돈 데 잔나 그래 생가카능 게러 여어 파론 할배미천칠뱅 녀네 이퍙을 해쓰이께네 천 천칠 천칠백오심 년 정돠 안 데게나 그래 보응꺼늠 머 확씰치느 안해	천칠백 한 오육십 년 정도 되지 않나 그래 생각하는 것이 여기 팔오헌 할아버지가 천칠백 년에 입향을 했으니까 천 천칠 천칠백오십 년정도 안 되겠나 그래 보니까 뭐 확실하지는 않아
나도 확씰창고 모르이께네	나도 확실하지 않고 모르니까
대강 이 이 양바니 이 채게 어데 이이 이 직 기로그로 바선 천칠뱅 녀네이퍙을 해쓰이끼네 그 만해 그 양반도 아매 천칠백오십 천칠백사십 그이 정도안 데겐나 그래 생가캄니다	대강 이 이 양반이 이 책에 어디 이 이 저 기록으로 봐서는 천칠백 년에 입향을 했으니까 그 만회 그 양반도 아마 천칠백오십 천칠백사십 그 정도 안 되겠나 그래 생각합니다
이거 으 그붐보다멍 후예이께네	이것그분보다는 후예이니까
파로언 쓰앵의 그암며너 후손임미까 만래 쓰애잉께	예 팔오헌 선생님의 그러면은 후손입니까 만회 선생님께서
후소이지여 그게	후손이지요 그래
그래슫 그 그읍 거우 고 고태기 지곰 화에떤 여 이따 그지예	그래서그 그 그 고 고택이 지금 하여튼 여기 있다 그렇지요
예 만해 고태기여	예만회 고택이요
만해 고택 이꼬 그다염 혹씨 여기에 머 그거 만해 고탱 말고 또 다른 머 고태기 이씀미까	만회 고택 있고 그다음에 혹시 여기에 뭐 그것 만회 고택 말고 또  다른 뭐 고택이 있습니까
만해암 마 만네아	많아 많아 많아요
어트게 얻 어떵 게 이씀미까 만해 고탱 말고너	어떻게어떤 게 있습니까 만회 고택 말고는
음적띠기 금 므승 고태기지 그어가	음적댁 거기가 무슨 고택이지 거기가
이기 으 기어기 잘 안 나 이으 자끄 이저 쁘르 싸안데	이게기억이 잘안 나 이 자꾸 잊어 버려서
나모 고택으나모 그 응 나모라 그능 검 멀 가주 나모러 그제근 나는	남호 고택어남호 그 응 남호라 그러는 것은 무엇을 가지고 남호라 그러지 그 남호는
그래 어응 어으 얻 쩨 이 짐 문하재는 마네아	그래어저 이 집 문화재는 많아
그 그르꼬 지 짐 문하재로능 크 그르코 여게 욱 우리 여 저어 저 쩌 신언 제사 지내엔 데는 여 인제 이 향사럴즈 제살 처낸 리 요게 바로 요요 추원사 여게서 인제 인제 거 야 향사를 우 우리가춘하 쩌 얼아얻 저어 봉 가을로 지내능 게 향사라 그능 이 여게 이 여여서 지내미가	그 그렇고 집 집 문화재로는 그렇고 여기에 우 우리 여기 저 저 저 신제사지내는 데는 여기 인제 이 향사를제 제사를 지낸는 데가 요기에 바로 요기 요기 추원사 여기에서 인제 인제 그향사를 우 우리가춘하 저아 아저어 봄 가을로 지내는 게 향사라 그러는 게 여기에 이 여기에서 지냅니다
그게 하나 이꼬으 그체이 그겨	그게 하나 있고 그렇지요 그게
그어 봉가을로 향사 지내능 거기느 어디 제실림미까	그 봄 가을로 향사 지내는 거기는 어디 제실입니까
요게 제실 데고 요거 언제 추원사라 그고 그러이더	예 요게 제실 되고 요것 인제 추원사라 그러고 그럽니다
그암 봉 가을로 인제어 보멘 언제어엗	그러면 봄 가을로 인제 봄에는 언제
옌나렌 봉 가으레 지낸데이 요즘 한 생 한 심 년덜 떼가 한 칠팔 련데에 가주고 제관드리 마카 객찌이 가 이꼬 이 제과 참석카이가 에로와 가주한내 한 철씨 지내기레 핸네 고마	옛날에는 봄 가을에 지냈는데 요즘 한 십 한십 년덜 되어서 한 칠팔 년 돼 가지고 제관들이 모두 객지에 가 있고 이 제사에 참석하기가 어려워 가지고 한 해 한 철씩 지내기로 했어 그만
으으보메 으 보메 고마 사 월따레 검머 세째 주이릉가 으 그래 곰마제사을 으 그 향사을 지내기로 해 가주고 에 웨지에 인는 자손들또 머 모두참서카우 그래 이 하내 한 철씀만 지내기로 데핸니드 그애	어봄에봄에 그만 사월에 그만 셋째 주일인가그래 그만 제사를그 향사를 지내기로해 가지고외지에 있는 자손들도 뭐 모두 참석하고 그래 이 한 해 한 철씩만 지내기로 했어요 그래
그암마 여기 그 보메 인제 향사늠 보메 한 철만 예저네너 가을에도 지낸는데	그러면 여기 그 봄에 이제 향사는 봄에 한 철만 예전에는 가을에도 지냈는데
언예 으 예예봥 가을 보므어 다 지낸데 요샌 한 한 철씨 지내기 데고	예예어예 봄 가을 봄으로 다 지냈는데 요새는 한 한철씩 지내게 되고
요즈으믄 그람며느 한 철마 지내고 그다으메 저기 그어 으 한 철 지내고그 다으메요즘 가으레능 그러며 시사 지내능	요즘은 그러면은 한 철만 지내고 그다음에 저기 그한 철 지내고 그다음에요즘 가을에는 그러면 시사를 지내는
시사는	시사는
산소에 가서	산소에 가서
산소에 가 지내응 게	어 산소에 가서 지내는 게 예
가 가서 이제 시사는 따로 지내고 그러치예	가 가서 이제 시사는 따로 지내고 그렇지요
예 따로 지내고	예따로 지내고 예
여게 인제 추원사에 모시는 은 니 양반들 이 이 임 믕양바 아이러모신느 어른드리 세 부널 모시구 이써 여게여	여기 인제 추원사에 모시는 어이 양반들 이 이 이 뭐양반이 아니라 모시는 어른들이 세 분을 모시고 있어여기에요
하문 이야길 해 주십씨요 그암머	예 한번 이야기를 해 주십시오 그러면
추원사에	추원사요
아아 그 그 웸처째 이 주봉고이고 고다음메 처뉴당공이고 고다음 학쩡고이고 고래 인제 세 부늘 여게 추원사에모시고 은제 으에보메 향사를 지내인더 모시늠 분드릉 그래 세 부늘 모시고 인니더 그이	아 그 그왜첫째 이 주봉공이고 그다음에 천유당공이고 그다음 학정공이고 그래 인제세 분을 여기에 추원사에모시고 인제어 봄에 향사를 지내는데 모시는 분들은 그렇게 세 분을 모시고 있어요 그래
그 세 분드른 어트케이 머 어데 벼스를 하셔쓴늠 부님니까 앙 그럼 웹 세부늘 모심미까	그 세 분들은 어떻게 뭐 어디 벼슬을 하셨던 분입니까 안 그러면왜 세 분을 모십니까
여 이퍙조느 암 모시고	여기 입향조는 안 모시고
그래 삐 벼슬또 하시쩨	그래 벼 벼슬도 하셨지
벼으 벼으 주봉고이라 근흥 거	벼 벼슬 주봉공이라 그러는 것 예
그 얘길 하모 할쩐 업	그 이야기를 하면 한정 없어
이 마으레 혹씨 그거 특삼물 가틍 거 이씀미까	이 마을에 혹시 그것 특산물같은 것 있습니까
특삼물	특산물
쫌 머 농삼물	좀 뭐 종산물
농삼무리 마르지예	농산물 말이지요
특뼈리 쫌	예 특별히 좀
머어 특펴 업싸요	뭐 특별 없어요
특뼐항 걷 녜	특벼한 것 예
어아 특뼈래 거 엄능기더 여	어 특별한 것 없어요 여기
염 머 특뼐하기 재배하능 그나 그렁 거느 에전네	여기 뭐 특별하게 재배하는 것이나 그런 것은 예전에
어으 업썬 주로 고마이 여언 논농사거 반농사 고마으 머	어 없어 주로그만 여기는 논농사고 밭농사 그만 뭐
특뼐하게	특별하게
어이 감자 옥쑤수 머 어데아 어역 머여 거 콩 그릉 게고 나라이그 나라기요	어 감자 옥수수 뭐 어디뭐야 그 콩 그런 것이고 벼 벼고
특뼐항 건 업따 그지예	특별한 것은 없다 그렇지요
특뼐항 걸 업씸머	예 특별한 것은 없어요
지곰 인젣 마으레 특삼물 가틍 거 문하재 이렁 거 이야기해 주션는데 그으 예저네 어르시니 어릳슬 때하고 지금 어르시 인제 연세 마너으신 지금하고비교하며넌 옌날 이 마을하고 지금 이 마을하고는 쫌 마니 달라져찌야	지금인제 마을의 특산물 같은 것 문화재 이런 것 이야기해 주셨는데 그예전에 어르신이 어렸을 때하고 지금 어르신 인제 연세가 많으신 지금하고 비교하면은 옛날 이마을하고 지금 이 마을하고는 좀 많이 달라졌지요
마이 달러져찌요 무	많이 달라졌지요 뭐
마이 다을쬬 고마 거기	많이 다르지요 고만 그것이다
그암맘 머 그엄 어떤 시그로 달라젼는지 함분 쫌 이야기해 주이소	그러면뭐 그럼 어떤 식으로 달라졌는지 한 번 좀 이야기해 주십시오
글세 귿 달라	글쎄 그 달라진
머 마으리 마을 마으리 그엄 머 아까 이야기해씀미다마너 어르신 어려쓸때 에 그 성씨들또 머 그때 의성 김씨들드리 더 마니 사라서쓸 꺼 따고 이야기아 해쓰미꺼	뭐 마을이 마을 마을이 그럼 뭐 아까 이야기했습니다만은 어르신 어렸을 때그 성씨들도 뭐 그때 의성 김씨들이 더 많이 살았었을 것 같다고 이야기 안 했습니까
그러트시 머 쫌 바껸넝 기 이따며 어떵 게 바껸는지 함 이야길 해 주십씨요	그렇듯이 뭐 좀 바뀐 것이 있다면 어떤 것이 바뀌었는지 한번 이야기를 해 주십시오
글세 그 박꾸웅 게라 그릉 게 머 보편쩌그로 이얘길 햔다 그 거트먼 우리각클 때는 여 참 노는 지비 마넨니더	글쎄 그 바뀐 것이라 그러는 게 뭐 보편적으로 이야기를 한다는 것 같으면 우리가 클 때는 여기 참 노는 집이 많았습니다
놀러 머 사랑도 조코 마리도 조코 사람 점부 놀러 다 우리 머 여 끼리끼리모여 가주 고 덷 동대끼리 마리여 동대라 그응 건 나이 비스탄 사랑끼리 모에가줌 머 밤나즈로 모에 노기도 하구 그랜데 요새는 이검 엄 모도 고 고마읻 지겁 쩐서네 나가 가주 객찌이 나아 가주고 마콱떼음 머 인는 나가이께네 인제는 놀 떼가 업써유 우리는 허이구 우리 또래는 은 옌날 때먼	놀러 뭐 사랑도 좋고 마루도 좋고 사람들 전부 놀러 다 우리 뭐 여기 끼리끼리 모여 가지고 고기  저 동년배 끼리 말이야 동년배라고 그러는 것은 나이 비슷한 사람들끼리 모여 가지고 뭐 밤낮으로 모여 놀기도 하고 그랬는데 요새는 이것모두 그 고만 직업 전선에 나가 가지고 객지에 나가 가지고 모두 뭐 이래 나가니까 인제는 놀 데가 없어요우리는 아이고 우리 또래는옛날에 대면
이 지그메도 우리 나에도 이래 머 모엠 너대뻬께 어꼬 모에 놀 떼도 어꼬또 예히 옌날거칟 그 어네 지베 가서 머 어얻 가 가주우 맘 노코 머푹 쉬고 할 지비 업서요 노기도 맘대로 노오고	이 지금도 우리 나이에도 이래 뭐모이면 네댓밖에 없고 모여서 놀 데도 없고 또 옛 옛날같이 그 어느 집에 가서 뭐어 가 가지고 마음 놓고 뭐푹 쉬고 할 집이 없어요 놀기도 마음대로 놀고
으 그릉 거또오 또 마이 달라져꼬 또 달라징 거슨 옌날 대믄 사기는 조아져쩨요	어 그런 것도 또 많이 달라졌고 또 달라진 것은 옛날에 대면 살기는 좋아졌지요
멍 멍능 게이 기롬나 여쎔 머 고길 시라거는 세사이끼네 마래요	먹 먹는게 괴롭나 요새는 뭐 고기를 싫어하는 세상이니까 말이에요
근네 하떼 옌나레는 노다 보믕 그 지베서 쪼끔 잘사는 지베서 마랴 머 정시믈 한 때 내온딴는 저녀글 한 때 내온너 그 잠 언 잘 머꼬 잘 노다도 나완데요샌느 그릉 거또 어꼬 워 그거또 인제 이금 므 업서져 뿌래꼬 또 염배 가넴모에 놀 장서독 업서져꼬 황경은 조아져쓴 하데 지금 생할 황경은 옌날마 모태져따꼬 바요	그런데 하여간 옛날에는 놀다 보면 그 집에서 조금 잘사는 집에서 말이야 뭐 점심을 한 때 내온다든지 저녁을 한 때 내온다든지 그 참잘 먹고 잘놀다가 나왔는데 요새는 그런 거도 없고 뭐 그것도 인제 이것 뭐 없어져 버렸고 또연배 간에 모여서 놀 장소도 없어졌고 환경은 좋아졌지만 어디 지금 생활 환경은 옛날만 못해졌다고 봐요
웨 그르냐 마음 노코 모에 가유 좀 머 욕또 하고 마어찌 머 쌈도 하고 헤이 이를 때덕 일 이쌍 게 그끙 앙 그러케씀미까	왜 그러냐 마음 놓고 모여 가지고 좀 뭐 욕도 하고 말이지 뭐 싸움도 하고 허 이 이럴 때도 있 있었는 거야 그러니까 안 그렇겠습니까
짜근 녀게 절믈 때 모여 노옴 앙 아아들 때 마라 니 오르이 내 오라 함세떠 요샌 그른 세대도이쓰 지나가 쁘래꼬 그릉 거에 으에 대믄 영 모탕 끄꼬사는 황경은 조아져꼬 그르치 머용	작을 때에 젊을 때 모여 놀면아이들때 말이야 네가 옳으니 내가 옳으니 하면서도 요새는 그런 세대도 지나가 버렸고그런 것에 이래 대면 영 못한 것 같고 사는 환경은 좋아졌고 그렇지 뭐요
잘 머꼬 잘 사이께네 마알가	잘 먹고 살 사니까 말이야
그엄며느 그 혹시 인제 아까 거 이야기를 쪼금머 하션는데 성씨별로 본다며너 어르신 어려슬 때에넌 의성 김씨드리 훨심 마나씀미까 지금보다넌	그러면은 그 혹시 인제 아까 그 이야기를 조금은 하셨는데 성씨별로 본다면은 어르신 어렸을 때에는 의성 김씨들이 훨씬 많았습니까 지금보다는
마내찌여 글때 대앰뇨	예 많았지요 그때 대면요
그땐 한 어느 정도 대씀미까	그때는 한 어느 정도 됐습니까
글때 때거 사람 수짜로 바 가주거여	그때에 대어서 사람 숫자로 봐 가지고요
어예	예
사람 수짜루 보어뚱 한 육씹 사십 뽐 데 께레요	사람 숫자로 보면 한 육십대 사십으로 보면 될 거에요
한 뉵씹 포 가구 이서뜨 이서꼬	한 육십 호 가구 있었 있었고
야예예 사시 포는 타성이고	어예사십 호는 타성이고
그런데 여즈 음제 꺼꾸로 대애따 그지예	그런데 요즘 인제 거꾸로 되었다그렇지요
거 꺼꾸로 바께 덴 세미지요 머이	예 그 거꾸로 바뀌게 된 셈이지요 뭐
타성이 그아이 더 만타구 바에 지그믄뇨	타성이 그러니 더 많다고 봐요 지금은요
그다음메 혹씨 그 인제 성씨 구성으로 바서느 의성 김씨가 더 저거져꼬예 인제 타성바지가 더 마나져꼬 혹씨 무 풍습 까틍 거또 옌나레 비해서 요즘바낑 게 쫌 이씀미까	어 그다음에 혹시 그 인제 성씨 구성으로 봐서는 의성 김씨가 더 적어졌고인제 타성바지가 더 많아졌고 혹시 뭐 풍습 같은 것도 옛날에비해서 요즘 바뀐 게 좀 있습니까
풍스비 옌날 때음 마이 바께져따꼬 보제요	풍습이 옛날에 대면 많이 바뀌어졌다고 보지요
옌나레는 우리게이 머으 거러서 마알시더 이래 나선 장 거튼 데 시내 가암말시더 올리 이래 서게 나가다 봄 마제 미쩸 아놈 아무꺼시 장에 까세꼬 마리이 부르기도 하고 또 차자가서 궈뉴도 하고 이래 자아 가서 뭐 구경도 하고이래 이응 거러 댕기고 이게 일 때는 머 중간 중가이 그으 주 취 옌나릉 주마기라 그래앤데 거 술찌베 드아서 멈 모기 마름 머 마껄리도 한 잔시 사 머꼬 서로 일해 내려오게 해앤데 요샌느 그릉 거또 업써져 뻐레꼬 여어 불	옛날에는우리끼리 뭐 걸어서 말입니다 이래 나서서 시장 같은 데 시내 가면 말입니다 오늘이래 설설 나가다 보면 말이지 밑에 아무 아무개야 장에 가자고 말이지 부르기도하고 또 찾아가서 권유도 하고 이래 장에 가서 뭐 구경도 하고 이래 이래 걸어 가니고 이래 이럴 때는 뭐 중간 중간에 그 주 주 옛날에는 주막이라고 그랬는데 거기 술집에 들어가서 뭐 목이 마르면 뭐 막걸리도 한 잔씩 사 먹고 서로 이래 내려오고 했는데 요새는 그런 것도 없어져 버렸고 여기 불
이 즈 에 에 예저네 여 주마기 쫌 이써씀미까	어 이 저예 예전에 여기 주막이 좀 있었습니까
여 여 우쩨 뚬 마낸니데 여쭝 쭉 올러가머	예 여기 여기 윗쪽에 좀 많았어요 요쪽으로 쪽 올라가면
그래 그른 데 모에 가즈 참 정담도 나누고 핸데 요새느 차를 타고 다니이께네 요 우에 사는 사람 요 우에 사은 설 마카 차로 다니이께네여 그이 이 임정이랑 겓 떠 부래요	그래 그런 데 모여 가지고 참 정담도 나누고 했는데 요새는차를 타고 다니니까 요 위에 사는 사람 요 위에 사는 사람 모두 차로 다니니까 그이 인정이라는 게 떠 버려요
위으 사라미랑 거느 자주 솜 접초기 데고 마래요 얘기도 나누꼬 머 조은얘기도 하구 나쁜 얘기 따어 이 이래 모에야 정다미 나오고 즈 쯔 정이 가는  데 이러 머이 일 려느 한두 범 만내찌 말쩨 하이께네 이 정이 저거지구요	이사람이란 것은 자주 좀 접촉이 되고 말이에요 얘기도 나누고 뭐 좋은 얘기도 하고나쁜 얘기도 하고 이 이래 모여야 정담이 나오고 정 정 정이 가는데 이래 뭐 일년에 한두 번 만날지 말지 하니까 이 정이 적어지고요
그 밤며네 잉감미도오 점맘 모태요	그 반면에 인간미도 전만 못해요
고움믄 니는 네고 나는 나오 고마 그래 지내고 또 자주 모엘 기헤도 어꼬그래 데드러꼬	고만 너는 너고 나는 나고 고만 그래 지내고 또 자주 모일 기회도없고 그래 되더라고
그르기 그거는 옌날맘 모태이	그러니 그것은 옛날만 못해요
고어뜰 이야그 으느이 똑 드라끄 끄트머	그것들 이야기꼭 들라고 할 것 같으면
그 혹시 머 농사진능 거또 예저네하고 요즘 머 풍스비 쫌 달러져씀미까	그 혹시 뭐 농사짓는 것도 예전하고 요즘 뭐 풍습이 좀 달라졌습니까
아이 마이 달라져쪄이	아이고 많이 달라졌지요
옌나레는 이 점붑 포마실 핸니더	옛날에는 이 전부 품앗이를 했습니다
내가 에이 예엔 아이 입 이 지베 가서 모를 하러 에 저 지 시머 주 잔니껴	내가어이 이 집에 가서 모를 하루저 저 심어 주지 않습니까
또 저 부이 내 지베 와써 시머 주우 이릅 포 푸마씨로	또 저 분이 내 집에와서 심어 주고 이래 품 품앗이로
이읍 이 농사랑 게이 옌나른 소느로 모를 시므끼 때므네 사라미 한둘 카지암 므이 여나암씩 데이 데그더	이 이 농사라는 것이 옛날에는 손으로 모를 심었기 때문에 사람이 한둘 가지고는 안 되고 여남은씩 되어야 되거든
그래 그 이등 모도 푸멀 마아 가주 한동네 사느끼르노 머 이 가조 오느를 이지븜 머 시머 즈고 저 짐 모 시머 저고 그래 모도 농사을 지인는데 요새능 기게가 발딸데 가주우 기게가 조응 게 나와 가주 고망 개이니 이 지 지가 지 해해 뿌래 마카요	그래 이 이래 모두 품을 모아 가지고 한 동네 사람끼리니까 뭐이래 가지고 오늘 이 집 모 심어 주고 저 집 모 심어 주고 그래 모두 농사를 지었는데 요새는 기계가 발달돼 가지고 기계가 좋은 것이 나와 가지고 개인이 이 자기자기가 자기 것을 해 버려 모두가요
그르이 농사도 옌날고 인저 확씨리 달러져 뿌리멈 머 푸마씨하자 소리거 업써이	그러니 농사도 옛날과는 인제 확실히 달라져 버리면서 뭐 품앗이하자는 소리가 없어
기 기게로 해 뿌이께 인제 머 고마	기 기계로 해 버리니까 인제 뭐 고만
지 기게 가주우 또 마 오이 지 기게 엄는 사러므 나무 기게 하록 폼 주고사 가주 고마 기게루 시머 뿌이께 웨부 사럼 살 피루가 어꼬	자기 기계 가지고 또 뭐자기 기계 없는 사람은 남의 기계를 하루 품을 주고 사 가지고 고만기계로 심어 버리니까 외부 사람을 살 필요가 없고
그래 데 가즈으 그걸 바 가즈우도 농사 진능거또 옌날 가찌 이 이 정미가저거져요	그래 돼 가지고 그것을 봐 가지고도 농사짓는 것도 옛날 같지 이 이 인정미가 적어져요
인정미가 저거져 뿌래요	인정미가 적어져 버려요
그이 보믄서이 시스마끔 하이께네	그래 보면서 스스로 하니까
멍 모에 가주 머 얘기하주 시간도 어허꼬	뭐 모여 가지고 뭐 얘기할 시간도없고
허 그 그램 농사도 마이 변젹떼쩨욛 지금 머	허 그 그래 봉사도 많이 변질되었지요 지금 뭐
그암 어째뜬 예저네느 쪼곰 이 마으레 사는 사암드리 서로 인정을 마니 주고바던는데 요즘먼 그런 부분드리 머 영 적따 그지예	그러면 어쨌든 예전에는조금 이 마을에 사는 사람들이 서로 인정을 많이 주고받았는데 요즘은 그런 부분들이 뭐 영 적다 그렇지요
그르체요	그렇지요
적쩨에요 으녀 작 그이 사라미느이랑 건 자주 모에 가주 얘기를 대활 하고 이래 나츨 자주 보고 해야 정이 나능 게드더요	적지요인제 그 사람이라는 것은 자주 모여 가지고 얘기를 대화를 하고 이래 낯을 자주 보고 해야 정이 나는것이거든요
구 구 구 그게 머러지이께네 자연히 고마 정도 뜨고 또 그르 찌 접짝 수짜더 찌음 자 짱꼬 그래 데드라꼬요	그 그 그 그게 멀어지니까 자연히 고만 정도 뜨고 또 그래 접 접촉 숫자도 잦 잦지 않고 그래 되더라고요
검 그게 혹씨 머에저넫 귿웨부 사암드리 타성바지가 자꾸 마니 드러와서 그런 영향도 이씀미까 앙 그럼며넌 그그하옴 머 별 광게 업씨 인자 세워리 바껴 가주우 그러씀미까	그럼 그게 혹시 뭐예전에 그외부 사람들이 타성바지가 자꾸 많이 들어와서 그런 영향도 있습니까 안 그러면은 그것하고는뭐 별 관계 없이 이제 세월이 바뀌어 가지고 그렀습니까
그른 광게는 별로 업써요	그런 관계는 별로 없어요
머 타서이 드온다 그르 가주 머 거 정이 뜰리덩데음	뭐 타성이 들어온다고그래 가지고 뭐 그 정이 떨어지거나
타성 역씨도 그래요	타성도 역시 그래요
여 두와 가주 자기 농 자기 일 하고 여 똥어 이 시내 가서 버는 사러믄 고마 다 엗 자고 머 시내 가 뿌고	여기 들어와 가지고 자기 논 자기 일 하고 여기또 이 시내 가서 버는 사람은 고만 다자고 뭐 시내 가 버리고
그르히 또옹니 사럼하구 접초기 잘 안 데미	그러니 동네 사람하고 접촉이 잘안 되고
에이 그 그그른 경야이지 므 끄으 머 승 썽씨가 달리 와 가주우 그릉 건업써에	어 그 그런 경향이지 뭐 그 뭐 성 성씨가 달리 와 가지고 그런 것은없어요
그다으메지검까지는 주로 마으레 대해서 이야기를 해 주셔꼬그다으멘 어르신네 대해서 쪼꼼 함분 여쭈어 보  바오게씀니다	그 다음에지금까지는 주로 마을에 대해서 이야기를 해 주셨고그 다음에는 어르신에 대해서 좀한 번 여쭈어 보  보겠습니다
예 예예	예예예 예
어르신께섣 태어나서 지응까이 사러오오신 그런 내려게 대해서 쫌 이야길 해 주십씨오	어 어르신께서 태어나서 지금까지 살아오신 그런 내력에 내대서좀 이야기를 해 주십시오
혹시 태언 태어낭 고시나 그다은 나이나 띠나 이럼 부부네 대해서 함분이야길 해 주십씨여 어예	혹시 태어 태어난 곳이나 그 다음 나이나 띠나 이런부분에 대해서 한 번 이야기를 해 주십시오
글세유 그게 나는 머 능기 나이 시방 팔시비라도 여게 성장을 여어서 핸니더	글쎄요 그게 나이는 뭐 그러니까 나이가 시방 팔십이라도 여기에서 성장을여기에서 했습니다
여어가참 출생지가 여게고 또 내가 성장을 여어서 해꼬 또 이때끔음나이 팔시빋 데두룩 머어여이 또 여게를 벨러 떠나 본 녜가 어꼬 그래 사러와꼬	여기가참 출생지가 여기이고 또 내가 성장을 여기에서 했고 또 이때까지 나이 팔십이 되도록 뭐어 또 여기를 별로 떠나 본 예가 없고 그래 살아왔고
또 웅으 생화으랑 게 그리두 웨 우리게 내갇 떼어 여 머 태어나긴 태어나쓰나 하데 어릴 때 내마근 모르고 여게 머 저 쪼맨할 찌는 참 코럴 흘레고 쪼얻쪼차뎅길 찌느 서로 머 흘글 퍼부어거 장난도 하고 마래이 이릉 거또 씨름도 하고 무어 이른흥흥 이힉 경과도 이서꽁 그르고 또 머 그 옌다르능 고 궁민하꾜라그은능 그 그 쪼매 다닝 거또 머 여선 옌다레느 군새케 짠니껴 모두가	또 어생활이라는 게 그래도 왜 우리가 내가 태어 여기서 뭐 태어나기는 태어났어나 그렇기는 하되 어릴 때 내막은 모르고 여기에 뭐 저 조그마할 적에는 참 코를 흘리고 쫓아 쫓아다닐 적에는 서로 뭐 흙을 퍼부어서 장난도 하고 말이야 이런 것도 씨름도하고 뭐 이런 이 경과도 있었고 그리고 또 뭐 그 옛날에는 고 국민학교라고 그러는것 그 조금 다닌 것도 뭐 여기에서는 옛날에는 궁색했지 않습니까 모두가
머 식생활또 쫌 넝넉짱꼬 이식또 넝적짱코 그른 황경에서 그 뜨 이음 머 읻자라자 하이께네머 언 올케 먹또 모타고 어우 바른 성장도 모태따고바요	뭐 식생활도 넉넉지 않고 의식도 넉넉지 않고 그런 환경에서 그 또 이 뭐 이 자라자고 하니까뭐옳게 먹지도 못하고바른 성장도 못했다고 봐요
그이 웨이 지금드 글때가 요새거치 멍능 게데 참 식쌩화리 조아따므 키도 좀더 커스 께라고 바요	그 왜 지금도 그때가 요새 같이 먹는 것이 참 식생활이 좋았다면 키도 좀 더 컸을 것이라고 봐요
그르나 더 옌나레엔 그기 생화리 그마꿈	그러나 저 옛날에는 그게 생활이 그만큼
거럼 그럼므 어르신 그 태어나신 해가 면 년도심미까	그럼 그러면 어르신그 태어나신 해가 몇 년도이십니까
경오새이께네이 경오여니고 에 서기로느 청구백삼심녀니고 그러치 머에	경오  생이니까 경오년이고 에 서기로는 천구백삼십 년이고 그렇지 뭐요
청구백삼심 년도 경오생이고	예 천구백삼십 년도 경오생이고
으예이 경오새이고	예 경오생이고
여 그다음메 그럼며 귿그다으메 어르신 그암 태어나시기넏 여 바라메에서 태어나셔따 그지요	예그다음에 그러면 그그다음에어르신 그럼태어나시기는 여기 바라미에서 태어나셨다 그렇지요
바러미 바러미	예 바라미 바라미
항녀근 어떠게 데심미까	어 학력은 어떻게 되십니까
항녀근 게아 구 궁민하꾜 가차 유명함미다이	학력은 겨우 국 국민학교 갖춰합니다
그으 그르며는 지거븐 어뜨게 데심미까	그 그러면은 직업은 어떻게 되십니까
주로 농사어를 하셔씀미까	주로 농사를 하셨습니까
농사도 짇 지따가 또 요샌 나이 마느이 농사을 지일 수 인니끼 믄 노니덩	예 농사도 짓 짓다가 또 요새는 나이가 많으니 농사를 지을 수 있습니까 뭐놉니다
그 몸 몸 뭐 아아드리 이그 머거 이귿 떠 돈냐이덛 주고 하능 까주 머꼬 사니더	그 뭐 뭐 뭐 아이들이 이것 뭐냐 이것 돈 돈냥이나 주고 하는 것을 가지고 먹고 삽니다
예저네느 그아므 주로 머 하셔씀미까	예전에는 그러면 주로 뭐 하셨습니까
옌나레 농사지어찌 머요	옛날에 농사지었지 뭐요
그럼며너 여 어르신 그걷 형제늠 며 뿌니나 게셔씀미까	그러면은 여기 어르신 그것 형제는 몇 분이나 계셨습니까
형제는 남자는 으흐 은 머셔 명어겨이 형제뿐이래꼬그르이 오 남매지 융 남매래찌 우리가요	아 형제는 남자는어 뭐  형제뿐이었고 아그러니 오 남매지 육 남매였지 우리가요
융 남매래엔데 다 죽꼬 인지는 뚜 두리가 나마 인니대	육 남매였는데 다죽고 인제는 둘 둘이 남아 있습니다
내하코 누님 하나하우까구 나마 이꼬 너이는 주거꼬요 인제는	나하고 누님하나하고가 남아 있고 넷은 죽었고요 인제는
가므 어드게 어르싱께서 형제 거 융 남재 중에서 어드겝 메째 부니심미까	그러면 어떻게 어르신께서 형제 그 육 남매 중에서 어떻게 몇 째 분이십니까
세째 부니이 세째시더 내가	셋째 분이 셋째입니다 내가
세째고예	셋째고요
우로 누니미 두 부니고	위로 누님이 두 분이고
미트로는	밑으로는
미트로느 인제 남동새이 하나이고 여동새이 두리 이꼬 그랜니더	밑으로는인제 남동생이 하나 있고 여동생이 둘이 있고 그랬습니다
가아여 지그믄	그러면 지금은
그 융 남매래써요	그래 육 남매였어요
그암므 위에 누임 함 분 게시고 지금도 사러 게시고	그러면 위에 누님 한분 계시고 지금도 살아 계시고
예내고 그래찌요	예예 나고 그랬지요
나머지 뿌우 형제 분드른 다 자꼬를 하셔따 그지예	나머지 분 형제 분들은 다 작고를 하셨다 그렇지요
응거 다 더 떠여 으 읍쩌예 주꼬 그이더 모두	응 다 다 떠없어예 죽고 그랬습니다 모두
그 혹시 어르싱 그 부몬님 고향은 어데심미까	그 혹시 그 부모님 고향은 어디이십니까
부모 고향도 여게시더	부모님 고향도 여기입니다
그얌 부모 여 그엄므 어르신 그거 머 아까 이야기하셔씀다만 이퍙조 이래로 쭉	그럼 부모님 여기 그러면 어르신 그것 뭐 아까 이야기하셨습니다만 입향조이래로 쭉
사무 여 이씅께	사뭇 여기 있었으니까
여 사몯 조상드른 다 여 이따 그지예	여기서 사뭇 조상들은 다 여기에서있었다 그렇지요
야 야 야 여기서	예예여기서 예
에 여이서 다 거주하시고 그래 해따 그지예	어 여기서 다 거주하시고 그래했다 그렇지요
예예	예 예예 예
그러며너 아버님 어르신러이 아버님께서너 여기서 태어나셛께따 그지예	그러면은 아버님 어르신의 아버님께서는 여기서 태어나셨겠다 그렇지요
여기서 태어난데여	예 여기서 태어나셨지요
여기서 태어나셔꼬 그럼며너 어르신 어머님 고향은 어디심미까	여기서 태어나셨고 그러면은 어르신 어머님 고향은 어디이십니까
어머니 고향은 저 옌나레는거 인능 그 거 예엔 풍기 따이야 아이 저에 충청도 다냥이라 근 데 단양	어머니 고향은 저 옛날에는거기에 있는 그거기 옛 풍기 땅이야 아니 저충청도 단양이라고 그러는 데 단양
다냥군 대강며니라 근 데 거게에선	단양군 대강면이라고 그러는 데 거기에서
다냥이고	예 단양이고
예 웨각 웨가는 거게시더	음외가 외가는 거기입니다
웨가 거이 으 그럼 어머니께서 이리로 한 언제쯤 시지오셔씀미까	예외가가 거기그럼 어머니께서 이리로 한 언제쯤 시집오셨습니까
크르익게네	그러니까
므 하이뜬 오래드 오래 전 니미다 그지예	뭐 하여간 오래된 오래 전 일이다 그렇지요
오래데쩨요	오래됐지요
오래데쓰게 거 확씨리 몰씸 내가 야 자꾸 이자뿌려써용	오래됐으니까 그 확실히 모르겠습니다 내가자꾸 잊어버렸어요
혹씨 그어 어르신 귿 조부모 조부께서도 여기 태어나셔쓸 꺼고	혹시 그어르신 그 조부모 조부께서도 여기에서 태어나셨을 것이고
여겓씨더	예 여기입니다
게속  야이야조부모옫 조부모도 여 태어나여	예예조부모 조부모도 여기에서 태어나셨어요
그암며느 혹씨 어르신태어나셔슬 때 할머니미 게셔씀미까	그러면은 혹시 어르신태어나셨을 때 할머님이 계셨습니까
할머니 게선니더 네	예 할머니 계셨습니다 네
내가 궁민하꾜 이 이 일 항년 땐지 이팍할 때에 그 그해 도러가신는데	내가 국민학교 일 일 일 학년 때인지 입학할 때에 그 그해에 돌아가셨는데
가머 할머니느 어디	그러면 할머니는 어디
할머니인 다시리시더 요게 요 요게 보 여	할머니는 닭실마을이십니다 요기에 요기 요기에 보면 여기
아 여 여쭈이 다 다시레서 오션네에	아 요기 요쪽에 닭실 닭실마을에서 오셨네요
야예 권씨 권씨 거	예예 권씨 권씨 거기
아 권씨씨고예	예권씨시고요
끄다으메 그 어머님 머 가며늗 다냥 어느 성씨가 어트게 데심미까	그다음에 그 어머님 뭐 그러면은 단양 어느 성씨가 어떻게 되십니까
예 다냥	예단양
거게능 기 김녕 김가씨더	거기는 김 김영 김가이십니다
김녕	아 김영 김씨
예이 김녕 김씨로 쓰고 예이 김녕이고 거언뇨	예김영 김씨로 쓰고예 김영 김씨이고 거기는요
예예예예 김녕	예 김영 김씨
이 깅가요 예예예	이 김가요 예
그다으멥 어르신 그 부몬님들께서느 하신 니른 그암 주로 어떠 닐 하셔쓰미거 생어브로	그 다음에 어르신 그 부모님들께서는 하신 일은 그럼 주로 어떤 일을 하셨습니까 생업으로
글세 그 생어비라 그릉 건느 우리 이 찜 맹이 주로 농사지 머요	글쎄 그생업이라고 그러는 것은 우리 이 저 역시 주로 농사이지 뭐요
농사지꼬 머 그래 그래 머 거으 긍그이 사러와찌 머에	농사짓고 뭐 그래 그래 뭐 그 근근이 살아왔지 뭐요 예
거므 어르신 부몬님들도 여게서 은제 주로 생어브로 농사를 하셔짠	그러면어르신 부모님들도 여기에서 이제 주로 생업으로 농사를 하셨지요
예예 생어븐 농사지 그언 나니 농사지 머 이 주로	예 생업은 농사이지 그뭐 농사지 뭐 이 주로
머 이 옌나르 다릉 게 이서께씀미까	뭐 이 옛날에 다른 것이 있었겠습니까
그으다으메 어르신 그 인제 그 배우자께서는 푸 부이는 지곰 어느 지여게서태어나셔씀미까	그 다음에 어르신 그 인제 그 배우자께서는 부 부인은 지금 어느지역에서 태어나셨습니까
크 거게는 여 봉와군 추냥면 서배기라 그르는 데써요	그 거기는 여기 봉화군춘양면 서벽리라고 그러는 데요
이으 그어여 맹 추냥며니 그은넫 청주 정으으은씨에서 이 정가로 이 정가고요 네	이 그 역시 춘양면이 거기인데 청주 정씨에서 이 정가고 이 정가고요 네
가므 청주 정씨에서 봉화 추냥에서 태어나셔 가주고 거 어르신 인제 이리로바래미로 시지블 오션는데 주로 언제쯤 머 며 어르신 연세 메 싸레 거화초글 발거	그러면 청주 정씨에서 봉화 춘양에서 태어나셔 가지고 그 어르신 인제 이리로 해저리로 시집을 오셨는데 주로 언제쯤 뭐 몇 어르신 연세 몇 살에 그화촉을 밝혔습니까
그게 내개 시물일고베이 결홍을 해쓰이께네	그게 내가 스물일곱에 결혼을 했으니까
부인께서는 여 그때 연세가 어떠게 데에씀미까  거가 내보다 네 사리 쩌그 여 네 사리 저그이께네	거기가 나보다 네 살이 적으니네 살이 적으니까
스물세시다 그지에	스물셋이다 그렇지요
시물세시우 그르치 머여	어 스물셋이고 그렇지 뭐요
끄엄며너 그 그 봉화 추냥에 대애서는 쪼곰 함붕 거 아까어 부잉께섣 청주정씨라고 하셔찌예	그러면은 그 그 봉화 춘양에 대해서는 조금 한 번 그 아까부인께서 청주 정씨라고 하셨지요
예청주 엉가	예예 청주 정가
그암믄 그 그 그릉까 처가때기 데는데 거 처가땍 마으레 대애서 쫌 함무 이야기를 쫌 해 주이소	그러면 그 그 그러니까 처가댁이 되는데 거기 처가댁 마을에 대해서 좀 한 번 이야기를 좀 해 주십시오
거기가 요기서 한 오심 니 떠러진 녀 봉고군 추냥면 서변니라 근 덴데 그 금정광산 드가능 고 사인 동넨데 그 동네에는 맹 산중 똥네라	거기가 요기에서한 오십 리 떨어진 여기 봉화군 춘양면 서벽리라고 그러는 데인데 그 금정광산으로들어가는 그 사이의 동네인데 그 동네에는 역시 산중 동네야
산중 동넨데 이으 거어서으 그음 우리이 시꾸도 거어서 태어나고 거어서 성장해꼬 그래 가주 봉화 이리 해저르 출가흘 참 히 시지블 와꼬 나능 그리 장가을 가고 히케 핸는데 그 머 동네가 이 조아요	산중 동네인데 이 거기에서 그음 우리 식구도 거기에서 태어났고 거기에서 성장했고 그래 가지고 봉화이리 해저리로 출가를 참 이 시집을 왔고 나는 그리로 장가를 가고 이렇게 했는데그 머 동네가 이 좋아요
거 인심 조코또늠 머으 거으가머이 벨 흉푸이 엄뜨라꼬 거가보이껜 머 은데 전다븐 머 산중 비스탄 땅이라도 농사도 잘 떼고 머 생와릉 대다수거 깨 여그 여게보다 차라리 나아 짠나 그래 바따꼬 나는녀	거기 인심 좋고또는 뭐 거기가뭐이 별 흉풍이 없더라고 거기가 보니까 뭐 인제전답은 뭐 산중 비슷한 땅이라도 농사도 잘 되고 뭐 생활은 대다수가 꽤 여기 여기보다 차라리 낫지 않나 그래 봤다고 나는요
춘냥 쪼게도 그 너 받츤걷 그쪼에드 땅은 쫌 널븜 펴닝 거 가씁띠다 추냥	춘양 쪽에도 그 뭐 밭은 머 거기 그쪽에도 땅은 좀 넓은 편인 것 같더라고요 춘양
예예아 예예 거가산전뚠 전지라도귿 땅이 갠차너요	예거기가예 산전 전지라도그 땅이 괜찮아요
거 그르구 살기가 모도 갠창코 거어난 또 그래 그 머 집성초니 아이고 그른 동네는	그 그리고 살기가 모두 괜찮고 거기는 또 그래 그 뭐 집성촌이 아니고그런 동네는
이스 점브가 머 각썽이 모도가 머 모에 사는 동네고 으흐 그르습띠다	이 전부가 뭐 각성이 모두가 뭐 모여 사는 동네고그렇더라고요
어게 장개을 가 보이께네	거기에 장가를 가 보니까
그러며넏 어르신 그거 머 그 배우 부이는 그암 어떠켑 만나서 결혼해씀미까	그러면은 어르신 그것 뭐 그 배우자 부인은 그럼 어떻게 만나서 결혼했습니까
옌날른 그게 인제 이 중매결혼이래찌 머요	옛날에는 그게 인제 이 중매결혼이었지 뭐요
저기 중매결혼이래앤데 그래 웨 내가 그 당시 파 바 가주우는 이 그 글때는쪼꿈 내가엳 장가가 느즌 세미라요	저기 중매결혼이었는데 그래 왜 내가 그 당시 봐 봐 가지고는 이 그 그때는 조금 내가 장가가 늦은 셈이에요
그게 머 그 글땐 시무 살 시무대애 쌀 모두 장개앤데 나느 그 시물일고꺼짐니이써쓰니까 그래 머어 으으 그래 장개가 느져꼬 에 중매렬해 가주오 결호니 데 가주 장갈 간니더	그게 뭐 그 그때는 스무 살 시믈대여섯 살 모두 장가인데 나는 그 스물일곱까지 있었으니까 그래 뭐그래 장가가 늦었고 에 중매를 어해 가지고 결혼이 돼 가지고 장가를 갔습니다
그래 중매결혼해꼬요	그래 중매결혼했고요
쭈 중매는 누가 하셔씀미까	중 중매는 누가 하셨습니까
중매결호는 그르이 우리 맹 족치닌데 이응 일간데 일가 어르니 그으 그 지비 거어도 왜가이 데에요	중매결혼은 그러니 우리 역시 족친인데 일 일가인데일가 어른이 그 그집이 거기에도 외가가 돼요
웨가이 데 가주설랑은 그래 나를 그리 중맬 해 가주 그래 에 그 이 그 이 결호니 데엔니더	외가가 돼 가지고설랑은 그래 나를 그리로 중매를 해 가지고 그래에 그 이 그 이 결혼이 됐습니다
족친께서 인저 하셔따 그지여	아 족친께서 인제 하셨다 그렇지요
예예	예
그래스스 거쪼옥 족친부닏 저쪽 천장찝하고 영겨리 데다 보니까어 하셔꼬	그래서 그쪽 족친분이 저쪽 친정집하고 연결이 되다 보니까어 하셨고
예예예 아웨 예이예	예예예 예
그다음 보 요주우미야 머 여내결혼하는 사암들도 망코 에예 그다으미 머중매하으서 만나서 결혼하능 거또 마는데 그암 그때 그 결혼하 중매으를 해써결혼할 때 머 중매해써 결혼하능 과정이 이써쓸 꺼 아임미까	그다음 보 요즘이야 뭐 연애결혼하는 사람들도 많고그다음에 뭐 중매해서 만나서 결혼하는 것도 많은데 그럼 그때 그 결혼하 중매를 해서 결혼할 때 뭐 중매해서 결혼하는 과정이 있었을 것 아닙니까
네 과저이 이쩨요	네 과정이 있지요
그때 므 대충 어떤 시어러 결헌하션는지 어르신 결혼 때에	그때 뭐 대충어떤 식으로 결혼하셨는지 어르신 결혼 때에
글때 결호능 그래 가주 은제 결호누 과저이 그래 인제 머 이 결호니 적쩌이 양가가 이 양가에 어름드리 승나기 나먼 거 이 즈 총오 그읃 중개르참중매를 하든 사럼 와서 승나기 데쓰이께너이 결호늘 성사어이 성사가 데쓰이줌비를 하라 그게지 머	그때 결혼은 그래 가직 인제 결혼 과정이 그래 인제 뭐이 결혼이 적절히 양가가 이 양갸의 어른들이 승낙이 나면 그 이 저 저 그 중매를어 참 중매를 하던 사람이 와서 승낙이 됐으니까 결혼을 성사 성가가 됐으니 준비를하라 그것이지 뭐
읻 줌빌 하미 인제 여기서는 남자 쪼게사 강서늘 써 가주 은제 심부 쪼으로보내코 또 어으 그래고 인제 날짜를 결혼 날짜을 바다 가주 홀렐 치루코 그래쳐 머이 좌으 쪽 과정이	이 준비라 하면 인제 여기서는 남자 쪽에서 강선을 써가지고 인제 신부 쪽을 보내고 또그러고 인제 날짜를 결혼 날짜를 받아 가지고혼례를 치르고 그랬지 뭐요 좌우 쪽 과정이
그엄면 어드겝 그거 인저스 날쓰 결혼 날짜너 호닌 날짜넌 호닌 날짜는 처가 쪼게서 자바슬 꺼 아임미까	그러면 어떻게 그것 인제 날 결혼 날짜는 혼인날짜는 혼인 날짜는 처가 쪽에서 잡았을 것 아닙니까
이히마자여 그래 자반녀 거어서 자반니더	예맞아요 그래 잡았거기에서 잡았습니다
여 여 여기서 사주단자하고너 여기서 보내쓸 꺼고	여 여 여기에서 사주하고는 여기에서 보냈을 것이고
어예예 여어서 보내 으야 야아	예여기에서 보내예
어르신 사주단자하고너 저쪼으로 보내애고	예 어르신 사주단자하고는저쪽으로 보내고
예예	예
그엄며너 끄어 그 사주단자하고 이거 보내앨 때느 어뜨게 보낸는직 함븐	어 그러면은 그 그 사주단자하고 이것 보낼 때는 어떻게 보냈는지 한 번
사주단자 보낸능 거느이 여기써 인제 그 머으 그거사주를을으 머 구그 사주을하 그능 거 머 지 맹 점 비스탕 게라 그르	어 사주단자 보내는 것은여기서 인제 그 뭐 그것사주를 뭐 그 그 사주라 그러는 것은 뭐 저 역시 점 비슷한 것이야 그것은
그걸 인제 으 써 가주고 그 강서니라 그능 걸 맨드르 꺼 머 인제 머 머 헝겁꺼틍 거또 머 쪼매 여코 그러씁띠다 보이께네	그것을 인제써 가지고 그강선이라고 그러는 것을 만들어 그 뭐 인제 뭐 뭐 헝겊같은 것도 뭐 조금 넣고 그렇더라고요 보니까
해 가주고 사라믈 보내 여 우리 동네 사러믈 그리 보내뜨라꼬	해 가지고사람을 보내 여기 우리 동네 사람을 그리로 보내더라고
그얼 강서니라 함미까	그것을 강선이라고 합니까
강선뇨	예 강선이요
그걸 사람 누구한 누우한테 보내 누가 누구 시켜스 보냄미까	그것을 사  람 누구한 누구한테 보냅 누가 누구를 시켜서 보냅니까
그래어 으어 우리 동네 사라미래 맹뇨	그래우리 동네 사람이에요 역시요
그커 으 글때 여게 사아뜽 그 윤 씬데 윤달출 씨라꼬 응 그 부니 강서늘 가조 가떼래써 글때	그그때 여기에 살았던 그 윤 씨인데 윤달출 씨라고 응 그분이 강선을 가지고 갔더랬어요 그때
그래 가주 그어 전내 주고	그래 가지고 그것을 전해 주고
거우 강서네늠 머 머 드러감미까 그럼며너	그 강선에는 뭐 뭐 들어갑니까그러면은
강서네 인제 사주학코 그그 머저 양가에 하비한 호닌 날짜하코 고래가고 머 저 오까지가 하나 먿 드가지 씹쓰더 멍가 보이께네	강선에 인제 사주하고 그것 뭐저 양가에서 합의한 혼인 날짜하고 그래서 거기 뭐 저 옷가지가 하나뭐 들어가지 싶습니다 뭔가 보니까
은 그르치 시픈 모시여 오래덴 니리 가주고 멈 오까미 하나 머 그 드가지 시퍼에	어 그렇지 싶은데 모르겠어요 오래된 일이라 가지고 뭐 옷감이 하나 뭐 그들어가지 싶어요
머 저고리까미이니 치마까민지 근 이이 오래뎅 기라서 끼여그	뭐 저고릿감인지 치맛감인지 그것인 이 오래된 것이라서 기억이
그릉 거 하나가 보내코 그래 보내습띠다	그런 것 하나 보내고 그래 보내더라고요
그엄며너 어째뜬그르가 강서늘 보내 가주고 그럼며너 저쭈게서 처가 쪼게서 날짜를 자버 가지오 그럼며너 이리로 통보를 함미까 어뜨케 하미까	그러면은 어쨌든그래 가지고 강선을 보내 가지고 그러면은 저쪽에서 처가 쪽에서 날짜를 잡아 가지고 그러면은 이리로 통보를 합니까 어떻게 합니까
아이래 이그 강서니 갈 찌겐 함머 여게서 날짜에 자버쩌지 시프이더	아니야 이것 강선이 갈 적에는 벌써 여기에서 날짜를 잡았지 싶습니다
그 호닌 날짜는 여 여 으영 우리가 자버찌 시퍼이	그 혼인 날짜는 여기 여기 여기 우리가 잡았지 싶어요
심부 쪼게서 잡짜네 여기서 강서네 날짜꺼저 자버 가즈 아저 보내찌 시프이드 이제 생카 보이	신부 쪽에서 잡지 않고 여기서 강선에 날짜까지 잡아 가지고아주 보냈지 싶습니다 이제 생각해 보니
그 저짜서 바등 게 아이고	그 저쪽에서 받은 것이 아니고
으 그램 거어성 고마 그 바든 날짜르 매 승나기 덴 게고	어 그러면 거기에서그만 그 받은 날짜로 역시 승낙이 된 것이고
그래 그래	그래 그래
그럼며너인제 그 날짜 자꼬 은제 강성 보내고 난 다으메느 어르시니 저리로 심부 쪼오고 처가 쪼그로 가서 인자 호닌시글 거기서 하지 안씀미까	그러면은이제 그 날짜 잡고 이제 강선 보내고 난 다음에는 어르신이 저리로 신부쪽으로 처가 쪽으로 가서 이제 혼인식을 거기에서 하지 않습니까
예예 그 그르체요 거거 그	예 그 그렇지요 거기 그
거므 여기 가실 때 추냥까지느 어뜨에 가셔쓰미거	그러면 여기 가실 때 춘양까지는 어떻게 가셨습니까
누구호랑 어떠게 가셔씀미까	누구랑 어떻게 가셨습니까
그 글때는 여게 인제 장개가능 게 인제 내 으 부모인지 참 부친하꼬 내아꼬 그어 또 저 그극 강서녈 그어 이 그 머로혼수를 가주 가능 혼수애비라그능 사람하꼬 맹 글때도 하나 데리고 그래 서이 가써요	그 그때는 여기 인제장가가는 게 인제 나부모인제 참 부친하고 나하고 그 또 저 그 강선을 그이 그 무야혼수를 가지고 가는 혼수아비라고 하는 사람하고 역시 그때도 하나데리고 그래 셋이서 갔어요
서이로 그쭈우서믄 뻐수로 가 가주고 으 글땐 거 뻐쓰가엑 귀해써에 길또마거 자갈끼레 투덜투더하고 그래 조일 거어 가서 거어서 내리 가주고 그 동네에서 인제 가마알 보내뜨라꼬 문제 실랑이 인제 가마 타고 두오라 그래 그 그거겍 가서 그 여 여관찌베 숙빠글 하고 므 고 이트나 인제 은 홀렐 치루키 때므레 거 응 거 이튼날 거어스 자고 나이께네 가마럴 보내 가주 그 가마 타고 장개가딱 고래 배움 본다	셋도 그쪽까지는 버스로 가 가지고그때는 그 버스가 귀해서 길도 모두 자갈길에 울퉁불퉁하고 그래 종일 거기에 가서 거기에서 내려 가지고 그 동네에서 인제 가마를 보냈더라고 뭐 인제 신랑이 이제 가마 타고 들어오라그래 그 그 거기에 가서 그 여 여과에 숙박을 하고 뭐 그 이튿날 인제혼례를치르기 때문에 그그 이튿날 거기에서 자고 나니까 가마를 보내서 그 가마 타고장가갔다 그렇게 보면 돼요
그엄며는 거으 지음 상개그로 따러가심 분느너	그러면은 그 지금 상객으로따라가신 분은
상개글 아부지고 그르치 머	상객은 아버지고 그렇지 뭐
아브지 혼자 가셔씀미까	아버지 혼자 가셨습니까
그르체요	그렇지요
에 여 곰마 혼수애비하콘	어 여 그만 혼수아비하고
혼수애비하고	혼수아비하고
내하쿠 서이 간 세미너	예 나하고 셋이 간 셈이지요
그럼며 거기 거 귿때 가슬 때 혼수늠 머 주로 머 가지고 감미끄슴미까	그러면 거기 그 그때 갔을 때 혼수는 뭐 주로 뭐 가지고 갔습니까
혼수는 그 맹 머그게 머 읻 치마저구리지 시퍼에 내 생가게 치마저구리래찌 시퍼요	혼수는 그 역시 뭐그게 뭐 이 치마저고리지 싶어요 내 생각에 치마저고리였지 싶어요
그래 가주 그검 머 엄 머 비담보에 싸 가주우 그래 가주 가찌 시퍼임미다	그래 가지고 그것 뭐뭐 비단보에 싸 가지고 그래 가지고 갔지 싶습니다
감 치마저구리 처루 가주 가꼬 그다음메 보통 인즈 상개건 어트게 머그어 크나부지너 자은아부지도 보통 가시는데 어떠게 부몬니미 웨동이셔씀미까	어 그럼 치마저고리를 저리로 가지고 갔고 그 다음에 보통 인제 상객은 어떻게 뭐그 큰아버지나 작은아버지도 보통 가시는데 어떻게 부모님이 외동이셨습니까
아이래래여 여우 크나부지가 여 게셔써두 크나부지보다 아부지가 가신따이	아 아니에요 여기 큰아버지가 여기 계셨어도 큰아버지보다 아버지가 가십니다
검 어째뜬 스 상객으로느 머 그냐 아번짐마 머 카 보통 가신다 그지예	그럼 어쨌든 상 상객으로는 뭐 그냥 아버지만 뭐 가 보통 가신다 그렇지요
네 예에예예 아버지만뇨	네예아버지만요
그러며느 거이서 그럼며느 가셔 가주고 어르신 그날 거이서 초레를 거기서치러찌예	그러면은 거기에서 그러면은 가셔 가지고 어르신 그날 거기에서 초례를거기에서 치렀지요
초레을 치루체 초렐 치루고	예 초례를 치르지 초례를 치르고
그읍 그엄며너 아까 이제 으 어디 추냥 거 머 현동이나 그쪼게서 주무셔씀미까	그 그러면은 아까 이제어디 춘양 거기 뭐 현동이나 그쪽에서 주무셨습니까
아이래 그 동네아피 바러	아니야 그 동네앞에 바로 예
아니 예를 드 그 동네 아페서 인제 주무시고 그쪽 인제 처가 쪼게서 보내응가마를 타고 거 초레르 치른 날	아니 예를 들어서 그 동네 앞에서 인제 주무시고 그쪽 인제 처가 쪽에서 보낸 가마를 타고 그 초례를 치른 날
예하어이 초레 장그까지 가제요	예예 초례 장소까지 가지요
가가션는데 그 가서 인제 초레를 치려슬을	가셨는데 그 가서 인제 초례를치렀을
초레얼 치르쳐	예 초례를 치르지요
치르지에	치르지요
초레를 치러고 그름며넌 어르시너 꺼 초렐 치르고 거기스 머 쫌 게셔씀미까 앙 그암며너 어떠케 하셔씀미까	어 초례를 치르고 그러면은 어르신은 그 초례를 치르고 거기에서 뭐 좀 계셨습니까 안 그러면 어떻게 하셨습니까
바로 오셔씀미까	바로 오셨습니까
거기스 아이지엑	거기에서 아니지요
거기스 한 이틀 이써쩨요	거기에서 한 이틀 있었지요
이 이틀 이스	이 이틀 있었
천날빠믈 거어서 자고 으 그 이튼날 와쩨요	예 첫날밤을 거기에서 자고어 그 이튿날 왔지요
오시고 또 그다으메 그 상개그로 가셔떤 아번니믄 당일랄 바로 오셔꾸에	오시고 그다음에 그 상객으로 가셨던 아버님은 당일에 바로 오시고요
당일랄 바로 오시고	예 당일에 바로 오시고
혼쑤애비하곧  도라오셔꼬	혼수아비하고  돌아오셨고
아이 가래 야 혼수애비야꽁 가치 오고나능 거어서 어어 하루빰 자고 은즈 그 이튼날 와꼬 그러치요 머 이	아그래혼수아비하고 같이 오고나는 거기에서하룻밤 자고 인제 그 이튿날 왔고 그렇지요 뭐 이
그럼면 거기 으인제 그어 인제 그게 인제 장개가능 건데 에에 장개가어서거이 글 하고 거므 하얻 하 니틀 거이스 주무시다가 일로 혼자 오셔씀미까 앙그러며너 그때 부임 가치 오이 어떠케 하이시씀미까	그러면 거기 인제 그 인제그게 인제 장가가는 것인데장가가서 거기서 그렇게 하고 그러면 한 한 이틀 거기에서 주무시다가 이리로 혼자 오셨습니까 안 그러면은 그때 부인과 같이 오셨 어떻게 하셨습니까
아이지여 글때 끄 글때는 저 무근 신행독 이썬데 그겨 글때능 고마 엥잉 내가 오능 기메 고마 신행꺼증 다 해쓰미다	아니지요 그때 그 그때는 저묵은 신행도 있었는데 그게 그때는 그만이 내가 오는 김에 그만 신행까지 다했습니다
안 안식꾸두 가치 와씀니다	안 안식구도 같이 왔습니다
신행을	신행을
사밀 신해이지 그게	어 삼일 신행이지 그게
이제 쫌 개하가 데따 그지예	이제 좀 개화가 됐다 그렇지요
개화가 떼아 예예	예 개화가 돼서 예
예전 까트며넌 무근 신행 해 가주고 한 일 녀니나	예전 같으면은 묵은 신행을 해 가지고 한 일 년이나
어옌나렌 머 이 메 태씩 익이 인는 수두 이써쓰이께네요	예 어옛 옛날에는 뭐 이 몇 해씩 있 있는 수도 있었으니까요
머 저께 이써드 일 려니고 머 아이 나아 가주고 보통 오 도라오능 게 그유신행 오는데	뭐 적게 있어도 일 년이고 뭐 아이를 낳아 가지고 보통 오 돌아오는게 그 신행 오는데
어흐 그르차하 오능 게 만투먼 네예 마내찌 브여그릉 게 마너쩨이	어 그렇지 오는 게 많더만 네 많았지 뭐그런 게 많았지요
그른데 인저 마니 인저 개화가 데 가주고	어 그런데 인제 많이 인제 개화가 돼 가지고
개화데에꼬 그르코 그기 또 그 그른 예걷 또 이써요이	예 개화됐고그렇고 그게 또 그 그런 예가 또 있어요
개와도 덷찌만느 그 무근 신해이라 그으녀 황경에 따라 데에요	개화도 됐지만은 그 묵은 신행이라는 것은 환경에 따라 돼요
그 어뜨냐 하게 데모 황겨이라 그겸 머 실랑 쪼기 황겨이 조튼지 심부쪼기 황겨이 조튼지 비슫삐스태야 그게 무근 신해이 데능 게라요	예를 들어 그 어떠냐 하게 되면 환경이라는 것이 뭐 신랑 쪽이 환경이 좋든지 신부 쪽이환경이 좋든지 비슷비슷해야 그게 묵은 신행이 되는 거에요
무근 신행을 한다 그능 거는 거우 그르이 그어 머 거게서 사모 머꼬 자고맹 그래 생가 생활비도 머 으 그짜섭 부담 데야 데고으 그른 녜르 나아지머 우리거튼 황경이느 머 저짜아도 넝넉찌 모타고 우리 넝넉찌 모따으 그르니까 이거 머 무근 신행 할 피료 업따 으르이 그마 사밀 신행 하자 이래하비하에서 사밀 치내이 뎅 게래요	묵은 신행을 한다고 그러는 것은 그 그러니 그것 뭐거기에서 사뭇 먹고 자고 역시 그래 생활 생활비도 뭐그쪽에서 부담 돼야 되고그런 예라면 나가지만 우리 같은 환경은 뭐 저쪽에도 넉넉지 못하고 우리도 넉넉지못하고 그러니까 이것 뭐 묵은 신행 할 필요 없다 그러니 그만 삼일 신행 하자 이래합의하에서 삼일 신행이 된 거에요
꺼 머 으 그게 개화가 떼 가즈 뎅 거뚜 아이고 자여니 그 황경에 따러서도그래 데능 게	그 뭐그게 개화가 돼 가지고 된 것도 아니고 자연히 그 환경에따라서도 그래 되는 거야
이긍 그으또 방개화지 그러이께네	이 그것도 반개화지 그러니까
머 어여 일단 그 머 그 경제저그로나 이럼 부부네서 양가가 어느 정도 비슫할때 그를 수 인는 부분인데	뭐일단 그 뭐 그 경제적으로나 이런 부분에서 양가가 어느 정도 비슷할 때 그럴 수 있는 부분인데
아헤야 아예아그르체요 아예예 무근 신해이 마이 성행데에꽁	예 예예 그렇지요묵은 신행이 많이 성행됐고
어째뜬 쫌 머 저랴글 하시는 겸해서	어 어쨌든 좀 뭐 절약을 하시는 겸해서
거 그르치요 저랴카능 거지야	예 그 그렇지요 절약하는 것이지요
예예 그르서 금 신행을 빨리 이자 오신능 그른 세미다 그지예	예 그래서그럼 신행을 빨리 이제 오신 그런 셈이다 그렇지요
예 그르처요	예그렇지요
그어므 인제 그어 신행월 인제 여 오셔 가주고 여기서도인제 그어 그뭠미까 어르신 대게서도 잔치를 하 하지예	그러면 인제 그 신행을 인제 여기오셔 가지고 여기에서도인제 그 뭡니까 어르신 댁에서도 잔치를 하 하지요
그르치여 잔칠 해야 데지요이 잔치를 해야 데	그렇지요 잔치를 해야 되지요 잔치를 해야 돼
잔찌럴 하능 거시 오먼 인제 쎄 이 인제 내학코 시꾸하꼬 거 으 가치입 오믄 동네슨 새득 꾸경하러 온다 그고 마리야 이 지베 내애흐애흐으 저익 여자잘르 보로 모도 오능 게라	잔치를 하는 것이 오면 인제 저 이 인제 내하고 안식구하고 그같이 오면 동네에서는 새댁 구경하러 온다 그러고 말이야 이 집에 내 저여자를 보러 모두 오는 거야
으 새드기 와씨이 이 임무리 으어 어뜨노 머 어뜨노 늘건나 절믄나 이거또 보고 머으 그래 동리이서 모도그으 잔치를을를르 보로 와요	어 새댁이왔으니 인 인물이어떻나 뭐 어떻나 늙었나 젊었나 이것도 보고 뭐 그래 동리에서 모두그 잔치를 보러 와요
그래 인제 신행 잔체라 그러써 그너 인제	그래 인제 신행 잔치라고 그랬어그것인 인제
신행 여자가 오 오능 거는 신행 잔치라 그러 가주고 동니서 모도 인제 구경을 와요	신행 여자가 오 오는 것은 신행 잔치라고 그래 가지고 동리에서 모두인제 구경을 와요
그래업 오멈 머 잘사는 지베는 머 특수한 대지블 하제염	그래 오면 뭐 잘사는 집에서는 뭐 특수한 대접을 하지요
머 그 머검 음식또 마이 장마나고 머 손님도 마이 히에음 망코으 그르쳐먼또 그 황경에 따러서그케 넝넉짜는음 머어시는 컨 손님도옥 어꼬 그저동네서즈 정니저그로 우 와 가즈 모두 신행 구경하고 그런 수로 이꼬	뭐그 먹을 음식도 많이 장만하고 뭐 손님도 많이 이래 많고 그렇지만 또 환경에 따라서그렇게 넉넉지 않은어 사람은 큰 손님도 없고 그저 동네에서저 인정상와 가지고 모두 신행 구경하고 그런 수도 있고
그으너 이제 황경에 따르서 좌우데능 게래여 이거 보이께네요	그것은 이제환경에 따라서 좌우되는 거에요 이걸 보니까요
거므 신행 오실 때에너 그쪼게서느 어떰 부니 오심	그러면 신행 오실 때에는 그쪽에서는 어떤 분이 오십니까
그게서는 어찌 뎅가 긍가영그 나는 울 때 그 읻 쩌 이 내 자인 데늠 부는도러가시 띠래꿈미 함마	거기에서는 어떻게 되었나 그러면 나는 올 때 그 이 저이 내 장인 되는 분은 돌아가셨을 때였습니다 벌써
내 즈 이 이 초행 저네	내 저 이 이 초행 전에
그러꾸 그어 내 처오촌 데늠 부니 오촌 데늠 부니 여얼 와띠래서 사앙 그상개그로	그렇고 그 내 처오촌 되는 분이 오촌 되는 분이 여기를 왔었어 상 그상객으로
그래 내 으 우리집 상개그로 와서 여게 와간녀 하로빰 주무시고 그 이튼널 도러가시고 에 델따 주고 그래 가고 그래따고 그래	어 그래 내 우 우리집상객으로 와사 여기에 와서는 하룻밤 주무시고 그 이튿날 돌아가시고데려다 주고 그래 가고 그랬다고 그래
그다으메 그때 머 혼수 가틍 경우너결훈 레물 가틍 거너 주로 어떵거 주롣	그 다음에 그때 뭐 혼수 같은 경우는결혼 예물 같은 것은 주로 어떤것을 주로
결홍 예무이러 그능 게 인제 참 쪼끔 저네드 얘기핸데 마이 그은 끼리끼리모에야 데잉 게라꼬요	결혼 예물이라 그러는 게 인제 참 조금 전에도 얘기했는데말이지 그것은 끼리끼리 모여야 되는 거라고요
이 지금도 그른 서얼미 이께찌요	예 이 지금도 그런 성질이 있겠지요
옌날또 맹 그륵 께리끼리그 데능 겐데 어이 덴 하게 뎀먼 이 여 호닌 예무리라 그능 거시 머 도니 이스멈 머 금반지도 해이고 금모꼬리 해도 데고 머으 금장시글 해 준 거시 조치마는 황경이 허락 짜능 사러믄 머 움 모탄 사럼도이게 이꼬	옛날에도 역시 그래 끼리끼리 되는 것인데 어떻게 되었나 하게 되면이 여기 혼인 예물이라 그러는 것이 뭐 돈이 있으면 뭐 금반지도 하고 금목걸이도 해도 되고 뭐금장식을 해 주는 것이 좋지만은 환경이 허락하지 않는 사람은 뭐 어못 하는 사람도 이렇게 있고
또 머으 으 그보 쪼끔 모탐 또 거 더 음반지 한 사암도 이꼬 또 으 금반제핵 해도 머 한 돈쭈이나 으 이 쪼매낭 걸로 이래 먿 표시만 하고 또 잘사느 지벤 머 항저 업씬 해 주고 우리 거뜬 추 처지에너 그저 머 다일 이 이 금 머음 조선 오시르 그제 함보글 잉으 다일 닝게 이벌 함 불 정도 해 주고 또 그머반지라 그능 거늠 머 쪼매넝 거즈 실반지 정도 데찌 시꼬 응 거 그윽그래 지내서여	또 뭐그보다 조금 못하면 또 그 저 은반지 하는 사람도 있고또 어어 금반지 해 해도 뭐 한 돈쭝이나이 조그마한 것으로 이래 뭐 표시만 하고 또 잘사는 집에서는 뭐 한정 없이 해 주고 우리 같은 처 처지에는 그저 뭐 당일입 입을 그 뭐조선 옷이라고 그러지 한복을 이 당일 입 입을 한 벌 정도 해주고 또 그 뭐반지라 그러는 것은 뭐 조그마한 그저 실반지 정도 됐지 싶고 음그 그 그래 지냈어요
그 그때 혹씨 그어 그럼며 시 실라 어르신 쪼게서 그어 심부 쪼게 머 예물 해 드링 거너 머 머 해 드려씀미까	그 그때 혹시 그 그러면 신 신랑 어르신쪽에서 그 신부 쪽에 뭐 예물 해 드린 것은 뭐 뭐 해 드렸습니까
그어 그케 인제 말항 게 이 예무리랑 게	그 그래 인제 말한 게 이 예물이라는 게
모 태 조따꼬	못 해 줬다고
그래 이그 금 실반지 비스탕 거 그어 금반지 한 돈쭘도 그어 자 란 데께라	그래 이것 금 실반지 비슷한 것 그것 금반지 한 돈쭝도 잘 알 될거야
한 동쭘 몰래 그은 내마겐	한 돈쭝 몰라 그 내막에 대해서는
여 그그 하나 해꼬 그 머 이브 다임 이블 져 옫 함 불 해꼬	여 그것 하나했고 그 뭐 입을 당일 입을 저 옷 한 벌 했고
치마저고리 해돈	치마저고리 했고
마에 치마저구리 해꼬으 그게지 머	맞아 치마저고리 했고 그것이지 뭐
요즈음 요 그 예전 요즘도 머 엄는 사암드렁 그르게 그 하고 그래 함미다는 예저느 그 당시엔 더 그러쓸께따 그지예	요즘 요 그 예전 요즘에도 뭐 없는사람들은 그렇게 그 하고 그래 합니다만은 예전에는 그 당시에는 더 그랬었겠다 그렇지요
예아 옌나레는 머 익 기양 자수 성네하는 사럼도 마내 짠니꾜에	예 옛날에는 뭐 이 그냥 자수 성례하는 사람도 많았지 않습니까
그 참물 항 그륵 떠 노코 기양 고마 마쩔하구 곰마 결혼한 녜도 이꼬 엄 사러미 황겨이 허락 짜느먼 그른 녜도 이써꼬	그 찬물 한 그릇 떠 놓고 그냥 그만맞절하고 그만 결혼한 예도 있고 없는 사람이 환경이 허락하지 않으면 그런 예도 있었고
그 그어기 혹시 그 끄어름며는 심부 쪼게서 심부 쪼게서 이 씨이집올 때 에시집올 때아 혼수너 보통 그 땅시에늠 보통 어뜨게 해씀미까	그 거기 혹시 그그러면은 신부 쪽에서 신부 쪽에서 이 시집올 때시집올 때 혼수는 보통 그 당시에는 보통 어떻게 했습니까
에 에	예 예
심부 쪼게서 머시어 여게업 올 때는머 칭구 이부자리 또 머 그 으 옫머 오 꺼틍 거 오깜 거틍 거 마에때여 오시머 시어런 멍 오깜 시어이 어이그 이 양 애분능 오깜 머 또 실랑 바지저구리 머 이 정도라 해 가지 오지 머예	신부 쪽에서 뭐 여기에 올 때는뭐 침구 이부자리 또 뭐 그옷 뭐 옷같은 것 옷감 같은 것 말이지요 옷이면 시어른 뭐 옷감 시어른이이것 이양 어른들 옷감 뭐 또 신랑 바지저고리 뭐 이 정도로 해 가지고 오지 뭐요
그래 그 잘사는 지벤 또 황정 어꼬 그릉 거는뇨	그래 그 잘사는 집에서는또 한정 없고 그런 것은요
잘사는 지벤 먹 우움 머므 차로 메 빠리시 실꼬 뎅긴 집또 이 짠니껴	잘사는 집에서는 뭐어 뭐 차로 몇 바리씩 싣고 다니는 집도 있지 않습니까
잘사는 지븐 그르코	잘사는 집은 그렇고
이여 그르치만 이 고고 황경이 헉 허락 짜느멩 게와 그저 나리나 넹긴 수도이꼬 그래 짠닉 글때느	예 그렇지만 이 뭐냐 환경이 허 허락하지 않으면 겨우그저 날이나 넘기는 수도 있고 그랬지 않습니까 그때는
그영까 머 다 살기 나름네	그러니까 뭐 다 살기 나름으로
녜 그케요	예 그러게요
살기 나르므로 그래 핸능 게 그 당시 그으고그람며 그때 어르신 그 인제 결혼하셔 가주고인제 부잉께서 오셔슬 때 그거 어르신 그거 부몬니믈 모시고 사셔씀미까 어떠케 사셔씀미까	예 살기 나름으로 그래 했는 게 그당시 그것이고그러면 그때 어르신 그 인제 결혼하셔 가지고인제 부인께서오셨을 때 그것 어르신 그것 부모님을 모시고 사셨습니까 어떻게 사셨습니까
가치 사몽 모시고 사러쩨요 머	예 같이 사뭇 모시고 살았지요 뭐
으 글땐 내어 머 장남 처지루설랑은 으에 머 또 황겨이 넝너칸 다으메삼 머이르 좀 떠르여스 사은 수도 이짜모 황경도 옹와 생와름 빱뜨탄데 이 이 이입 두 찝 살리먼 살 수도어꼬 그래 은 그래 금 머 어으이 머 그여 사모 모시고 사러찌 머이	어 그때는 내가 뭐 장남 처지로서뭐 또 환경이 넉넉한 다음에 뭐 이래 좀 떨어져서 사는 수도 있지만 환경도생활은 빠듯한데 이 이 이이 두 집 살림은 살 수도 없 없고 그래그래 그 뭐뭐 그 사뭇 모시고 살았지 뭐요
도러가실 때까지	돌아가실 때까지
머 그 당시엔 머 지금도 마창가짐니다마는 대개 끄어 어째뜬 그 당시에너머 장남 가틍 경우너 어째뜬 다 모시고 부몬님 모시고 사셛스니까	뭐 그 당시에는 뭐 지금도 마찬가지입니다만은 대개 그 어쨌든 그 당시에는 뭐 장남 같은 경우는 어쨌든 다 모시고 부모님 모시고 사셨으니까
그케예예 그르디키탕 그 긍 그르타꼬고 바끄드 글땡 고므 점부 다가부몰 모시거 사능 게 그 원치기라꼬 바꼬 그래 으때 이요서	예 그렇게예 그렇다고 그 그 그렇다고 봤거든 그때 고만 전부 다가부모를 모시고 사는 게 원칙이라고 봤고 그래 그때 요기에서
거므 그때 그 부잉께서 시집오셔쓸 때 부모님 웨에 누거 형제분드른 누우구 시집 앙 간 형제분드리나	그러면 그때 그 부인께서 시집오셨을 때 부모님 외에누가 형제분들은 누구 시집 안 간 형제분들이나
이서쩨용	있었지요
누구 누우 게셔씀미까	누구 누구 계셨습니까
시동새이 하나 이써꼬 내 바러 미테 동새이	어 시동생이 하나 있었고내 바로 밑에 동생이
또 그다으메 이기 여동새이 이 이 두리 이써꼬 그래쓰미네여	또 그 다음에이게 여동생이 이 이 둘이 있었고 그랬습니다
그럼며 어째뜬 거 여동생 둘 이쓰꼬그다으메 미테 남동생하오 그르게세 부니 더 형제 저 시 시집 앙 가고 장가 앙 간 세 부니 더 게셔따 그지예	그러면 어쨌든 그 여동생이 둘 있었고그 다음에 밑에 남동생하고 그렇게 세 분이 더 형제 저 시 시집 안 가고 장가 안 간 세 분이 더 계셨다 그렇지요
그래서 그엄며는 부잉께서 오셔 가주고 어째뜬 머 나머지 동생 세 부는 장가 보내고 십브집 가고 이러케 핸네예	그래서 그러면은 부인께서 오셔 가지고 어쨌든뭐 나머지 동생 세 분은 장가보내고 시집가고 이렇게 했네요
결과저그로으 그른 세미저	결과적으로 그런 셈이지요
그게 인제 이 제일 미아넝 거십 그 참 그 장남미야 건늗 채기미 그겍 이꼬 보먼 참 조은데 어어 어꼬 보먼 낭감하다꼬	그게 인제 이 제일 미안한  것이 그 참 그 장남이라는 것은 책임이 그게 있고 보면 참 좋은데 없 없고 보면난감하다고
웨냐 후우 머 오 부모한떼 재선 물레바능 거또 만 창코 그 어꼬 게와 식쑤 여 참느 인 식쌩와런 해 나간데 그 결혼쓰게자 그능 게 머엳 쯔 참 그게 쉬운 니리 아이 리이이리래껄머은	왜냐 그것 뭐부모한테 재산 물려받은 것도 많지 않고 그 없고 겨우 식생활 여 참 이 식생활은 해 나가는데 그 결혼시키자고 그러는 게 뭐 저 참 그게 쉬운 일이 아닌 일이었거든요
쉬운 니리 아이래유	쉬운 일이 아니에요
그 머 나미 볼 땐느 그까지 꺼또 장 으 참느 잔체라 글찌 몰래도 그 당사자는 버겁따꼬 그어또요	그 뭐 남이 볼 때는 그까짓 것도 잔참 잔치라 그럴지 몰라도 그 당사자는 버겁다고요 그것도요
으어 그러씁띠다 그게	어 그렀더라고요 그게
에 사라보이께네	에 살아보니까
으 그마끔 에릅뜨라 구게요	어 그만큼 어렵더라고요 그게요
마쓰미드 쫌 넝넉하며넌 쫌 더	맞습니다 좀 넉넉하면은 좀 더
넝너카므 쪼그	예 넉넉하면 조금
혼수도 쫌 더 잘해 줄 수	혼수도 좀 더 잘해 줄 수
예아 넉너캄머 이에예 내 마음버트문 더 조우 께래업	예 넉넉하면내 마음부터 더 좋을 거에요
우선 동생이든지 머 매부라든지 그른 사암인데 흡쪼케 해 보내 주믄 얼마나조케쓰에 그에	우선 동생이든지 뭐 매부라든지 그런 사람에게 흡족하게 해 보내주면 얼마나 좋겠어요 그게
그른데 그게 안 데이께네 그 잠 낭감하더라꼬	그런데 그게 안 되니까 그 참난감하더라고
그그보다 더 서 참 어흔 안타까운 일히히으 업습띠다	그것보다 더 저 참 어안타까운 일이 없더라고요
어째뜬 그르케 보며늠 머 지곰 부잉께스도 아마 고새을 마이 하셔슬 꺼 가코	어쨌든 그렇게 보면은 뭐 지금 부인께서도 아마 고생을 많이 하셨을 것 같고
해씀니다	예 했습니다
어미테 세 분 장가보내고 하시고 시	아어 밑에 세 분 장가보내고 하시고 시
예아 예아 이여인 이거 머 그자랑말 이른 아임니다마능 고생도 해씀니다	예예 이 이것 뭐 그자랑할 일은 아닙니다만 고생도 했습니다
머 그 그걸 고생항 걸 자랑응 하니꺼씀니다마는 고생을 좀 해씀니다	어뭐 그 그것을 고생한 것을 자랑을 하겠습니까만은 고생을 좀 했습니다
엄는 지베 와 가주고 그 첨 이만침예 싹 상 거도 마이 사라꼬	없없는 집에 와 가지고 그 참 이만큼예 산 산 것도 많이 살았고
그 당시에 머 다 어려워쓸 때니까	그 당시에 뭐 다 어려웠을 때니까
허아 참 내 그거 이야기 참	아 참 나 그것 이야기 참
아마 그런 부분드리 쪼그믄또 나썽 고세 와서 아무래도 살기그 쉬운 니  른 아니네여	아마 그런 부분들이 조금은또 낯선 곳에 와서 아무래도 살기가쉬운 일은 아니지요
그래요 그르예 에 쉬운 니릉 아이지므 또 근나따나 나썬 동네 와 가주오 나 집 설고 나썬 지베우 와 가지욷 더군두나 군새칸 살림한다 그능 게 얼마나 에로워께써에 그게	그래요 그래예쉬운 일은 아니지만 또 거기에다 낯선 동네에 와 가지고 낯 집 설고 낯선 집에 와 가지고 더군다나 궁색한 살림한다고 그러는 게 얼마나 어려웠겠어요 그게
여 참 말 모탈 사저이지요	예 참 말 못할 사정이지요
어르싱께서으 혹씨 처가찌베 가셔슬 때너어 처가 시꾸드른 어떠케 구성데가이써씀미까	어르신께서 혹시 처갓집에 가셨을 때는 처가 식구들은 어떻게 구성되어 있었습니까
아까 장인어르는 도러가셔따 하셔꼬	아까 장인어른은 돌아가셨다고 하셨고
그이 처가에 가이께네 그 당시는 쩌을르 그 머거로 그읻 장모가 게셔꼬 또 마처나믄 쩌겓 처나미 형제부이래꼳 처제가 두리래엔데야 허르이 마처나멍 객찌이 나가 이 이써꼬 두째 처나미 그어서 인제 참 지별 꾸리고 사아고구련데 거거우 가 보이께네 머 구 그릅씨다으 거어도 머 그키 잘사은 집또 아이고 므 내나 그어나 조쌍	예 그 처가에 가니까 그 당시는 저기 그 뭐냐 그 어이 장모가 계셨고 또 맏처남은 저기 처남이 형제분이었고 처제가 둘이었는데 그러니 맏처남은 객지에 나가 있 있었고 둘째 처남이 거기에서 인제 참 집을 꾸리고 살고 그랬는데 거기에 가 보니까 뭐 그 그렇더다고요 거기에도 뭐 그렇게 잘사는 집도 아니고 뭐 나나 거기나 비슷하게
그르이 머 내게 꺼 니 경게라꼬 내 지비 군새카이께네 나무 지베 가도 맹 조심스럽따고	그러니 뭐 내 것이 너 경계라고 내 집이 궁색하니까 남의 집에 가도역시 조심스럽다고
맹 잘사는 집 꺼뜸멕 갠잔 빠빠탄 지에 맹 저도 내 거튼너이 심저익 아이겐나 하는 생가기 뜨러 가주 하로 도 노오 꼬또 몬 놀래드라꼬요	역시 잘사는 집같으면 괜찮지만 빠듯한 집에 역시 저기도 나 같은 심정이 아니겠나 하는 생각이 들어 가지고 하루 더 놀 것도 못 놀겠더라고요
마슴미다	맞습니다 예
피히가 덴다꼬 마리저이	피해가 된다고 말이지요
믁 그래 가주우 므안 데 다일 나온 수도 이꼬	뭐 그래 가지고 뭐 당 당일에 나오는 수도 있고
으 그른 녜가 마네니드	어 그런 예가 많았습니다
그런데 잉 그 으 그게 인제 이 결호니라응 게 이게 맹 며 으 서로 비스태야데엑 이 이 데드라꼬	그런데 이 그그게 이제 이 결혼이라는 게 이게 역시 뭐어 서로 비슷해야 돼 이 이 되더라고
그여 너무 잘사는 지베 또 즈 장개까보오 너어므 바리 마리음 너그 머 잘사는 지비 장개간 사름 얘기 드르머 홀때바은다 그래고	그 너무 잘사는 집에 또저 장가를 가 놓으면 다른 이의 말로는 뭐 잘사는 집에 장가간 사람 얘기 들으면 홀대받는다 그러고
끄 어이 지 저까짐 므 사이 온달 잘또 보고 사은다 그 홀때바다 소리음 나오  고	그저 저까짓 뭐 사위 온달을 잘도 보고 산다 그러면서 홀대받았다는 소리만 나오고
우리잉 겨꺼 보지 아너씨이 그릉 거는 모르고	우리는 겪어 보지 않았으니 그런 것은 모르고
그래도 사정어영 그르트라꼬 그게요	그래도 사정은 그렇더라고 그게요
그러미 지금 그 부잉께서 그암며너 처가찌베섣 형제 중에서 가운뎁심미까	그러면 지금 그 부인께서 그러면은 처갓집에서 형제 중에서 가운데이십니까
딸로늠 마지고요 딸로늠 마지고이 형제 수니느 세째고 그래지요	딸로는 맏이고요 딸로는 맏이고이 형제 순위는 셋째고 그렇지요
예 위에 인자 까므 오 오라비 쫀	아위에 인제 그러면 오 오라비가 좀
야 에어 그 우에 에예 두리고	예그 위에둘이고 예
오라비 두 붕 게신고	오라비 두 분 계시고
으예예	예예
은젇 딸 부이니시고 그다음 미테 처제 두 붕 게시고 그래 게시다 그찌예	인제 딸 부인이시고 그 다음 밑에 처제 두 분 계시고 그래 계시다 그렇지요
이제에응어예 그러컫드 그랜니더	아 이제예그렇고그 그랬습니다
지그믕 그럼며너 머 부인 입짱에서 보며넌 시대게 지곰 게심 분드너 다름 분드른 아무도 앙 게시지예	지금은 그러면은 뭐 부인 입장에서 보면은 시댁에 지금계신 분들은 다른 분들은 아무도 안 계시지요
머 형제분들 누님 함 분 게시고	아 뭐 형제분들 누님 한 분 계시고
누님 함 부릳 게시고여 땀 부는 다 모	예 누님 한 분이 계시고 다른 분은 다 뭐
다 도러가시 자꼴 하셔꼬	다 돌아가셨고 작고를 하셨고
예음 머 머그르이	예예뭐 뭐그러니
지움 다른 분드르 앙 게신다 그지예	지금 다른 분들은 안 계신다 그렇지요
예예	예
그엄므 혹시 어르신 여기에 그어 머 사촌 가니나 유 육촌 가니나 그렁 경우나 이릭 똥네이 게심미까	그러면 혹시 어르신 여기에 그 뭐 사촌 간이나 육 육촌간이나 그런 경우가 이 동네에 계십니까
예아사촌 육초는 믿 인니더 여게더 모두	예사촌 육촌은 있 있습니다 여기에도 모두
큰지비 여 이꼬 그른데 거게 역씨도 또 며천 개찌이 가 이꽁 요 머 삳 으데 여가 여 여머시그 여 저한 지비 사고 인니더마능그 거어도 맹 그으한 집빼께 업써 여게더	큰집이 여기 있고 그런데 거기 역시도 또 몇은 객지에 가 있고 요기 뭐 살 어디 여기 여 여뭐냐 여 저한 집이 살고 있습니다만은 거기도 역시 한 집밖에 없어요 여기도 예
그 살고 게시늠 분도	아 그 살고 계시는 분도
어예 이예	예 예
그 그엄 객찌에 주로 은젇 출향아 하셔따 그지에	그 그러면 객지에 주로이제 출향을 하셨다 그렇지요
서울 서 예아출향 출	예 서울 서예 출향 출
그다으미 그 어르신 혹시윽 군대느 다녀오으오셔씀미까	그 다음에 그 어르신 혹시 군대는 다녀오셨습니까
내가 군대을 모 까씀니다	내가 군대를 못 갔습니다
웨 모 깐냐 하기 데믄 내겅 누널 다치뜨래씀다	왜 못 갔냐 하게 되면 내가눈을 다쳤더랬습니다
누늘 다처 가주 글때 신체검사 하이께네 불하껴기 데 가주오 군대늠 모 까쓰여	눈을 다쳐 가지고 그때 신체검사를 하니까 불합격이 돼 가지고 군대는 못갔어요
그래 가주고 또 결호니 쪼끔 느저꼬 그래씀다 내가	그래 가지고 또 결혼이 조금 늦었고 그랬습니다 내가 예
누 누늘 다치셔 아주구 그러셔따 그지예	눈 눈을 다치셔 가지고 그러셨다그렇지요
보통 어움 그읍 어르싱 게셔 어르신 연배 때넏 군대 다 가셔찌예 대개너	보통그 어르신 계실 어르신 연배 때는 군대 다 가셨지요 대개는
대개 다 가찌용	대개 다 갔지요
이 그러치예	이 그렇지요
예이	예
대개 다 가 주고 신체 머이이짜기 결하미 인는 사럼드런 모 까꼬	대개 다 가 가지고 신체 뭐이이쪽이 결함이 있는 사람들은 못 갔고
으우 군대는 모 까써도 군대에이으 강 거보다 더 겨꺼씀니다	어 군대는 못갔어도 군대에 간 것보다 더 겪었습니다
숩탄 험항 거 다 바쓰음다	숱한 험한 것 다 봤습니다
머 이이 보구때르 건늠 명칭 띠아 가주 마리야 여어도 끌꼬 가고 저거또 꿀꼬 아우 수타이 따라 뎅기다 봄멀 으 군대에 가슨 차라리 더 나아쓰 께레요	뭐 이 보급대라 그러는 명칭을 붙여서 말이야 여기도 끌고 가고 저기도 끌고 가고숱하게 따라 다니다 보면군대에 갔으면 차라리 더 나았을 거에요
그거 이 요새 말하땀 쩌 이 제대쯔이라두 하나 이찌요	그것 이 요새 말하면저 이 제대증이라도 하나 있지요
이거또 어꼬 저거또 어꼬 전쟁은 더 겨꺼씀니다	이것도 없고 저것도 없고전쟁은 더 겪었습니다
머 수탕 아군도 전쟁 겨꾸오 이 임밍군 전쟁도 겨꾸꼬 마리 여게도 끌래에따 저어도 끌래따 이리 이래 데 뿌르나 마래	뭐 숱한 아군도 전쟁을 겪었고 인 인민군 전쟁도인민군과 함께도 겪었고 말이야 여기에도 끌려 갔다 저기에도 끌려 갔다 이래 이래 돼 버렸단 말이야
으걱 그 커 커 거 그거는 어으 말하라 금 말로 참 전 지 채그로 써도 채그도 모 쓰 께레요	어 그 그 그 그 그것은말하라 그러면 말로 참 저 저 책으로 써도 책으로도 못 쓸 거에요
하 하이따 고생한 건뇨	하 하 고생한 것은요
어을떵 꼬새이 데 가주우요 아이구 키아낭 고생해씀니다	엉뚱한 고생이 돼가지고요 아이고 희한한 고생했습니다
혹씸 머 할 때 기엉나시능 거 이쓰면 함무 이야기 쫌 해 주실람미까	혹시뭐 할 때 기억나시는 것 있으면 한 번 이야기 좀 해 주시렵니까
유기오 절란 때	육이오 전란 때
아하유기오용	아하육이오요
거 억 고생하셔떵 그런 부부네	그고생하셨던 그런 부분에
제엘 가차운 요게소부틈 함시더	제일 가까운 요기에서부터 합시다
글때가 오심 년도올쩨 그이 유월 그게 이식구일라림니다	그때가 오십 년도지그 유월 그게 이십구 일입니다
여게으 구 강원도오서 응 기 윽가원 경찰때가 여게 나와쓰네 요 아페다리 아페 여게 와 이썬 주두늘 해씀미다	여기 그 강원도에서그어 강원 경찰대가 여기에 나왔었는데 요 앞에 다리 앞에 여기에 와 있었는데 주둔을 했습니다
주동을 해 이써꼬 그르다 이께넥 거기서 우리으 동네에다 가따 사라므 차출하능 게라요	주둔을 해 있었고 그러다 보니까 거기에서 우리 동네에 갖다 사람을차출하는 거에요
사람 차출하능 게 내보다 절믄 사암더 구 내보다 나이 마은 사암더 걷 다서시 차추리 데 가 데우 그 사암들 따러 가써요	사람 차출하는 게 나보다 젊은 사람도 있고 나보다 나이 많은 사람도 있고 다섯이 차출이 돼 가지고 되어서 그 사람들 따라 갔어요
따르 가니거 저어서부틈 보고푸믈 나르랑 게러 시러 가주	따라 가니까 저기에서부터 보급품을 나르라는 거야 실어 가지고
으 탄도 날러 주고 땅맏 포탄도 나르아 그오 탄 그래 가주 그어 저 읻저 사님니다 바로 요 이 요 딛써네 여게 군대가 걱 강원도 경찰때거 엳 지는쳐쓰미다	어 포탄도 날라 주고 다른 것 뭐 포탄도 나르라고 그러고 포탄 그래 가지고 그 저 이 저 산입니다 바로 요 이 요 뒷산에 여기에 군대가 그 강원도 경찰대가 진을 쳤습니다
거어서 저어서 인제 으 삽쩨에석 그날 비가 와연데으 군대가 둥오능 게래요	거기에서 저기에서 인제삽재에서 그날 비가 왔는데 군대가 들어오는 거에요
끄 이겨 총 쏘능그널 첨 바씀니당	그 이것 총 쏘는 것을 그날 처음 봤습니다
총을 띠리 말그 기완총을 싸 대고 하이그 저어서도 쏘고 마리지 야단 나느꺼 띠 이 은지 주거따 시퍼떠라고호 난	총을 이리 막 기관총을 쏴 대고 하니까저기에서도 쏘고 말이지 야단 났는 것 같더니 이 인제 죽었다 싶더라고 나는
크래 가주고 그날 마쭘 너므가이께음 으 그 쳐어선 드오능 게 아구니랑 게라요	그래 가지고 그날 마침 넘어가니까그 저기에서 들어오는 게 아군이란 거에요
그래 가주이 여섬 모에 가조 고서 닫쌔마네 이 즈 저기서 후테엘 한데 그군대엘 따라가즈 저꺼춤 나가스음당	그래 가지고 여기에서 모여 가지고 고기에서닷새만에 이 저 저기에서 후퇴를 하는데 그 군대를 따라서 저기까지 나갔습니다
저으 저 안농꺼지 거이 다 가씀다	저 저 안동까지 거의 다 갔습니다
거어 가이께 예고개라 그언데익 그어 가이께 산뜽게에서 먼딩기믄 임밍구니막 총을 쏜데 마리에요 머 잉 베라기 납띠다	거기 가니까 예고개라고 그러는데거기 가니까 산등성이에서 뭐 인민군이 막 총을 쏘는데 말이에요 뭐 이 벼락이 나더라고요
구루이 머 오우 궁겨어먼 처미제 이어 으어트게 처살 해야 사나하능 거빼게 생각찌 않트라꼬	그러니 뭐그경험은 처음이지 이어어떻게 처사를 해야 사나 하는 것밖에 생각나지 않더라고
그래 가주우 거어서늠 머이 인지는 이 여이슨은 이 중는 수배께 업따 한생가인 덷 드르거 거서 그마 다라나씀니다	그래 가지고 거기에서는 뭐이인제는 이 여기서는 이 죽는 수밖에 없다 하는 생각이 들 들어서 거기에서 그만 달아났습니다
아이구 그 인 내가 사자 하니까 마알 총아른 비빨치지여 머 포타는 떠러지지에 포타넙 빠러지제 머 명녕 게통독 업서요	아이고 그 이 내가 살자고 하니까 말이지 총알은 빗발치지요 뭐 포탄은 떨어지지요 포탄은 떨어지지 뭐 명령 계통도 없어요
머구 군대고 머고 미 니 어얘라 소리 하는 사럼도 어꼬 장교도 어꼬사병도 업써여 고맏 지머때르 그마	뭐그 군대고 뭐고 뭐 너는 어떻게 해라소리를 하는 사람도 없고 장교도 없고 사병도 없어요 그만 제멋대로 그만
머 구 주 구 여 산 산떼미에서잉 께이 기총 사결드리 해 대이 차에서 내리이께네 짐마끔 다 다라나 뿌능 게라	뭐 그 저 그 여 산 산등성에서 그 기관총 사격을 해 되니 차에서 내리니까 저마다 다 달아나 버리는 거야
눔 차즐 떼도 업써 어름 검 므 난 내대로 내빼고 저 늠 저 늠대로 내빼고	어느 놈 찾을 것도 없어 그런 것 뭐 나는 나대로 도망가고 저 놈은 저 놈대로도망가고
그래 가주우 그 길라 해 가주우 와 유에 동네꺼짐 드와써 여기르 또	그래가지고 그 길로 해 가지고 어찌 어떻게 동네까지 들어왔어 여기를 또
그래가 참 스 쓰 사 사라완니드	그래서 참 살 살 살아왔습니다
그른 째기드 이썬니더	그런 적도 있었습니다
그 그엄 그래가 그때 이	그 그럼 그래서 그때 이
그래 가주걱 거 인제 이 이거 그 엗 다라나기 차에 내리 가주우 막 난 사람중능 그 거리 첨 바씀니다	그래 가지고 그 인제 이 이것 그달아나기 차에서내려 가지고 막 나는 사람 죽는 것을 그때 처음 봤습니다
끄유 구니니 총에 마자가조 공막 칵 카믕거 끄고 머 게누안 자빠지디 고마 머고맏 다시 소시기 업뜨러꼬	그 군인이 총에 맞아서 그만 칵하면서 그러고 뭐 괴로워 넘어지더니 그만 뭐 그만 다시 소식이 없더라고
그이게 나느 또 이 여게서 구 우리 참 이여여 순지난 마으미러여 큰 그 그걸로 사러미 주거씨이 어예 데서 갇 자바때기이께넫 삑삑 소리므 나고 마알지 말또 모 타더라꾸	그러니 나는 또 이 여기에서 그 우리 참 이 순진한 마음에 큰 그그걸로 사람이 죽었으니 어떻게 되었나 하며 가서 잡아당기니까 삑삑 소리만 나고 말이지 말도 못 하더라고
그러이께네 이 여페 사람 이따그 그 주긍 구 머하러 만지누 쿠며 얼 내뺀다 그래써허	그러니까 이 옆에 사람이 있다가 그 죽은 것을 뭐하러 만지냐 하면서 얼른 도망간다 그랬어
그래가주 내 거 사람 주웅 그 첨 바쓰음다	그래서 내 그 사람 죽은 것 처음봤습니다
그래가 함믇 겨꺼씀다	그래서 한 번 겪었습니다
그래가이 끄거 사미 궤상한 니를 다 이써찌 머히	그래서 그것 참 괴상한 일이 다 있었지 뭐요
거 유기오 때 그어 어띠에 보며너 마쓰임더 어르심 말씀대로 군대 가쓰며너 그전네 정경 참전 그거 여 저	그 육이오 때 그 어떻게 보면은 맞습니다 어르신 말씀대로 군대 갔으면은 그전에 전쟁 참전 그것 여기 저
예아 응응예 참전 요새 으이 그 이 쩌으 으어 기 다멍능 궈 지 참전 용사비라도 타 먹제 이구 그으또 모 타 머구 고생은 수탕 고생하고	예 응 예예 참전 요새그 이 저그 타 먹는 그 저 참전 용사비라도 타 먹지 이것은그것도 못 타 먹고 고생은 숱한 고생하고
응 그뿌이껴 그래거 또 또고 다가멛 또 불레 나가 가주설랑 또 겨꼬곰 벨꺼떠 다 얘 그까이 다 얘기하 껀 어어꼬 함 번 겨꺼씸 데꼬 사라옹께 그래씀니다	응 그뿐입니까 그리고 또 또 다음에 또 불려 나가 가지고설랑 또 겪었고별것도 다 얘기 그것까지 다 얘기할 것은 없고 한 번 겪었으면 됐고 살아온 게 그랬습니다
그땜 머 어터에 그럼며너 이 피난늘 가셔씀미까 여기서	그때 뭐 어떻게그러면은 이 피난을 가셨습니까 여기에서
여기서 피란 모 까찌요	여기서 피란 못 갔지요
그르이 글땝 따라 나가씸 피라니 덴는데 지베엽 부모드리 여겍 이씨이께 그그 갈 쑤거 업떠릉	그러니 그때 따라 나갔으면 피란이 됐는데 집에 부모들이 여기 있으니까 그 갈 수가 없더라고
나도 구오 거우 거으가 고마 그 차로 고마 가 사머 그 군대 따러 가씨믄 또우에씨든지 주거쓸 사러찌 모르제	나도 거 거 거기 그만 그 차로 그만 가서 사뭇 그 군대를 따라 갔으면 또 어떻든지 죽었을지 살았을지 모르지
그느 하으떼 그어서 기스벌 당애 가주우 닥 티이께네엔 저리 가기보던 지브로 와에 덱 뿌엔누	그래 하여튼 거기에서 기습을 당해 가지고 탁 달아나니까 저리가기보다는 집으로 오게 돼 버렸지
구우땐 내아 머 객찌랑 거 도통 상상도 모 태쓰이께네 우선 지베브텅 가이데이따 그래 가주욷 데두오이께네 피란 모 깐 세미 데찌 머 이 그러이께네	그때는 내가 뭐 객지란 것을 도통 상상도 못 했으니까 우선 집에부터 가야 되겠다그래 가지고 되돌아오니까 피란 못 간 셈이 됐지 뭐 이 그러니까
그르가 그라고느 여기 머 도 임밍군드리 그암며너 여어겓 주루해씀	그래서 그러고는 여기 뭐 또 인민군들이 그러면은 여기에 주둔 안 했습니까
임밍군두 와 이써쮸 유게	인민군도 와 있었지요 여기에
주둔해써찌야	주둔했었지요
여게 와 이써씀다	여기에 와 있었습니다
여기가 으여이 이 이 여이가 으엥 밍 병워니 여기 채리 가즈 이서쓰미당	여기가이 이 여기가뭐 병원을 여기 차려 가지고 있었습니다
임밍군 병워네	아 인민군 병원이요
응 예예예 임밍군 병워니 여 와 이써써요	응인민군 병원이 여기 와 있었어요
그래가주 여 이 임밍군드림 망 머 이 쩌 거이 집찜매덩 다 와 이써쓰미다	그래서 여기 이 인민군들이 막 뭐 이 저 거의 집집마다 다 와 있었습니다
검 그때 혹시으 몸미까 그 임밍구네서느 징집해가주 과셔슴미까 어르신	그럼 그때 혹시 뭡니까 그 인민군에서는 징집 안 해 가지고 가셨습니까어르신
임밍구니이히 임밍군녜라 그릉 그또 역씨 보급때 그여 당 해따꾸 기암 머에	인민군이 인민군이라 그러는 것도 역시 보급대 그래 다 했다고 그 뭐
임밍군니라 그능 게 그으또 내거이 이른 소리꺼짐 할 피룐 업찌만느 웨 그른냐 하게 떼믄 동네 우리 또래드리 메찌이 이써씀다	인민군이라 그러는 게 그것도 내가 이런 소리까지 할 필요는 없지만은 왜 그러냐 하게 되면 동네 우리 또래들이 몇이 있었습니다
여 메 찝 이썬데 그게 이게 흉이 덴데	여기 몇 집 있었는데 그게 이게 흉이 되는데
그래서 어째뜬 그럼  그럼 부부네서 예저네 참 고생을 마니 하셔따 그지예	그래서 어쨌든 그런 그런 부분에서 예전에 참 고생을 많이 하셨다 그렇지요
고생 마이 해찌요 마 애덩	고생 많이 했지요 많이 했어
얻 어에 어트게 본다며너 얻	어 어떻게 어떻게 본다면은 어
또 나능 그르코음 웨냐 하게 뎀 내 종배씨가 순사러 이써써에 글때요	또나는 그렇고 왜냐 하게 되면 내 종백씨가 순사로 있었어요 그때요
경찰과니읃 이써 가주설랑 여기 내가 두와 주 주목또 마이 바다쓰임다	경찰관이 있어 가지고설랑 여기 내가 들어와 가지고 주목도 많이 받았습니다
에에 이거 머 거 백씨가 즈 종백씨가 순사라 카는 명칭 때므래도 그 이 임밍군들또 날 조케 암 바꼬 으 그른 녜덩어 마내씀다 그	에 이거 뭐 그 백씨가저 종백씨가 순사라고 하는 명칭 때문에도 그 이 인민군들도 날 좋게 안 봤고그런 예도 많았습니다 그
그건 머 까지 얘긴 치아 뿌 그래 이거 상 거먼 다행이고요 우리가	그것은 뭐 까짓것 얘기는 치워 버리고 그래 이것 산 것만으로 다행이고요 우리가
그르기 동네 덕태기 모두 사라꼬 그릉 이 아이끼	그러게 동네 덕택에 모두살았고 그런 것 아니겠습니까
그 험한 세상에	그 험한 세상에
그으도 으 참 이 그 당시에 에 그음 어뜨헤 피난 앙 모 까고 도러가심 분들도 망코	그래도참 이 그 당시에 에 그 어떻게 피난 안 못 가고 돌아가신 분들도 많고
만체여	많지요
만제요 거이 고생 다 해찌 머요	많지요 거의 고생 다 했지 뭐요
꺼 어르신 아까 그어쫌 이야기를 해 주시 어르신 보닌 이야기를 쫌  해 주션는데 이제 보닌 이야기 아니고오요줌문 점부 결호늘 하게 데며너예식짱 가서 안 함미까	어 그 어르신 아까 그좀 이야기를 해 주셨 어르신본인 이야기를 좀 해 주셨는데 이제 본인 이야기가 아니고요즘은 전부 결혼을하게 되면은 예식장 가서 안 합니까
예시장 그르차	예식장 그렇지요
요즘 절믄 싸암들	예 요즘 젊은 사람들
점부 예식짜이저 글체	전부 예식장이지요 그렇지
에 읍 아마 요줌 예전처럼 시고레서 또느 자기 지베서 초레 치르거나 이른사암 아무도 업찌 안씀미까	예아마 요즘은 예전처럼 치골에서 또는 자기 집에서 초례 치르거나 이런 사람 아무도 없지 않습니까
허르체거	그렇지요
가끔 머 어디 향교나 저런 데서 엔날씨 방시그로 저여 그 홀레 치르능 경우 인는데 너 옌나레 그어 이 동네에 쫌 잘사는 집뜰 가틍 경우에 쩌 홀레 치를 때 어뜨게 어떤 시그로 함미까	가끔 뭐 어디 향교나 저런 데서 옛날식 방식으로 저 그 혼례 치르는 경우가 있는데옛날에 그 이 동네에 좀 살사는 집들같은 경우에 저 혼례 치를 때 어떻게 어떤 식으로 합니까
옌나레 홀레 치룬능 가능 닝 그 그르테 보이께네 옌머 조이 견덴 집좀 황경이 조은 집뜨런 그엄 엄 마 첨 날짜도 머 거게 동네가 다 아고 머 온동네가 축뽁도 하고 마아찌 추카도 하고 그래고 또 그언이 거 이 결혼 응그 머 초레장 에버요복 꺼뜨믄 그 호 좀은 호와스러꼬 머 꼬뜽 거틍 거또 노코마리야 이래 머 그래 호와 쪼그므이 요새로 말 꺼므 호와 결혼식짜이읻 데미 응거 그른 시그로 하는 지또 이마내쓰찌여	옛날에 혼례 치르는 것은 이 그 그렇더라고 보니까 옛뭐 좋게 견딘 집 좀 환경이 좋은 집들은 그뭐 참 날짜도 뭐 거기 동네가 다 알고 뭐 온 동네가 축복도 하고 말이지 축하도 하고 그리고또 그이 그 이 결혼그 뭐 초례장 예복 같은 것은 그 호화 좀 호화스럽고뭐 꽃등 같은 것도 놓고 말이야 이래 뭐 그래 호화롭게 조금 요새로 말할 것 같으면 호화 결혼식장이 되겠는데그 그런 식으로 하는 집도 이많았었지요
마내꼬 잘사는 집뜨너	많았고 잘사는 집들은
그럼며너 꺼 이젣 이으 그 초레 보톤 여이 집베서도 언저 시집뽀낼 꼉우에여기서 초레 지낼 꺼 아님미까 그지예	그러면은 그 이제 이 그 초례 보통 이집에서도 인제 시집보낼 경우에 여기에서 초례를 지낼 것 아닙니까 그렇지요
나 에야 초레 여야	네초례 예
그어임며너실랑인하고 상개기 와서 어인저 여기 오며너 초레를 지래으내는데 초레 보통 초레 어떤 시우루 지냄미까 에전네	그러면은신랑하고 상객이 와서 인제 여기 오면은 초례를 지내는데 초례 보통 초례 어떤 식으로 지냅니까 예전에
그이 초레라 그능 건 이 인제 이 심부 찌베 이 인제 마당에다썰르 이른 상을노코 달 라코 머 꼬꼬항 거 이스이건 달 로코 머 이래오 화분도 꼬바 노코 마아지여 머 이릉 거 에 쭉 채리 노코설랑	그 초례라 그러는 것은 이 인제 이 신부집에 이 인제 마당에다설랑 이런 상을 놓코 닭을 놓고 뭐 꼬꼬하는 것이 있으니까닭 놓고 뭐 이래 화분도 꽂아 놓고 말이지요 뭐 이런 것쭉 차려 놓고설랑
검므 그어 초레상에 올리능 게 달하고 그다음 먹화분도 올리고	그러면 그 초례상에 올리는 게 닭하고 그다음 뭐화분도 올리고
예 훈 화분 나꼬	어화 화분 놓았고
오리가 인능가 그르치 암마	오리가 있는가 그렇지 아마
오리	오리
오리 그 나무 나무 오리 가튼	오리 그 나무 나무 오리 같은
응예 나무 어리 그케 마리야 엥 그 그르코	응예 나무 오리 그러게 말이야그 그렇고
그다으미 쌀 가틍 거또 노씀미까	그 다음에 쌀 같은 것도 놓습니까
그 싸른 논능 거 모 빠안데	그 쌀은 놓는 것을 못 봤는데
감 꺼 거게또 다른 머 머글 거뚜 올림미까	예 그럼 그 거기에도 다른뭐 먹을 것도 올립니까
머그 꺼느 안 올려 거게요	먹을 것은 안 올려 거기에요
머그 껃 안 올리고 거 인제이기 읻 끼 교배례할 찌 술 으 술뼁음 가따 노코	먹을 것은 안 올리고 그 이제이것 이 교배례할 때 술술병만 갖다 놓고
술뼝을 가따 노코	술병을 갖다 놓고
여 잔 나코 이래 노코	여기 잔 놓고 이래 놓고
에에 잔하고 술뼈은 가따 노코	예 잔하고 술병은 갖다 놓고
예아	예
근 노코 인제엑 그래 인제 심부 찌베서 초레싸잉 마당에 채레지먼 그어르 인제 상에다 그래 노코설랑 실라이 그으 초레장어륻 두우더라꼬	그래 놓고 인제그래 인제 신부 집에서 초례상이 마당에 차려지면 그것을 인제 상에다 그래 놓고설랑신랑이 그 초례장으로 들어오더라고
실랑이 인제 머 그 가마 타고 오는 집또 이꼬 말 타고 오는 게입또 그 물롱 그르께 해찌 잘사는 지변 황겨이라 건 그르코 머 엄느 찌벵니 거러 두 오고 그러치먼 그 마당에 두와서 은제 이 실랑이 에 그 이 저 초레 에 에 에 이즈 장엗 대길 하멈 심부가 또 은제 그 나와요	신랑이 인제 뭐 그 가마 타고 오는 집도 있고 말 타고 오는 집도 있고 물론 그렇게 했지 잘사는 집의 환경이라고하면 그렇고 뭐 없는 집에는 걸어도 오고 그렇지만 그 마당에 들어와서 인제 이 신랑이 에 그 이 저 초례 에 에 에 이 저 초례장에 대기를 하면 신부가 또 인제 그나와요
응 기 심부울 나온 데느 인제 그 지베서 인제 머 심부 화장얼 쓰게가주 마리지 그래 먹 가치 모시거 나와가즈 거 와 가지 이즘 맏 두리 인저 마뿌터 가주저를 쓰게더라꼬 보이끼네이 여자들	어 그 신부가 나올 때는 인제 그 집에서 인제 뭐 신부 화장을 시켜 가지고 말이지 그래 뭐 같이 모시고 나와 가지고 거기 와가지고 이래 맞 둘이 인제 맞붙어 가지고 절을 시키더라고 보니까 여자들
남자는 단도그로 저럴 하데 여자늠 보이 양쩌게 부터가주 이리 저를 쓰게드라꼬	음 남자는 단독으로 절을 하되 여자는 보니 양쪽에 붙어 가지고 이래 절을 시키더라고
거 그이 티 히미 드니까	예 그 그 힘 힘이 드니까
이야	예
기이 여자으 치마도 머 이꼬	특히 여자는 치마도 뭐 입고
그래 이야 예아그 그래가지 인제 저를 쓰게고 인제 그 그래 머 거 어이저 홀기라 그으제 거러루 그걸 이르멈 머 저럴 하고 또 술짠똑 여 이인 낻 나나 마시드라꼬 보이께네	그래예그 그래 가지고 인제 절을 시키고 인제 그 그래 뭐 그저 홀기라 그러지 그것을 그것을 읽으면 뭐 절을 하고 또 술잔도 여 이 나 나눠 마시더라고 보니까
심부 머꼬 실랑 머꼬 크런 시그러 은제	신부 먹고 신랑 먹고 그런 식으로인제
그래 저를 하고 그래거 인제 에은 에잉 그래은 초레사이 끈나믄 인제 심부는 심부 빵으롣 드가고 또 실랑은 그 인제	그래 절을 하고 그리고 인제어그렇게 초례상이 끝나면 인제 신부는 신부 방으로 들어가고 또 신랑은 인제
사랑방으롣 드어가주 은제 그 동네 그어엳 친척뜰하코 모에 안자 가주우 인사 나누코 인자 가치 얘기도 하고 노다가 인제 은 은제 바메 인제 그 심부하꼬심방 치루코 그 또 잘사는 지베능 거 실랑이 고마 한 달또 사는 사람도 이꼬두 달또 사은 사람도 이꼬 또 머 엄 머얻 또 그 여 하 타아 한 대에쌔 사는 사람도 혹 이 이쓸지도 모르 그래도 인제윽 저 무근 신해이 데드라꼬	사랑방으로 들어가서 인제 그 동네 그 친척들하고 모여 앉아 가지고 인사 나누고 인제 같이얘기도 하고 놀다가 인제인제 밤에 인제 그 신부하고 신방 치르고 그 또 잘사는집에서는 그 신랑이 그만 한 달도 사는 사람도 있고 두 달도 사는 사람도 있고 또뭐뭐 또 그 여 한 다섯 한 대엿새 사는 사람도 혹 있 있을지도 모르고 그래도인제 저 묵은 신행이 되더라고
그래에 또 실랑은 인제 자기 지베 가따가 또 은정 오고 수푸무 또 오고 머으 그른 녜가 데드라꼬	그리고 또 신랑은 인제 자기 집에 갔다가 또 인제 오고 싶으면 또 오고 뭐그런 예가 되더라고
그래가주 인제어 어느 정도 떼므 인제 에 실랑이 심분 은제 신행을 쓰게드라꼬	그래서 인제 어느 정도 되면 인제 에 신랑이 신부를 인제 신행을 시키더라고
자기 지브로	자기 집으로
검 쭈 그 초렌날 그 초레 지내고 나며너 거기서 잔치를 함미까	그럼 저그 초롓날 그 초례 지내고 나면은 거기에서 잔치를 합니까
처가 거 시 심부	처가 그 신 신부
예예 잔첼 하제요	예 잔치를 하지요
끄어 잔치넙 보통 그 초레 잔 그 홀레 거 활 때 잔치는 주로 어떤 사암더리 워우 모여가 함미까	그 잔치는 보통 그 초례 잔치 그 혼례 그 할 때 잔치는주로 어떤 사람들이 옵 모여서 합니까
잔치는 주로 인젝 그 집 그 동네 사람 그 집 지반 머 형제 자매아 또 그루코옹얻 또 그르코 어우 그읃 처가찝 시꾸들 우우 동네 사럼들 그래 머 그또 고 그래음 모에 가즈어 잔체엘 하며 인제 실랑어느 인제 그으 이 동네사람들 절믇 칭구드리부 와 가주이 예를 뜨르 으성 깅가 거떵 깅가드리 구웡타성도 더러 써께 그래 온 오머에 실랑한테 인제 여머 처가에 머를 쫌 멍  능 걸 마이 내오라 요굴 하능 게라	잔치는 주로 인제 그 집 그 동네 사람 그집 집안 뭐 형제 자매 또 그렇고어 또 그렇고그 처갓집 식구들 우리 동네사람들 그래 뭐 그 또 그 그래음 모여 가지고 잔치를 하면 인제 신랑은 인제그 이 동네 사람들 젊은 친구들이 와 가지고 예를 들어 의성 김가 같으면 김가들이그 타성도 더러 섞였고 그래 오 오면 신랑한테 인제 여뭐 처가에 뭐를 좀 먹는걸 많이 내오라 요구를 하는 거야
멍능 걸 머 수리 멤 말 머 써 멩태가 멛 따하 머이 기 이른 씨그로 해 가주우 머 다라매고 발또 뚜데래고 그래가주 인제 에울꽈내는 리 예가 데드라고 잔체가	먹는 것을 뭐 술이 몇 말 뭐 저 명태가 몇 마리 뭐 그 이런 식으로해 가지고 뭐 달아매고 발도 두드리고 그래서 인제음 우려내는예가 되더라고 잔치가
그래 데며 인제 실앙어 은 다라매애 가주설랑 시끈바를 인제 읃 뚱 때리 가주우 인지 처가찌베이 요구울 해 노코는 여과바이라 그렁 게 이써여 인제 그거 그날 결혼즈 치낸 지베서 심부 찌베서 음시글 장만해떵 그려음 방이 이써업 과바이나 채린 나 거게 실랑 끌꼬 가용	그래 되면 인제 신랑은어 달아매 가지고설랑 실컷발을 인제딱 때려 가지고 인제 처갓집에 요구를해 놓고는 여과방이라고 그러는 게 있어요 인제 그것 그날 결혼을 치른 집에서신부 집에서 음식을 장만했던 그런 방이 있어요 과방이라고 채려 놓은 거기에 신랑을 끌고 가요
그어 이 정 머하르 청항 거으 내오라꼬 마이 그래가쭈 은저 쓰어 실랑이 청해가주우 나오멍 그어스 인제 그거 머꼬 노래도 하고 머 그래 어응 바미 느뜨룽노다 으 가고 그르치 머	그 이 저 뭐를 청한 것을 내오라고 말이지 그래서인제 신 신랑이 청해 가지고 나오면 거기에서 인제 그것을 먹고 노래도 하고 뭐 그래어 밤이 늦도록 놀다가가고 그렇지 뭐
너 그른 제게 이따꼬이	뭐 그런 적이 있어요
가므 인제 그얻 보통 장가 은저 온 사람 머 실랑 데르고 인제 그래 안 함미까 그지	그러면 인제 그 보통 장가 인제 온 사람 뭐 신랑 데리고 인제 그래 안 합니까 그렇지요
예아 야	예 예
그엄며넏 끄으거 아까 초렏 지엉 초레 지내고 나며너 인저 상개근 보통 하루빰 무꼬 가기도 하고 앙 그암머 지반 형펴네 따러서 당일랄 도라가기도 하고그러쓰미까	그러면은 그것 아까 초례 지내 초례 지내고 나면은 제인 상객은 보통하룻밤 묵고 가기도 하고 안 그러면 집안 형편에 따라서 당일에 돌아가기도 하고 그렇습니까
상개기	상객이
이 뜩 크 아무리 모싸러도 하루빠믄 상개기 자오 간 수느 이 이따구	이 저그 아무리 못 살아도 하룻밤은 상객이 자고 가는 수는 있 있다고
그기 영 가차운 데는 머 에두 다인 깐 새임 머 이뗌만	거기 영 가까운 데는뭐 어디 당일에 가는 사람 뭐 있지만
보통어 하루빰 주무시고 그 다음날	보통은 하룻밤 주무시고 그 다음날
귿 응에 헤예 하루빰므 자우 가고 다음 가능 게 마찌	그예 예 하룻밤만 자고 가그 다음날 가는 게 맞지
가므 천날빰 응 거 보통 여기에 천날빰 가틍 경우에 초레 지내고 여이 천날빰지 저 할 꺼 아임미까	그러면 첫날밤그 보통 여기에 첫날밤 같은경우에 초례 지내고 여기에서 첫날밤저 저 할 것 아닙니까
심방을 꾸며 가주고 거 천날빠믈 그 하는데 심방웓 그 어떤 시으주로어디에 꾸밈미까	신방을 꾸며 가지고 그 첫날밤을 그렇게 하는데 신방은 그 어떤식주로 어디에 꾸밉니까
그어 안채가 안채에 함미까 어떠케 함	그 안채에 안채에 합니까 어떻게 합니까
그 아게 그 그러치 심방은 솀방은 그 심부 큰 집베이그 그 자긱 크게 자기가 성장하등 그 크 그 방에 채리드라꼳 쭈로가	그 안 그 그렇지 신방은신방은 그 신부 큰 집에 그 자기가 컸던 자기가 성장했던 그 그 그 방에 차리더라고 주로가
그 심부가 므 예를 뜨르 꺼뜨므 중감 빵이럼 중감 빵에서 거칠락 그어서처녀 때으 거겔 이으 거칠 해따 그머 그 방열 사용하는 수가 엳 주로 만트라꼬	그 신부가 뭐 예를 들을 것 같으면 중간 방이면 중간 방에서 거취를 거기에서처녀 때 거기에거취를 했다고 그러면 그 방을 사용하는 수가 주로 많더라고
거으돠 인제 심방을 채린데 그 심방을 채리먼 그기 옌날 수 수 속땀미 그이 심방을 채림 머 실랑을 어으 더러 그 머 사댈한는 쑤갇 천날빠메 사밸하는수어 이따 카능 게데 그게 인제 풍스비 데가주 뭉꿍골 뚜우꼬 들다보고 그래드라꼬 상개칸다꼬 마레 상지칸다꼬	거기에다가 인제 신방을 차리는데 그 신방을차리면 그 옛날 속 속 속담에 그 신방을 차리면 뭐 신랑을더러 그 뭐 사별하는수가 첫날밤에 사별하는 수가 있다고 하는 게 그게 인제 풍습이 돼서 문구멍을 뚫고 들여다보고 그러더라고 상직한다고 말이야 상직한다고
그래 인제 실랑 심부가 방에 드가서 은제 치치믈 하기 데믄 그그 그 무늘 뚜꼬 마아찌 이래어 송까라우 뚤꼬이 머 너거 엠 마구 시즈마꿈 매달렏 들다보고	그래 인제 신랑 신부가 방에 들어가서 인제 취침을 하게 되면 그그 그문을 뚫고 말이지 이래 손가락으로 뚫고 뭐 이래마구 추녀마다 매달려서 들여다보고
그래 그 상지글 하능 거느 그 그어는 예가 은제 이 실랑을 보호하는 뜨시라 그래 에 얘기엗 데드라꼬	그래 그 상직을 하는 것은 그 그것은 예의가 인제이 신랑을 보호하는 뜻이라 그래얘기가 되더라고
무 뭉꾸멍 뚤릉 그얼 머 한다고 함미까	문 문구멍 뚫는 그것을 뭐 한다고합니까
상지칸다 그래 상직	상직한다고 그래 상직
마저 상지카로 간다 상지칸다 그어느 인제 여자드리 주로 해 남자가 아이고	맞아 상직하러 간다 상직한다 그것은 인제 여자들이 주로 해 남자가 아니고
끄엄며느 주로 여자드리 그어 뭉꾸녕 뚜러 가주고	그러면은 주로 여자들이그 문구멍을 뚫어 가지고
응 상지글 한다 게지	응 상직을 한다고 그러지
그엄며느 보통 그으거 시 심방에 검 초레 지내고 한 저녁 저녕 머꼬 심방에 감미깡 실르너	그거면은 보통 그것 신 신방에 그럼 초례 지내고 한 저녁 저녁 먹고 신방에 갑니까 신랑은
저 저녕 머억 까제	예 저 저녁 먹고 가지요
저녕 머꼬	저녁 먹고
감 실랑언 저녕 머끼 정까지느 어디에 이씀미까	그러면 신랑은 저녁 먹기전까지는 어디에 있습니까
초레 지내고 나서	초례 지내고 나서
맹 에잉 그어 이인 즈 초레읃 즏 지나고 나멍 그 집 사랑방에 가	역시그이 저 초례 저 지내고 나면 그 집 사랑방에 가
사랑에 가가주 인제이 칭구들하꼬 술또 머꼬 노게드 인사도 나누꼬 그래은제장난 소리도 하고 장난도 치고 머 그래 실랑 다룬다 크고 머야 매다러 노꼬 물견 요구도 하구 마에주 음싱 머 수리 메 초롱 으이따 머 이 이래 인제불꾸꼬 그래 인저 장난드 하고 그래으 저녕 머꼬	사랑에 가서 인제 친구들하고 술도 먹고 놀기도 인사도 나누고 그래 인제장난 소리도 하고 장난도 치고 뭐 그래 신랑 다룬다 하면서 뭐 매달아 놓고 물건 요구도 하고 말이지 음식 뭐술이 몇 초롱 있다 뭐 이 이래 인제불 끄고 그래 인제 장난도 하고 그래 저녁먹고
으 저녕 머꼬 또 노라	어 저녁 먹고 또 놀아
맹 노머 바미야 열뚜 시 거익 가차이 데야 헤어지더라꼬 모도	역시 놀면밤에 열두 시 거의 가까이 되어야 헤어지더라고 모두 어
거러 인저 스 그때 인저 심방에 감미까	아 그래 인제 신 그때 인제 신방에 갑니까
암무 실랑은 엉에으 인지 그 심방을 거기 어읍 어이 여자 방으로 드가고	암뭐 신랑은인제 그 신방을 거기에이 여자 방으로 들어가고
가므 심바 심방 심방 가기 정까지너 여자어 심부 얼굴도 제대로 모 뽀껜네예	그러면 신방 신방 신방 가기 전까지는 여자 신부 얼굴도 제대로 못 봤겠네요
초레 지낼 때늠 머 화장해 가 이꼬	초례 지낼 때는 뭐 화장해 가지고 있고
그 그르치 모 빠쩨 그르찌이그	그 그렇지 못 봤지 그렇지요
화장가이그 이래 가주움 마가가주 이쓰이께르 모 빠쩨예	화장해서 이래 가지고 막아서 있으니까 못 봤지요
적뚤 족뚜리 쓰고 이꼬 그래 너이 그지예	족두리 족두리 쓰고 있고 그래놓으니 그렇지요
거으 거 그러치 모 빠찌 이거 확씨리 모 빠찌	거 그 그렇지 못 봤지 이것확실히 못 봤지
그래고 은제 이 심방엑 가 가주우 쪽또리 베끼미 인제 확씨리 볼 수 이찌심부러	그러고 인제 이 신방에 가 가지고 족두리 벗기면 인제 확실히 볼 수 있지신부를
거 족뚜리 인저 심방 그아며 인지 천날빠민데에 검 쪽뚜리를 그어읃 심랑읻버낌미까	그 족두리 이제 신방 그러면 인제 첫날밤인데 그러면 족두리를 그러면신랑이 벗깁니까
메 시야이 실라이 베끼지여이지 쪽또리네	예 신랑이 신랑이 벗기지요 족두리는
그암머 족뚜리 버끼고 그냥 잠미까 앙 그러명 거이 머 수리라도 한 잔 하고 잠미까	그러면 족두리 벗기고 그냥 잡니까 안 그러면 거기 뭐 술이라도 한 잔하고 잡니까
하 아이래 그 수리랑 게 흐게 먼 주라 그르잉갸 그게 윽 거게 인제 술 라꼬 음시글 가따 노은다꼬	아 아니야 그 술이라는 게 그게 무슨 주라 그러는지그게거기에 인제 술을 놓고 음식을 갖다 놓는다고
으 머꼬 얘기하라꼬	어 먹고 얘기하라고
허러 인저 그거 머응 사랑도 이꼬 기양 곰 암 머꼬 고다나이 꼼머 자는 사람드 이꼬 그르트락 구게 인제	그래 인제 그것을 먹는 사람도 있고 그냥 그만안 먹고 고단하니 그만 자는 사람도 있고 그렇더라고 그게 인제
거윽 그애서 어째뜬 그래가 머 천날빰 그어 한다 그지예	그 그래서 어쨌든그래서 뭐 첫날밤 그래 한다 그렇지요
끄 보통 그 인제 그얻 은저 그륻때 인제어 초레 에 그 하고 그럼며너 인제머 아까두 이야기해찜마는 무근 신행 하는 사얌머 실랑이 머 처가찌베서 무꼬어 지내다가 또 머 가끔 자기 집 봉가에 가따가	그 보통 그 이제 그 이제 그때이제 초레그렇게 하고 그러면은 이제 뭐 아까도 이야기했지만은 묵은 신행 하는 사람은 신랑이 뭐 처갓집에서 묵고지내다가 또 뭐 가끔 자기 집 본가에 갔다가
따가 또 오구오 그러 쑤도	갔다가 또 오고 그럴 수도
와따 가따 하음면서 그래서나중에 인제결과저그로 인제 무근 신행 끈날 무려베	왔다 갔다 하면서 그래서나중에 인제결과적으로 인제묵은 신행 끝날 무렵에
그키 양가이 타압패가주 인제 신행을 해가쭈 그만	그래 양가에서 타합해서인제 신행을 해서 그만
그르쪼 신행을 가며 인제 여자 입짱에서넌 시집까능 거 아임미까 그지에입짜이	그렇지요 신행을 가면 인제 여자 입장에서는 시집가는 것 아닙니까 그렇지요 입장이
그어 그 그르찌여 여자저이 여자로튼 실랑 찌베 가능 게고	그 그 그렇지요 여자 여자로서는 신랑 집에 가는 것이고
그르치예	그렇지요
네에 인제 결구은 시집가능 건데 시집까서 인제 에어 저쭈게 인제 저쪼게어 실랑 찌베 인제 시집까서넝 거이서늠 머 잔 잔치만 하지 머 아까처럼 머 홀레 치르고 인제 이릉 건 업따 아님미까 그지에	예 인제 결국은 시집가는 것인데 시집가서 인제저쪽에 인제 저쪽에 신랑 집에 인제 시집가서는 거기에서는뭐 잔 잔치만 하지 뭐 아까처럼 뭐 혼례치르고 인제 이런 것은 없다 아닙니까 그렇지요
그러치요 그 신행 찌베는 끄으 머 잔치 케양 머꼬 엉 에 머꼬 심부 보러 오  지 머 다릉 건	그렇지요 그 신행 집에는 그 뭐 잔치 그냥 먹고에 먹고 신부보러 오지 뭐 다른 것은
남자드른느 벨러 안 온다 그이께네 어이 거 신행 찌베는 여자드리 주로와 고마	남자들은 별로 안 온다 그러니까그 신행 집에는 여자들이 주로와 그만
아이 지여 새득 뽀로 온다 그래 새득	어 저 새댁 보러 온다고 그래 새댁
심부를 새드기라 그래그더 여	신부를 새댁이라 그러거든 여기에서는
요 구경하러 머 잘젇 잘난나 몬나나 보로 온다 그르고 머 그래가주 주로인제 친척 남자더른 친척 웨에는나이	요기 구경하러 뭐 잘 잘났나 못났나보러 온다 그러고 뭐 그래서 주로 인제 친척 남자들은 친척 외에는 안 와요
끄엄며너 그워 페배글 그때 함미까	그러면은 그 폐백을 그때 합니까
페배기라 거능 게 인제 신행 가 가주고여자가 인제 샤할랑 찌베 신행을라꺼 갈 때 으 페배기라 그능 걸 멀 장만해가주 간다궈	폐백이라 그러는 게인제 신행 가 가지고여자가 인제 신랑 집에 신행을 갈 때폐백이라 그러는 것을 뭘 장만해서 간다고
달또 이꼬 머 머 고기도 이꼬 머 머 밤도 이꼬 대추도 이꼬 그릉 걸 싸 가주고 이래 쟁바네 싸 가주고 응 그 가마 여어가주 우어이 씨래이 신행어르카 가믄 신행을 드려닥 어여 그 가믄 응 그 시어른는 시부모한떼음 인사을 드랜다꼬	닭도 있고 뭐 뭐 고기도 있고 뭐 뭐 밤도 있고 대추도 있고 그런 것을 싸가지고 이래 쟁반에 싸 가지고그 가마에 넣어서신행 신행을 가 가면 신행을 들여다그 가면그 시어른 시부모한테 인사를 드린다고
그게 페배기라 그드라꼬 보이께네	그게 폐백이라 그러더라고 보니까
그래 심부가 아아이 썌이 시어른 양어분한떼 제이 저럴 하고 그 페배글 내노으먼 그 요새로 말허꺼 바밈 대추 거틍 거를 떤져 주문상은 머 어언 참 은어 으응 마낸 아드를 로으란 시그로흥 그래 힌제으 머 무루페 떤져 주드라꼬그른 녜게 인제 그게 페백 드랜다 그드라꼬	그래 신부가시 시어른 양어른한테 절 절을 하고 그 폐백을 내 놓으면 그 요새로 말할 것 같으면 밤이며 대추같은 것을 던져 주면서 뭐참어많은 아들을 놓으라는 식으로 그래 인제뭐 무릎에 던져 주더라고 그런 예가 인제 그게 폐백 드린다고 그러더라고
그게 인제버 에이 요새로우 글때능 그게 페배기라 그래드라꼬요	그게 인제어 요새로 그때는 그게 폐백이라 그러더라고요
그암 페배 그으게 인제 악 페배글 그때 머 신행 와서 페백할 때 보통 시으실랑 시부모맘 페백 뽐미까 앙 그암 머 페백 어디까지 봄미까 보통	그러면폐백 그게 인제 아까 폐백을 그때 뭐 신행 와서 폐백할 때 보통 신 신랑 시부모만폐백 봅니까 안 그러면 뭐 폐백 어디까지 봅니까 보통
폐배기 그르이껜 인제으 그윽 큰 응 그이 자기 실랑 지베아 머 구오우 그거인제 맹 가차운 친처긍 어름분더드어런 마쩌를 하고 보긴 보드라꼬	폐백이 그러니까 인제 그 큰그 자기 신랑 집에 뭐 그 그것 인제 역시 가까운 칙척 어른분들은 맞절을 하고 보기는 보더라고
그 마쩔 하드라꼬	어 그 맞절 하더라고
마쩔 하거우 보드라꼬 그	맞절 하고 보더라고 그
글때 으 그거 맹 그제거끄 그거 노꼬 맹 저를 하드라꼬옹	그때그것 역시 그것 그것을 놓고 역시 절을 하더라고
페배 그걸 로꼬	폐백 그것을 놓고
머 수를 한 잔 올리고 그래 함	뭐 술을 한 잔 올리고 그래 합니까
으예	예예
긍 그래등 거 타꼬	그 그랬던 것 같다고 예
확씨리 멀 므어 그 다 이저 뿌래 인제 아허으 그르치 십따꼬 인제이 기어기 나능 게	확실히 뭐 뭐 그 다 잊어 버리고 인제 허허 그렇지 싶다고 인제 기억이 나는 게
그래 인제 그 시어른 외에 가차운 머 삼촌이라든지 사초어니라든지 이른 사람드릉 그거 마쩌르 하고 보드라꼬 마디	그래 인제 그 시어른 외에 가까운 뭐 삼촌이라든지 사촌이라든지 이런 사람들은 그것 맞절을 하고 보더라고 말이지
철 첟이인사라꺼 그으래뜨라꼬	첫 첫인사라고 그러더라고
그때 처음 인제심부 입짱에서느 그때 인제아 지반 어른들 처음 벱찌예	그때 처음 인제신부 입장에서는 그때 인제 집안 어른들 처음 뵙지요
그래 잉 그 으어 그아 저이 인살 드래능 게비 거	그래 이 그그 저 인사를 드리는 것이지 그
그다은 그다으메 시 거음 시부모 중에서 머 시아버지너 초레 땝즈 그엄 뻐 봐 초레 하는 날 볼 수 보 숨	그 다음 그 다음에 시 그 시부모 중에서뭐 시아버지는 초례 때저 그 봐 봐 초례 하는 날 볼 수 볼 수 있습니까
아이래에영	아니에요
그때도 모 뽐미까	그때도 못 봅니까
그얼롱음 모 빠찌	그때는 못 봤지
도 그영 어째뜬 처음 벰능 거는	뭐 그럼 어쨌든 처음 뵙는 것은
어예 그날 페백 드랜 날 보지	예 그날 폐백 드린 날 보지
신행 와서	신행 와서
그 페백 뜨린 날오 확씨리 보지요	그 폐백 드린 날 확실히 보지요
시어머니늠 므 처어 처음 인사 드리능 거우   그지예	시어머니는뭐 처음 처음 인사 드리는 것이고   그렇지요
예아	예 예
웨아 그르스 그 하고그다으메으 인제 보통 그거 신행 옴며너 여자들한테 거 새댁한테 상을 주지예	예 그래서 그렇게 하고그다음에 인제 보통 그것 신행 오면은 여자들한테 그 새댁한테 상을 주지요
상을 인제 그	예 상을 인제 그
그 상은 무슨 상이라 함미까	그 상은 무슨 상이라 합니까
그게 어여 으 이 큰사이라 그랜너이 큰사아	그게어 이 큰상이라 그랬습니다 큰상
큰사이라 하지예	큰상이라 하지요
큰상에너  어뜨게 함미까	큰상에는  어떻게 합니까
꺼으 끄 큰상을 바더	그 그 큰상을 받아서
큰상을 저럴 하능 게 아이고	큰상을 절을 하는 게 아니고
머 큰상에 멀 차려 줌미까 보통	뭐 큰상에 무엇을 차려 줍니까 보통
그르이 머 그게 옌날로 말하 꺼 머 머이 칠첩 방상기니 머 머 에듬 메 처꺼반상기 그므썬 그 쩌에 그 머아 바네 노엔 수짜를 인제 젱으 그 접씨가 일고 껨칠처비거고 머 쎼이 열 깸 십처비래 그 그릉 꺼 테 보이께네	그러니 뭐 그게옛날로 말할 것 같으면 뭐 뭐 칠첩 반상기니 뭐 뭐 이 몇 첩 반상기 그러면서 그저 그 뭐 반에 놓인 숫자를 인제 접 그 접시가 일곱 개면 칠첩이고 뭐 십 열 개면십첩이라고 그러고 그런 것 같아 보니까
그어 칠첩 반상기에다 음시글 여래 채리 가주어 밥바꼬 가따 노으먼 큰상을인제 그으 거 가차운 친처기에 가따 주먼 그 새드기 그걸멍는다꼬	그 칠첩반상기에다 음식을 요래 차려 가지고 밥하고 갖다 놓으면 큰상을 인제 그 그 가까운친척이 갖다 주면 그 새댁이 그것을먹는다고
그걸 인제 신행 와가주 인제 처 쌍 큰사이라 그래드라꼬	그것을 인제 신행와서 인제 첫 상 큰상이라 그러더라고
그아임 보통 큰상 그거 은제 심부가 와서 큰상얼 바더 가주고처음 바블 멍는데 그아므 그어때 그냥 여자어가 시음부갇 직쩝 자기 이베 먼젇 떠러씀미까 앙 그암 다른 사암한테 누구 줌미까	그러면 보통 큰상 그것 인제 신부가와서 큰상을 받아 가지고처음 밥을 먹는데 그러면 그때 그냥 여자가 신부가 직접 자기 입에 먼저 떠넣습니까 안 그러면 다른 사람한테 누구 줍니까
아이래 그게 옌나레름 마르지예	아니야 그게 옛날에는 말이지요
에 옌날얼러므	예옛날에는요
얼 그 잘산이 옌날 얘기레예이	어 그 잘사는이 옛날 얘기에요
예 옌날 꺼 하무 요즘 안 하니카	예옛날 것 하시면 요즘 안 하니까
잘사는 잘 지베는 그게 어이 시 신행얼륵 갈 찌게 그 어으 그 시녀를 데루가여 하나	잘사는 잘 집에는 그게신 신행을 갈 적에 그그 시녀를 데리고 가요 하나
시녀럴	시녀를
자기 몸쫑을 데루 간다꼬	자기 몸종을 데리고 간다고
잘사는 지베는	잘사는 집에서는
그르치예 몸쫌에 함 명 데르 가지예	그렇지요 몸종을 한 명 데리고 가지요
어 몸쫑을 처녀래 그또	어몸종을 처녀야 그것도
데리구 가먼 그 이드 몸쫑익 거게서 인제 바벌 떠메기 준다꼬 그 큰상을 바드마	데리고 가면 그 이 몸종이 거기에서 인제 밥을 떠먹여 준다고 그 큰상을 받으면
그 몸쫑이 그 인제보잘 해 준다꼬	그 몸종이 그 인제보좌를 해 준다고
어에 하라꼬 밥또 떠미게 주고 마리지여 오또 이래으 가사 주고 마리지 이르 인제 에 그 시녀를 데루 가 가주고 몸쫑을 데루 가서 그어으 보졸 반는 집또 이꼬 몸쫑이 엄는 지베느 여뻬 가차운 지베서 머 한 술 떠미게 주고 그른  녜드 임 머	어떻게 하라고 밥도 떠먹여 주고 말이지 옷도 이래 발라 주고 말이지이래 인제그 시녀를 데리고 가 가지고 몸종을 데리고 가서 그 보조를 받는 집도있고 몸종이 없는 집에는 옆에 가까운 집에서 뭐 한 술 떠멱여 주고 그런 예도 있는 모양입니다
그르쵸 어딤 머 하능미나 머 이런 시우러 데리우 가지영	그렇지요 어디 뭐하인이나 뭐 이런 식으로 데리고 가지요
야예아예 예어 그 그래	예예예그 그래
그엄믄 그 웨감 므 가서 저를 해야 데니까 으에 또 절도 해야 데고 쯔어	그러면 그 왜 뭐 가서 절을 해야 되니까또 절도 해야 되고 저
그 그읻 저리랑 게 그케 거 인제 저 이	아 그 그 절이라는 게 그러게 그인제 저 이
시부모 페백 뽈라 함며너	시부모 폐백 보려 하면은
시여 씨부모 페백 드렬 찌이 저럭 큰저를 다 하능 게라	아 시 시부모폐백 드릴 적에 절을 큰절을 다 하는 거야
그르쳐 여자 혼자는	그렇지요 여자 혼자는
끄어 그 가차운 친척 다 대렐 다 하능 게라 글때느	그 그 가까운 친척 다대례를 다 하는 거야 그때는
그르치예	그렇지요
인살 라눙 게라	인사를 나누는 거야
여자 혼자 절하 남자느 혼자 머 절하기 쉬운데 여자너	여자 혼자 절하기는 남자는 혼자 뭐 절하기 쉬운데 여자는
여잔 여페서으 보조올 해 주제이	여자는 옆에서 보조를 해 주지
그얼치예 큰절하기가 힘드니까	그렇지요 큰절하기가 힘드니까
에예	아예
이 양짜어 부터가주 보조올 해 준다 꼬래 큰저얼 한 덴	이 양쪽에 붙어 가지고 보조를 해 준다고 그래 큰절을 할 때는
그엄며는 그때 머 그 보통 그 밥 까튼 경우에풍으이 이런 데너 풍스비머 땅 거 업씀미까	그러면은 그때 뭐 그 보통 그 밥 같은 경우에풍 이런 데는 풍습이 뭐 다른 게 없습니까
거어시작짜 시지베 와서 머 시누나 누구항그 누구한테 이거 머 밥 제일 한 술 제일 먼저 떠가지 누구한테 주라 그릉 건 업씀미까 이 동네에넝 그렁	그시집 시집에 와서 뭐 시누이나 누구한테 누구한테 이것 뭐 밥 제일 한술 제일 먼저 떠 가지고 누구한테 줘라 그런 것은 없습니까 이 동네에서는 그런
모르시더 그거는느 자시 모르겐데	모르겠습니다 그것은 자세히 모르겠는데
여자들 끼라서	여자들 것이라서
어예아	예
어르신 그음이여 어제 이어스 게속 하게씀니다	어르신 그러면이어서 어제 이어서 계속 하겠습니다
예예 그래시더 예예	예 그럽시다 예
어르신 어제 우리 그엄 이 마을 유래라든지 이럼 부부네 대해서 쫌슴 말쓰믈 해 주션는데 끄어혹씨 그 요즈므언 머 주로 어제도 잠시 이야기해쓰미다마는 장어 누가 도러가시게 데며느 초상나며너 점부 장이사라든지 병어 영안씨 병원 영안씨 가써 에여 마이 하처	어 어르신 어제 우리 그것 이 마을 유래라든지 이런 부분에 대해서 좀 말씀을 해 주셨는데 그혹시 그 요즘은 뭐 주로 어제도 잠시 이야기했습니다만은 장 누가 돌아가시게 되면은 초상나면은 전부장의사라든지 병 영안실 병원 영안실 가서많이 하지요
다 하져 요솜	다 하지요 요새는 예
예 하어게 데서 쪼곰 그르치마너 에전 가트며는 대개 지베서 안 해씀미까 거르치에	예하게 돼서 조금 그렇지만은 예전 같으면은 대개 집에서 안했습니까 그렇지요
예전 거트먼 은 지베서 마가 장미 장니 치루조	예 예전 같으면집에서 모두 장례 장례를 치르지요
혹씨 그얻 사라미이 이 주거서 장네를 치를 때에 쩌 이 자으 저 예저네 장네 치를 때 어떤 시으루 치런는지 함무 이야길 하문 해 주이소	혹시 그 사람이 이 죽어서 장례를 치를 때에 저 이 장례 저 예전에 장례 치를 때 어떤 식으로 치렀는지 한 번 이야기를 한 번 해 주십시오
요즘 머 사암들 잘 모르니까 에	요즘 뭐 사람들 잘 모르니까 예
옘 으예	옛예 예
이 옌날 에임 장레 치른 버블 얘기하까요	이 옛날장례 치르는 법을 얘기할까요
옌나레는 인제읍 부모가 머 편찬해 가주 상을 당하믄 상주가 그 문중 어른드리 모도 모에고 해서 그 인쩨 별쎄해따는 부고를 씀니다	옛날에는 인제 부모가뭐 편찮아 가지고 상을 당하면 상주가 그 문중 어른들이 모두 모이고 해서 그 인제별세했다는 부고를 씁니다
읍 부고를 인자 하모에 하모 임 머 이 유인내 그애 해 가주 그 으 부치니 어제 날짜로 마 인 메 시경에 이 경여 머 유씨므 유씨야 마 으 그른 씨로 해 아주이별쎄해쓰니께 자이 부고한닥 이래 인제 그 부골 내먼 그으 부골르 가주고 옌나레는 우체부가 업썬니더	그 부고를 인제 항목 항목 이 뭐 이 유인을 그 해 가지고 그부친이 어제 날짜로 뭐 이 몇 시경에 이 경에 뭐 유시면 유시 뭐 어그런 식으로 해 가지고 별세했으니까 아들이 부고한다 이래 인제 그 부고를 내면그 부고를 가지고 옛날에는 우체부가 없었어요
여에 동네 사럼드리 모도 한 동네쓰 마타 가즈어 이마꺼이 여나음 장씨에이  시무 장석 가주고 전낸니더 동네매동	여기 동네 사람들이 모두 한 동네씩 맡아가지고 이만큼씩 여남은 장씩 스무 장씩 가지고 전했어요 동네마다
가서 인제 집찜매동 가서 인제 이여 부골 전나고 끄으 그래 와 가주고 인저또 부골 전난 따으메으 그 사람드름 부고 전하도르 캔 노꼬 동네 문중 어른드른또 망이네 대한느 장이를 정해요	가서 인제 집집마다 가서 인제 이 부고를 전하고 그 그래 와 가지고 인제 또 부고를 전한 다음에는 그 사람들은 부고를 전하도록해 놓고 동네 문중 어른들은 또 망인에 대한 장의를 정해요
제 장이르이 예를 뜨러 가주 말하음 오늘 도러가씨미 요샌 먿 주로 사밀짜일니더 머 암 냐음 머 더도 모 타고 그래두구만	인제 장의를 예를 들어 가지고 말하면 오늘 돌아가시면 요새는 뭐 주로 삼일장입니다 뭐음 뭐 더도 못 하고 그러더구만
그느 옌나렌 머 사밀짱도 마이 해찌만 보통 오일짱 치릴짱 그래 머탄 지벤 머 어어 근 열흘 으을 보름장도 지낸 지비 이써써 유유한 지베는	그런데옛날에는 뭐 삼일장도 많이 했지만 보통 오일장 칠일장 그래 무엇한 집에는 뭐 어근 열흘보름장도 지내는 집이 있었어 여유있는 집에서는
그래어 황겨이 좀 느잉 경제가 나꼬 한 지베는	그래 환경이 좀 낫고 경제가낫고 한 집에서는
그래 장네을 채루코 그게 찌 장녀는 인제 쯔 에 그래 데먼 인제 지 에 상가에서는 인저 그 금 망이니 주근 다으메 인제 수으 소리미라 근능 어이 소려미라 그능 거 소려믈 하니더	그래 장례를 치르고 거기에 장 장례는 인제 저 어그래 되면 인제 저상가에서는 인제 그 그 망인이 죽은 다음에 인제 소 소렴이라 그러는 것 소렴이라 그러는 것 소렴을 합니다
소려미러 그능 거느 인제 망이널 인저 소늘 거다 가주 무꺼 조요	소렴이라고 그러는 것은 인제 망인을 인제 손을 거두어 가지고 묶어 줘요
마 발라꼬 거 이게	뭐 발하고 그 이게
그 이스 에 사라미랑 건 숨 떠러지먼 고마 사지가 구더 뿌거드요	그 이어 사람이라는 것은 숨이 떨어지면 그만 사지가 굳어 버리거든요
구더 뿌먼 소널 모치럴 모 하이께네 덜 구더슬 찌게 소널 모코 바를 마아가주 무끼 조트룩 배 우에 요래 은저 가주이 요골 소리미라 그래여	굳어 버리면 손을 모으지 못 하니까 덜 굳었을 적에 손을 모으고 발을 모아 가지고 묶기 좋도록 배 위에 요래 인제 가지고 요것을 소렴이라고 그래요
그래 소리믈 마치고 나머 인제 그나알 거트먼 그 인제으 상주는 머 그어를쩌꺼 성보기라 그은 또 제사알 지내요	그래 소렴을 마치고 나면 인제 그날 같으면 그 인제 상주는 뭐 그것을 저것 성복제라 그러는 또 제사를 지내요
성보글 지내먼 성복 쩌네는 다리이능 고글 모 태여 상주도	성복제를 지내면 성복제 전에는 다른 사람은 곡을 못 해요 상주도
으 성보기라 그능 거느 인제 머 어이 이트레머 오늘 주거씸므 내일쯤 성복 제사을 치이내요	그 성복제라 그러는 것은 인제 뭐이틀에뭐 오늘 죽었으면 내일쯤 성복 제사를 지내요
상복 제사러 그능 거느 인제 머펴늘 해 어으하고 머 그래 가주 인제 불각찌 성복 제사을 지내먼 성복 제사을 지냄 인저 상주는 상보글 이 이  버이 데요	성복 제사라고 그러는 것은 인제 뭐편을 해어 하고 뭐 그래가지고 인제 불 같이 성복 제사를 지내면 성복 제사를 지내면 인제 상주는 상복을입어야 입어야 돼요
상 베오스로 인제이 가라이이꼬 커래 가주우 그날브틈 인제으 고걸 해서 상주가	상 베옷으로 인제 갈아입고 그래 가지고 그날부터 인제 곡을 했어상주가
머이 사목 고글 모 타다가도 성보글 지내어 보글 이븐 다으메느 아이고러 그는 고글 해요	뭐이 사뭇 곡을 못 하다가도 성복제를 지내고 성복을 입은 다음에는 아이고라 그러는 곡을 해요
그래가주 인제 상문서 문상객뜨리 오먼 문상객뜨또 가치 인제 에 엠 맏재밸하고 이니 영위를 다니고 인저 상주한데 맏재배을 그 맏재배을 한데 인제 문상온 사람드른 초로 그 인제 므어 써 기양 절만 하기 쑥쑤로 하이께네 그 머 상고을 당애서 얼마나 으 앵 이 그 머 애서칸냐꼬 마이제 이른 시그로 인제 인사말씀 해요	그래서 인제 문상객 문상객들이 오면 문상객들도 같이 인제어 맞재배를 하고 이 영위를 다니고 인제 상주한테 맞재배를 그 맞재배를 하는데 인제문상 온 사람들은 주로 그 인제 뭐 쑥 그냥 절만 하기 쑥스러워 하니까 그 뭐 상을당해서 얼마나어 이 그 뭐 애석하냐고 말이지 이런 식으로 인제 인사 말씀을해요
그래 참 이미 이그 잉으 저부시에 상을 당애서 응우후 우옌냐코마육 그른 소리로도 인살 하고	그래 참 이 이 이 저불시에 상을 당해서어우 어떻게 하냐고 말이지 그런 소리로도 인사를 하고
그래 인제 상지를 치 치루먼 고다으민 인제 성복 지내먼 그 인제 그음 망이네 장녜 줌비를 해여	그래 인제 상례를 치 치르면 그 다음에는 인제 성복제를지내면 그 인제 그 망인의 장례 준비를 해요
오오 과늘 사 오고 관니라 그응 게 너리 말씨더 너를 가서 시자아 가서멈 머 이떠 옌나렌너 시장에 사 옹 거 이짠 보통 지베 노코 해써인 너으르아	오 관을 사 오고 관이라 그러는 것은 널을 말해요 널을 가서 시장에 가서 뭐 뭐이 옛날에는 시장에서 사 온 것 이것을 보통 집에 놓고 했어요 널을
옌날버뜸 어르니 게시음마 너를 장만해 나써요	옛날부터 어른이 계시면 널을장만해 놓았어요
그걸 인제 대모글 불러 가주 그걸 은제 짜요	그것을 인제 대목을 불러 가지고 그것을 인제 짜요
너으럴 짜가주 인제 에 에끄 크래가주 인제 성복 찌내고 너를 짜 가주어느 이꽌할 땐능 글 인제 에 대르미라 캐요	널을 짜서 인제어 그래서 인제성복제 지내고 널을 짜 가지고는 입관할 때는 그것을 인제대렴이라고 해요
소리밀 때 소렴 대렴 한데 대려미라 그능 거느 인제 에 시시네다서렁을랑그이 옌날 마껀 수이라 그니더 웨 으이 주구꼬 어이 주거써 이 이꼬 가늠 오설 수이라 그능 게으 허게 주로 인제 베로 해요 명주로 하고	소렴일 때소렴 대렴 하는데 대렴이라고 그러는 것은 이제시신에설랑 그이 옛날 말로 수의라 그럽니다 왜죽고죽어서 입 입고 가는 옷을 수의라 그러는 게그게 주로 이제 베로 해요 명주로 하고
그글 은제 이페 가주고 그래 인제 머씨케고 그래가주 인제 국 과네 여가정 이꽈늘 하먼 이꽈늘 해가주 인제 하먼 그 상주드리 모도 옥 어허이 영위에 나와써우 고글 하고 그래그 난 디에는 그 인제 에 장이리 사밀짜이맘 머 그날 고마 배께 야깐 내나따가여 한 전느매 씨 시빌짜이나 치릴짜이나 오일짜이네데마 그으 급 과늘 바아 몬 나두그으요	그것을 인제 입혀 가지고 그래 인제 뭐아 씻기고 그래서 인제 그 관에 넣어 가지고 입관을 하면 입관을 해서 인제 하면그 상주들이 모두어 영위에 나와서 곡을 하고 그렇게 하고 난 뒤에는 그 인제어 장일이 삼일장이면 뭐 그날 그만 밖에 약간 내놓았다가 한 저 십 십일장이나 칠일장이나 오일장이나 되면 그 그 관을 방에 못 놔두거든요
웅 거 부패하기 때무레	어 그 부패하기 때문에
그래 배께 가따설랑 토롱이라꼬 해요	그래 바깥에 가져다설랑 토롱이라고해요
토롱이라 그능 거는 인제 근 너를 얻 배께서 땅알 이래 널 드갈 만찌음음 쪼끔 파고 고다 노코 이 영개라 그니드이	토롱이라고 그러는 것은 인제 그널을밖에 땅을 이래 널이 들어갈 만큼조금 파고 거기에 놓고 이 이엉이라그럽니다
옌나레이 지프로 이래 소느로 여껀능 거 그 그걸 가주어 둘러논니더	옛날에 짚으로 이래 손으로 엮은 것 그 그것을 가지고 둘러놓습니다
그 둘러노능 거느 겨을그로눈 더 러어라꼬도 조꼬 온도도 떠이떠 여르므로너잉여 거느을 방지해 주고 또 그램 우중에능 그 비도 바다 주고 크래 가주어그래 영개라 그능 걷 더퍼 논니닫	그 둘러놓는 것은 겨울으로는 덜 얼어서 좋고온도도 따뜻하고 여름으로는 그늘을 방지해 주고 또 그리고 우중에는 그 비도 받아 주고 그래 가지고 그래이엉이라 그러는 것을 덮어 놓습니다
더퍼 가주우 그래고 인제 머 에에헤 그러고 인젣 장니리 다오멍고 사니인제 모도 싸 흔녀 문상객뜨리 오제 머예 장일까지느	덮어 가지고 그리고 인제뭐그리고 인제 장일이 다가오면그 사이는 인제 모두 상문 인제 문상객들이오지 뭐요 장일까지는
인제 그 동니 모두 부골 해 나이쓰이께네	인제 그 동네 모두 부고를 해 놓았으니까
부골 바덤 븐드리 오늘 온 사람더 꼬 내이리사람 머 치 릴랄 다일 오는 사람더 이꾸 머 그런데 그건 머엡 대정웝씨 치릴짜이라 금 그날 와 자 상주 무는 사람더 이꼬 그래이 치 릴가늑 꾸주니 문상개글 바꼬 그래 인제이 장이리 다오먼 은 인제 옌나레는 장이리 다오먼 요새능 굼 머 차로 실꼬 저래가 뿌이껜 펜언데 옌나렌너 행상이라 그느 걸 꾸메느게	부고를 받은 분들이 오늘 오는 사람도 있고 내일 오는 사람 뭐 칠 일에 당일에 오는 사람도 있고 뭐 그런데 그것은 뭐 대중없이 칠일장이라 그러면 그날 와서 저 상주를 보는 사람도 있고그래 칠 일간은 꾸준히 문상객을 받고 그래 인제 장일이 가가오면인제 옛날에는 장일이 다가오면 요새는 그 뭐 차로 싣고 저래 가 버리니까 편한데 옛날에는 행상이라고 그러는 것을 꾸몄어요
행사이라 그능 거 인제 그거 행사이라 그능 거는 내이리 장사 거뜸머 인  제 오늘 모도엗 저녀겡 그 고찌비라 그능 그 행상을 이 매끼 논는 지비 인니더그어끄 가따 노헌 지비	행상이라 그러는 것 인제 그것 행상이라 그러는 것은 내일이 장사 같으면 인제 오늘 모두 저녁에 그 곳집이라고 그러는 그 행상을 이 맡겨놓는 집이 있어요 그것을 갖다 놓은 집이
그어 그 그게 고찌비러 근데으 거어 가서 인자 마카 그 자료을 어잉어 매상가찌브로 그미이 나르니다	거기에 그 그게 곳집이라고 그러는 거기에 가서 인제 모두 그 재료를뭐 상갓집으로 그메 나릅니다
미이 나르고 인제 낼 아치메 인제이 시 식쩌네 동니 사러미 그 인제 장사지느러 운 사럼 상두구니러 근니다	메 나르고 인제 내일 아침에 인제 식전 식전에 동네 사람이 그 인제 장사 지내러 온 사람을 상두꾼이라 그럽니다
으 상두군	어 상두꾼
상두군드리 모도 와 가주어 그어서 인제 에 상가찌베서 아치믈 가치 머꼬그래 인제 그거으 으어 거 인제 행상을 꾸메지 머 조리블 하지 머에	상두꾼들이 모두 와 가지고 거기에서 인제상갓집에서 아침을 같이 먹고 그래 인제 그것그 인제 행상을 꾸미지 뭐 조립을 하지 뭐요
인제 서와가주 인제 그래 가주운 조리비 다 마치믄 클짜즈 인제 상가찌베서줌비 다 데따 그먼 그러 인제 느어럴 토롱 해 나아떤 느어럴 응어 씨 시시널구 과늘 파내 가주고 머 이 이래 그 그래 그 거 주럴 거러 나써 멍 데	인제세워서 인제 그래 가지고 조립을 다 마치면 그쪽에서 인제 상갓집에서 준비 다 됐다고 그러면 그래 인제 널을 토롱을 해 놓았던 널을시 시신을 관 관을 파내 가지고 뭐 이 이래 그 그래 그 거기에 줄을 걸어 놓았어 묶는 데
그래 마뜰고 상두군드리 와서 그이 어어어에 고 행상에 땅 마뜨롱 논는 통이 이써용 고다 여어가주 인제 더퍼씨여며 인제 그르 인제 행쌍 에에읍 그걸다 떠퍼씨에먼 상두군드리 소릴 해요	그래 맞들고 상두꾼들이 와서 그그 행상에 딱 맞도록 놓는 통이 있어요 거기에다 넣어 가지고 인제 덮어씌우면 인제 그래인제 행상그것을 다 덮어씌우면 상두꾼들이 소리를 해요
인제 줌비그 다 제즈 출발해두 데느냐우 그래먼 그래 인제 그어 상가찌베스넌 으어 저 바린제를 또 지내으	인제 준비가 다 되었으니 출발해도 되느냐고 그러면 그래 인제 그 상갓집에서는 그 저 발인제를 또 지내요
바린니러 그능 건 인제 에 이 이 이 부니 이 지베섣 주거 가주고 영영 인지느 떠난다 카능 거 인제 바린제를 지내엔데 그읍바리니러 그능 그넌 그인제듣 추기 인니더 웨여	발인이라 그러는 것은 인제이 이 이 분이 이 집에서 죽어 가지고 영영 인제는 떠난다고 하는 것 인제 발인제를 지내는데 그 음발인이라 그러는 것은 그 인제 축이 있어요 왜요
바린 추기 인데 그 칟 추 추기러 거능 겓 드러보옴 마으메 안 데찌 머예	발인 축이 있는데 그 축 축 축이라고 그러는 게 들어 보면은 마음에 안 됐지 뭐요
영구종처니라 그느 인제 그른 뭄핀 나오잔니껴	영구종천이라 그러는 인제 그런 문구가 나오잖아요
그 그른 추걸 이르먼 상주두른 마쩌를 해요 인제 그	그 그런 축을 읽으면상주들은 맞절을 해요 인제 그
느으 그 너레 실렌 어른하꼬 영결종천하먼 추게서 상주하코 널하코 마쩌르해용	어 그 널에 실린 어른하고 영구종천하면 축에서 상주하고 널하고 맞절을해요
그 해 행상이 젤 아페 미이떤 사러미 야까누 구 구펴 조용	그 행상 행상을 제일 앞에서 멨던 사람이 약간 굽 굽혀 줘요
그럼 인짇 저리 데는 세민데 그래믄 인제 예헤웨 출발하지 므 행상이 인제 다 지느 그릳 지베또 은제 함 바꾸 도라가는 데도 이 이써요	그러면 인제저렇게 되는 셈인데 그러면 인제출발하지 뭐 행상이 인제 다 지내고 그 집에도 인제 한 바퀴 돌아가는 데도 있 있어요
연 내가 사던 지비라가 마당을 도라 디아느로 도라간 사름도 이꼬 그르저 지비 저근 지벵 고마 마다으서 그검 머 작뼐하고여 종천을 하고 추초 출발허만 그래 가서 산지이 가서 인제 장사을 치 지나고 장사 지나은당긴 데 매장이그더 그 인제 이 시시늘 무꼬 그어서 인제 또 시시느릅 다 무드믕그 그어서인제 머 추기 또 이써 머 평토어제이니 머에 하능으 그릉 거 머우 여러 가지어	어 여기 내가 살던 집이라서 마당을 돌아 뒤안으로 돌아가는 사람도 있고 그래서 집이 작은 집에서는 그만 마당에서 그것 뭐 작별하고 종천을 하고 출 출발하면그래 가서 산에 가서 인제 장사를 지 지내고 장사 지낸다는 게 매장이거든 그 인제이 시신을 묻고 거기에서 인제 또 시신을 다 묻으면 거기에서 인제 뭐 축이 또 있어 뭐 평토제니 뭐라 하는 그런 것 뭐 여러 가지야
평토 제사도 이 써 여 그래 즈 제사알 다 지음 평토 제사랑 게 또 이즈에	평토 제사도 이 저 여 그래 저 제사를 다 지내면 평토 제사라는 게 또 있어요
떠글 가 가주에 해 가주고 가뜽 그어 인제 에 산쏘 아페 노꼬 그 인제 상주드리 저럴 하고 고궐 하고 그래 인즈 성보기라 그능 거 참 그래 에 평토 제사라 근드아 어으랄 여기 이 자리에 모셔씀니러 하능 그 뜨시지 머 평토라 긍 게	떡을 가지고 가서 해 가지고 갔던 것 인제산소 앞에 놓고 그 인제 상주들이절을 하고 곡을 하고 그래 인제 성복이라 그러는 것 참 그래평토 제사라 그런다 어른을 여기 이 자리에 모셨습니다 하는 그 뜻이지 뭐 평토라 그러는 게
그래구 은제 다 차나먼 그래 평토 제사그 끔나먼 인제 그어서 상주드리 그으 그이 영위를 함 바꾸 도라 가주고 함 바꾸 도라 가주고 인제 에에헤 어이춛 추 지 지브로 오지 머에	그러고 인제 다 지내면 그래 평토 제사가 끝나면 인제 거기에서 상주들이 그 그 영위를 한 바퀴 돌아 가지고 한 바퀴 돌아 가지고 인제어 출 출 집 집으로 오지 뭐요
어르얼 그이 다 무더시이께네	어른을 그 다 묻었으니까
지베 오미 인제 그 또 제사가 또 인니더 웨요	집에 오면 인제 그 또 제사가또 있어요 왜요
으 읻 체게 도우먼커게 인제 오래뎅 그 그어능 거 평토 제사 지내고여 쯔 찌 차벼 노으먼 인제 그 멀 반혼제에라 그릉 게 인니더	어 이 집에 들어오면그게 인제 오래된 것 그것은 그 평토 제사 지내고 저 저 차려 놓으면인제 그 무엇을 반혼제라고 그러는 게 있습니다
반혼 제사라 그능 게 인제 인제 이 에 심주를 모시고 내리와따 지 지베와따 카능 거 인제 그래 반혼 제사을 치나먼 그 인제 요론 상 우에다설랑 그  인제 신주르 모시니다	반혼 제사라 그러는 게 인제 인제 이신주를 모시고내려왔다 집 집에 왔다라고 하는 것 인제 그래 반혼 제사를 지내면 그 인제 요런상 위에다설랑 그 인제 신주를 모십니다
신주러 그능 게 그 이 금 머 오 여르에따 꺼뜸 머 현고 유인 머머 이현비유인 머 그래 가주써 은제 어른 어내 언 아베 표씨를 핻 해 가주고 신줄요래 모쎠 노옴 그게 인제 변소라 그랜네껄 옌나러 말하 까뜽	신주라고 그러는게 그 이 그 뭐여자다 할 것 같으면 뭐 현고 유인 뭐뭐 이 현비유인 뭐그래 가지고서 인제 어른 어머니 아버지 표시를 해 해 가지고 신주를 요래 모셔 놓으면 그게 이제 빈소라 그랬어요 옛날로 말할 것 같으면
이런 사랑방에아야 얌빵에 이른 데 채리 로우먼 그 그 거게 에이으 대해가주우 인제 상주드리 초호루 보루무로 그어 으 상망을 지내인니더	이런 사랑방에 안방에 이런 데 차려 놓으면 그 그 거기에대해 가지고 인제 상주들이 초하루 보름으로 그삭망을 지냅니다
상마이라 긍 읻 초하루 보르미고 또 그르금 아침 저어그로는 그 인제 이변소에 거으 그이 기양 인젣 조서그로 보통 으 사라 게실 때매똥 정시만 안드래업 아침 지여그론넌 그우 웨 이 그어 이 에든 능 이 으 바벌 올리니다	삭망이라 그러는 게 초하루 보름이고 또 그리고 아침 저녁으로는 그 인제 이 빈소에그 거기 그냥 인제 조석으로 보통살아 계실 때처럼 점심만 안 드리고 아침 저녁으로는 그 왜 이 그 이어 이밥을 올립니다
그래그 인제 특뼐한 제사는 인제 초하루 보르므로 인제 그른 여 상마이라그는 제사를 지너	그리고 인제 특별한 제사는 인제 초하루 보름으로 인제 그런이 삭망이라 그러는 제사를 지내고
그래 머 삼 녀느 그래 가주우 이 옌나레 그게 참 므 끄 상주줄 하기에 퍽에로와떠이여	그래 뭐 삼 년을 그래 가지고 이 옛날에 그게 참 뭐 그 상주질 하기가 퍽 어려웠어요
예이 요새 거뜨 그래 모 타시 께르요	옛 요새 같으면 그래 못 했을 거에요
그 더우나 추우나 그 삼 년가늘 아침 저으로 바블 조서글 떠 나 디래이 덴또 초하루 보르므로 머 익 기양 하능 게 아이르 펴늘 해 가주오 상망 제살 지내이 데제 그을 삼 녀늘 해용	그 더우나 추우나 그 삼 년간을 아침 저녁으로 밥을 조석을 떠 놓아 드려야 돼 또 초하루 보름으로 뭐 이 그냥 하는 게 아니라 편을해 가지고 삭망 제사를 지내야 되지 그것을 삼 년을 해요
그 삼 녀이러 그능 게 그그 참 긴 세워리시더	그 삼 년이라 그러는 게 그것참 긴 세월입니다
그래 모시구동 그 인제이 옌나레능 거 이 효자라 카는 등명을 할라꼬 모두거 불효 소리 드짜 늘라꼬 또 그 인제 나는 이 내 어른 이키 잘 모신다 카는뜨스로 인제 그 삼 년 삼 년 또 대상을 지내인띠아	그래 모시고도 그 인제 옛날에는 그 이 효자라고 하는 득명을 하려고 모두가 불효 소리 듣지 않으려고 또 그인제 나는 이 내 어른을 이렇게 잘 모신다고 하는 뜻으로 인제 그 삼 년 삼 년 또대상을 지냅니다
삼 년 날 때능 그이 대사이라 그니더	삼 년 날 때는 그것을 대상이라고 그럽니다
이태마넨 소사이라 그으고	이태만에는 소상이라고 그러고
끄 이 대상을 참 어여 성대히 그 제살 찌 지나고 모두 동네 사람 인척 가네 염비사가이 연사가가네 점부 모도 와가주 그래 인제 허러으 그랟 대상 뜨는 또 웨처 사가기늠 머 사돈 찌비라든지 메느리 지비라든지 또 내가 보낸 따르 지비라든지 거게서늠 그 인제 으 아엗 정서이라꼬 그래가주 인제 그 머 거지베 그얻 쩌 여 그 승 넝읍 그으거 주굼 부늘 위해가씅얼 펴늘 해가주 온니다	그 이 대상을 참성대히 그 제사를 지 지내고 모두 동네 사람 인척 간에 연사간 연사간에 전부 모두 와서 그래 인제그래 대상 때는 또 외척 사가이거나 뭐사돈 집이라든지 며느리 집이라든지 또 내가 보낸 딸의 집이라든지 거기에서는 그인제어 정성이라고 그래서 인제 그 뭐 그 집에 그 저그 승그것 죽은분을 위해설랑 편을 해서 옵니다
허릉여 거게 인녜 제무늘 지꼬 머 그래 가주우 그 저 응 고걸 하고 그래참 머 꺼 여 성대히 치룬니더 대상얼	그리고 거기에 인제 제문을 짓고 뭐 그래가지고 그 저 응 곡을 하고 그래 참 뭐 그성대히 치릅니다 대상을
응 그 그램 인제 삼 녀니 다 낭게 인제 보걸 버꼬 대상 낟 상주가 삼 녀녈 라쓰이께네 인지는 상 상보걸 버씀니다 하는 뜨시 대사인데 그래 상보걸보꼬 일반 평이느루 도라가지 인	어 그 그러면 인제 삼 년이 다 지났으니 인제복을 벗고 대상 지냈으니 상주가 삼 년을 지냈으니까 인제는 상복 상복을 벗습니다하는 뜻이 대상인데 그래 상복을 벗고 일반 평인으로 돌아가지 인제
그래 인제 변소오도 그거 인제 심즈도 응혀 매호널흠 매즈매호널 해 뿌우 가써	그래 인제 빈소도 그것 인제 신주도매혼을 매혼매혼을 해 버려 가서
고 인제 끄 가차운 언느 어데 삼삐써리나 이른 데 가서 무더 쁘래요 그어느	거기 인제 그 가까운 어디 어디 산기슭이나 이런 데 가서 묻어 버려요 그것은
허구 인제 매호니라 그래고 그래 무드므 인제 다 윽 그 부네 대항 거는 에삼 년 제사가 다 끈나고 고다음 인젠 나믕 거능 기제사배께 남찌 안챈나	하고인제 매혼이라 그러고 그래 묻으면 인제 다그 분에 대한 것은삼 년 제사가다 끝나고 그 다음에 인제 남은 것은 기제사밖에 남지 않잖아
그래 인지 조싸이 삼 녀널 나도 어르니 도라가신 날짜를 귀해 가어주주고제살 지내이더 기제사라 그능 거 엉 거 바므로	그래 인제 조상이 삼 년을 지나도 어른이 돌아가신 날짜를 기해 가지고 제사를 지냅니다 기제사라 그러는 것 어그 밤에
열뚜 시 한 시 사이예	열두 시와 한 시 사이에
그걸 기 끼 기제사라꼬엳 지내고 그랜니드	그것을 기 기 기제사라고 지내고 그랬어요
그 그래머 인제 삼년상이 닥 끈나능 게지	그 그러면 이제 삼년상이 다 끝나는 것이지
그르치에	그렇지요
어르 어르시 그럼며너 그어 이제 방금 이야기를대강 그으거 이 그어우  어르싱께서 이 동네예 장네에 대한 대강의 이야기를 해 주션는데 아어 그러 끄러케 해 주션는데 끄언 아까엄 보통 긍어 요주움먼 머 사밀장하고그 다음메또 탐 마	어르신어르신 그러면은 그 이제 방금 이야기를대강 그것 이 그것어르신께서 이 동네의 장례에 대한 대강의 이야기를 해 주셨는데그렇게 그렇게해 주셨는데 그 아까 보통 그것 요즘은 뭐 삼일장하고그 다음에 또 다음 뭐
오일짱 므어 치릴짱 곰 머 옴 머 시빌짱 그래 지낸 사암더 영 보름찡 지내인또 인네 엔녜다	오일장 뭐 칠일장 그 뭐뭐 십일장 그래 지낸 사람도 있고 보름장 지내는 사람도 있 있어요
예저네너 마이 해따 그지에	예전에는 많이 했다 그렇지요
그다음메그어스 대상 하는 사암도 이꼬 소상 하는 사암드 이스꼬 그지예	그다음에거기에서 대상 하는 사람도 있고 소상 하는 사람도 있었고 그렇지요
아이래 소상 대상은 맹 다 지내요	아니요 소상 대상은 역시 다 지내요
다 하고	다 하고
이패마네예를 드러서 도라가신 내으 금녀네 도라가쓰믄 내여네느 소상이고 삼 년째 든 덴 대상이고 그러이더	예 이태만에예를 들어서 돌아가신 해가 금년에 돌아가셨으면 내년에는 소상이고 삼 년째 든 데는 대상이고 그렇습니다
그륻 그륻습 보통 탈상을 삼 년까지를 해따 그지에	그래 그래서 보통 탈상을 삼 년까지는 했다 그렇지요
예으 삼 년까지는 다 해뜨	예삼 년까지는 다 했어 예
소상엔 탈쌍을 모 타고 머 이애	소상에는 탈상을 못 하고 뭐 이래 예
그 아응 보통쓰 그어 한은 그 무더메 인지 무돔 봉분 만들고매장을하고 난 다으메 한 사 밀째 데는 나른 검며너 사무제도 함미까	그보통그 한 그 무덤에 인제 무덤 봉분을 만들고매장을 하고 난 다음에 한 삼일 째되는 날은 그러면은 삼우제도 합니까
예 사므이제	예삼우제
사뮈제를 지낸니더	삼우제를 지냈어요
요이 요새도 거이 다 그건 하 께레요	요 요새도 거의 다 그것은 할 거에요
그엄 머 사미제로설랑 다 마치능 꺼 떠라끄 요새앤 마료	그것 뭐 삼위제로설랑 다 마치는 것 같더라고 요새는 말이야
고마 보글 버서 뿌드라꼬	그만 상복을 벗어 버리더라고
근 녀 사미제는 능이 요새도 합띠다	그 이제 삼우제는 이 요새도 하더라고요
그 은저 이 예전 요주우메 비하먼 예정 가틍 경우넘이 장네 절차도 복짭하고 그대앰 머 일도 마나어찌짐	그 인제 이 예전 요즘에 비하면 예전 같은 경우는이 장례 절차도 복잡하고 그 다음 뭐 일도 많았지요
보짜패요 망코 마고지요	복잡해요 많고 말고지요 예
그른데 이 요주옴 옌나레 비해서 요주움먼 쫌 어떤 시어루 간소화가 데씀미까 요주엄 장네는	그런데 이 요즘 옛날에 비해서 요즘은 좀 어떤 식으로 간소  화가 됐습니까 요즘 장례는
요새는 기양 머 장녀 지내능 거또 말시더 상주가 할 리리 업써용	요새는그냥 뭐 장례 지내는 것도 말입니다 상주가 할 일이 없어요
웨냐 옌나네능 거 상주 채기미 참 즏 조 중핸니더	왜냐 옛날에는 그 상주책임이 참 중 중 중했습니다
그걸 첨부 그걸 초아늘 해 가주우 마리지 으이 주이 문중 어른들하꼬 이래이러 하자건 타하블 해 가주어 겨쩡언 상주 결쩡이 나이 데그더	그것을 전부그것을 초안을 해 가지고 말이지저 문중 어른들하고 이래이래 하자고 타합을해 가지고 결정은 상주 결정이 나야 되거든
상주구 조타 그래이 덴데 그 그게 어끄더	상주가 좋다 그래야 되는데 그그게 없거든
요새는 고마 사아 저 어어이 병워네 가서 이 그움마 장사을 지내이께네 마리야	요새는 그만 상 저병원에 가서 이 그만 장사를 지내니까 말이야
거기 장이사 곰마 하 하란 데루 해 뿌래 고마	거기 장의사가 그만 하 하라는 대로 해 버려 그만
예를 뜨러 가주여 규저이 업뜨라꼬 머 지 장이사가 내앨 머 어이 금 음인 저거 하베 이꽌함니다 거서 결쩡해 쁘드라꽁	예를 들어 가지고 규정이 없더라고 뭐 장 장의사가 내일 뭐그이 저것 하지 입관합니다 거기에서 결정해 버리더라고
그래이 장 응 거으 상주는 따를 수배껭 업뜨러꽁	그러니 장그 상주는따를 수밖에 없더라고
구러 고멍 이꽌한 날 고 모도 억 가차운 머 이 자네질떠리여 가 까 가치 가서 보고 이이꽌하고 그래띠더	그래 그만 입관하는 날 그 모두가까운 뭐 이자녀들이 같 같 같이 가서 보고 입관하고 그러더라고요
그울꼬 머 요새는 또 그르꼬 그게 머 이꽌해 뿌고 나이 마리얌 기양 상주는그이 영아 어이 영안시를 떠나 가주고 이짝 빵으 와서 고마 그어 으어어이이예 여를 뜨러 마하 꺼비 옌날 그떰 변소 태기지 그 셰 신니를 모셔 논 요른쪼마낭 으 머 사지늘 요샌 시닐 안 써 노꼰 사지늘 윽 가따 노뜨라 영위라 그래고 거 사진 아페써 머 절 라고 서로 상줄 무꼬 바꼬 그래고 고만 매장일또구넨 내앨 곰마 사밀짱 끄은다 금 내열 긍 어엉 메 씨에 즈 짜엑매장지룯출발함니다 그 이 즈 장이사가 그래이께네 우우머 상주눙 그래 딸트라꾸 또	그렇고 뭐 요새는 또 그렇고 그게 뭐 입관해 버리고 나니 말이야 그냥 상주는 그 영안영안실을 떠나 가지고 이쪽 방에 와서 그만 그예 예를 들어 말할 것 같으면 옛날 같으면 빈소인 셈이지 그 신위 신위를 모셔 놓은 요런 조그마한 것 뭐사진을 요새는 신위를 안 써 놓고 사진을갖다 놓더라 영위라 그러고 그 사진앞에서 뭐 절 하고 서로 상주에게 묻고 받고 그러고 그만 매장일도 그냥 내일 그만 삼일장 지낸다고 그러면 내일 그몇 시에 저 저매장지로 출발합니다그 이 저 장의사가 그러니까 그만 상주는 그렇게 따르더라고 또
그르이 상주능 고마 끄으 인 장이싸써 옌날거치 멍에 내 부모라꺼연 내가 이래이 한더 저래 한더 거거읻 주장을 모 타고 그 병워네서 영안시레서 정하는데로 합띠다	그러니 상주는 그만 그 이 장의사가 옛날 같이 뭐 내 부모니까 내가  이래 한다 저래 한다 그 주장을 못 하고 그 병원에서 영안실에서 정하는 대로 하더라고요
그르 나 가주 구마 영구차 불러 가줌 실꼬 나갈 찌이 고마 그 거게어 인제단지 인제 그검 에 출발할 찌게 에 그 맹으 형시기지맘 본지비 아인데으 그바린쩨에를 지냅 피로고 엄는데 응 그래두 거이 영안시레서는 자기느 수이블바래 가주우여 바린제을 지냅띠다	그래 놓아 가지고 그만 영구차 불러 가지고 싣고 나갈 적에 그만 그 거기에 인제 단지 인제 그것출발할 적에그 역시 형식이지만 본집이 아닌데 그 발인제를 지낼 필요가 없는데 응 그래도 거기 영안실에서는 자기네 수입을 바라 가지고 발인제를 지내더라고요
근데 응 이 나도 그른 썰렁 해 해써 그 이 뭄 버 물런 영안시레서 하라그에 하기넌 네 바리니라 근능 근는 쩜 영구종천 이 인사을 하능 겐데 내 지베가 가주설러 하능 게지 병워네 머 영구종청 배 끼 머 인느 요 와서 어뜨나 그바린제을 지낸능 그 상줍 머 부다믈 더 쓰능 거빼께 아이라 그러이께네	그런데이 나도 그런 소리를 했 했어 그 이 물론 뭐 물론 영안실에서 하라니까 하기는 해도 발인이라 그러는 것은 좀 영구종천 인사 인사를 하는 것인데 내 집에가 가지고설랑 하는 것이지 병원에서 뭐 영구종천 할 게 뭐 있나 요기 와서 어떻게 그 발인제를 지내는 것은 그 상주에게 뭐 부담을 더 시키는 것밖에 안 되지 그러니까
끄어 인제 이 장이싸으저 아이 그르치 아내우 어른 그른 소른으흐흔 마이소 크은 여아 다 하기 데 인니더 금 아유 글쯔아 한다그 내 모 타그러 한냐고 금 원처 그 피로가 엄능 거 아이냐검 그래도 이얘기한 제기 인니더마는 끄러 상주 부다믈 자꾸 쓰게지 마고 은 그래 지내앵 게 나 짠나 그 소리래찌 내금 머 하라 소리너 안 하라 소리능 안 해 짠냐고 그래구 므 그래 얘기도 하고누	그 인제 이 장의사가 아니 그렇지 않아요 어른 그런 소리는 하지 마세요 그것은 여기에서 다 하게 돼 있어요 그러길래 아니 글쎄 한다는 것을 내가 못 하게하느냐고 그 원체 그 필요가 없는 것 아니냐고 그렇게도 이야기 한 적이 있습니다만은 그래 상주 부담을 자꾸 시키지 말고그래 지내는 게 낫지 않냐 그 소리였지 내가 뭐 하라는 소리 안 하라는 소리는 안 했지 않냐고 그러고 뭐 그래 얘기도하고
그르고 나이 머으 기양 고마 또 구어이 저으 저 엉으 장이삳 출발해 가주운 직쩝 머 어떤 어떤 지베는 매장하는 집또 이꼬 어떤 지이능 고마 화장해가주 굼머 그래음 우우 머 움 모 곰마어 치아 뿐 집또 이꼬으 그르이 그머 이 이게 올따 저거 얼따 소리옫 할 쑤 어꼬 그래으 머 상주드리 펜트라꼬 요샌 마러	그러고 나니 뭐 그냥 그만 또 그 저 저장의차 출발해 가지고직접 뭐 어떤 어떤 집에서는 매장하는 집도 있고 어떤 집에서는 그만 화장해 가지고 그만 그래뭐뭐 그만어 치워 버리는 집도 있고 그러니 그 뭐 이이게 옳다 저게 옳다 소리를 할 수도 없고 그러니 뭐 상주들이 편하더라고 요새는말이야
머응그키 머 애쓰 꺼또 어꼬 머 으 숨 떠러징 고읍 상주 구머보도 모 태꼬	뭐그렇게 뭐 애쓸 것도 없고 뭐숨 떨어진 것을 상주는 그만어 보지도 못 했고
또 요새는 옌나렌 그겨 참 어르늘 모시고 사다설랑 그 어응 그걸 그 인 도라가시능 걸 응 그걸 모 뽀먼 불효가 데따 그랜니더	또 요새는 옛날에는 그것참 어른을 모시고 살다가설랑 그그것을 그 인제 돌아가시는 것을그것을 못보면 불효가 됐다 그랬습니다
끄은데 임종을 모 타멈 마리아	그런데 임종을 못 하면 말이야
그 요새느 거이가 임종을 모 태용	그 요새는 거의가 임종을 못 해요
웨냐 객찌이 가 이뜬 사럼드리 매일 와 이찌도 모 타지르 또 어여 지베서요주먼은 보이께네 아엡 병이 드러 가주에읻 지베 편차네엗 주거도 고머 장이사로 갑띠르 고마 이 실꾸 장이쓰 차 불러 가주오	왜냐 객지에 가 있던 사람들이 매일 와 있지도 못 하지 또집에서 요즘은 보니까병이 들어 가지고 집에서 편찮아서 죽어도 그만 영안실로 가더라고요 그만 이 싣고 장의사 차 불러 가지고
므이 찌 지베서 안 지내오 곰 머 장이사가 저 그거 거으 그짝끄 규정대로따르스 지내 뿌이 상주는 편해요	뭐 집 집에서 안 지내고 그만 뭐 장의사가 저그것 그 그쪽 규정대로 따라서 지내 버리니 상주는 편해요
응 이 요는 물론 깅 경비두 좀 나게찌만능 옌날 드명 경비가 나찌마는 나능 겐데 으 상주가 그음 머어어 부모에 대정 효시미라 그릉 건 나 이 영업써저뜨라꾜 오새 보이께네	어 이 요점은 물론 경비 경비도 좀 들겠지만은 옛날에 대면 경비가 들겠지만은 드는 것인데상주가 그 뭐어 부모에 대한 효심이라고 그러는 것은 뭐 이 영 없어졌더라고 요새 보니까
므 이 껴 기양 곡또 형시기고 옌나레 꺼튼 참 그게 자기 어르느 모셔고 이떤 또 그 자기 어르니 자기일 그 귀여워함상 마에찌 머 으에 주든 그른 정닐생가해 주온 눔무를 참 마이 흘림미다	뭐 이 그 그냥 곡도 형식이고 옛날과 같은 참 그게 자기 어른을 모시고 있던 또 그 자기 어른이 자기를 그 귀여워하면서 말이지 뭐 어떻게 해 주던 그런 정을 생각해 가지고 눈물을 참 많이 흘립니다
어인 옌날 으이 참 쯘 짇 자녀손드른 그거 읻 쩌에 마 참 거우 고걸 하고상줄 무로 나오믄 자기가으 참 서르멥 복바찌엠 아피 땅기 저씀니다 눔무리흘러 가주고	어 옛날참 저 저 자녀들은 그것 이 저 뭐 참 그 곡을 하고상주를 눈물이 나오면 자기가 참 서러움에 북받쳐서 앞의 땅이 젖습니다 눈물이 흘러 가지고
므 그른 머신 내가 아잉 기 이 나히이 띠 므 그 나이 만찌엔 안젣 드러상가아 다니 반니드먼 느 그른 흔저그너 항 구견 모 타게뜨라꼬	뭐 그런 무엇이 내가그 이 나이 저 뭐 그 나이 많지는 않지만 더러 상가에 다녀 봤지만뭐 그런 흔적은 한 구경을 못 하겠더라고
상주가 자기 부모를르 부모를 때해 생가깨 가주에 애서캐 하는 마으믄 영업뜨라꼬	상주가 자기 부모를 부모에 대해 생각해 가지고 애석해 하는 마음은 영없더라고
고마 이응 그 으으 엑 이 날짜만 때자 고마 어애등 그게 금머 즈 지 짜으어예 봄먼 잘 쭈거따는 생각 꺼뜨라구 내가 보이 마을러	그만 이 그어 이날짜만 때우자 그만 어쨌든 그게 그만 저 저 저 어떻게 보면 잘 죽었다는 생각 같더라고 내가 보니 말이야
머 저어끼레 머 우꼬 머 상주가 글세 머 은제 배께 나가소옥 저어끼르 머하도 웅눙 오 구 이 영안실 내에서 우수물 나와 글쎄 그혀인 내엗 샵 참 세워리 바께긴 마이 바께따 참 마이 달라져따 옌나레는 눔무리 땅을러브 적신데우수미 잉여이 등처늘 하이끼네 이 므으어 이 이른 니 린노 함 생가 뜹띠다	뭐 자기들끼리 뭐 웃고 뭐 상주가 글쎄 뭐 인제 밖에 나가서 자기들끼리 무엇을 하든 웃는 것 그 이 영안실 내에서 웃음이 나와 글쎄 그래 내가 세 참 세월이바뀌긴 많이 바꼈다 참 많이 달라졌다 옛날에는 눈물이 땅을 적셨는데 웃음이 이어등천을 하니까 이 뭐 이 이런 일이 있나 하는 생각이 들더라고요
그른데 아주 그게 나느 마땅찬트라쿠요	그런데 아주 그게 나는 마땅찮더라고요
그이 참 어예 키아뜽 가네 그읃 참 으으 나아 가주오으 그거 참 응 그게예를 드할 마니거 그으거 끄 참 피떵걸읍 바더 가주우설러 그 크 그걸 그마꿈먼쓰 정서 성장하드로익 키아 조씨먼 그점 마 까능 기려녀임 쪼꿈 눔무려더 흘리 주능 게 조 찬나 한 생가근 내인능 해써요이	그 참 어떻게 키웠던 간에 그참낳아 가지고 그것 참그게 예를 들어 말할 것 같으면 그것 그 참 핏덩어리를 받아 가지고설랑 그 그 그것을 그만큼 뭐 성장 성장하도록 키워 줬으면 그저 마지막 가는 길에는 조금 눈물이라도 흘려 주는 게 좋지 않나 하는 생각은 내가했어요
차 에이 부 불효 거튼 누웨 니가 아무르 머 어떤 이 이 니 혼자 컨나 한생가기 그으꾸 곤 나가드라꼬 마엉 거떤 내가 가차운 사랑 거뜨먼 웨이 꼬양말행 긍 그름 버비 어딘 누 그래 내 차 솔히으 하지마는 응 그으또 머 으 그런이 얘기고 읃 그른 생가기 듭띠다	참 에이 불 불효자 같은 놈 네가 아무리뭐 어떤 이 이 너 혼자 컸나 하는 생각이 그 곧 나가더라고 막 어떤 내가 가까운사람 같으면 에이 고약한 그 그런 법이 어디 있나 그래 내 참 소리를 하지만은 어그것도 뭐그런 이 얘기고그런 생각이 들더라고요
응여 그 어에 키안데 그열 그 어느 으 듭 부모가 그읻 자석 손자럴 그 참자기 다칭 거보단 그 그게 아판 나 대먼 든 더 아프다꼬 마으미요	어 그 어떻게 키웠는데 그것을 그 어느저 부모가 그 자식 손자를 그 참 자기 다친 것보다 그 그게 아픈 것에 대면 더 더 아프다고 마음이요
마슴미다 에	맞습니다 예
으게 이게 실찌도 그래 내 여시도 구루타구 머	이게 이게 실제도 그래 나역시도 그렇다고 뭐
나는 아프멈 보토인데 그 머 연더 어얻 이 옌라렌 자시기래찌믄 똑 고 이스엄 손자 머 쏘 손녀드리 머어 다쳐 가주 머 어렁까 컥 가라 배끼고 함 그 참마으미 그낑 저우 우예노 한 생가이 드는데 그래 키안는데도 글쎄 그게 그음마지막 가는 니 잉으익 끄 끄 그날까지도 눔물 함 빠은 흘려창 거 투록 우꼬 장난하고안잔능 거 보먼 한시릅따꼬 참	나는 아프면 보통인데 그 뭐 인제어 이 옛날에는 자식이었지만 또 곧 있으면 손자 뭐 손 손녀들이 뭐 다쳐 가지고 뭐어떻다 그  벗기고 하면 그 참 마음이 그렇게 저것을 어떻게 하나 하는 생각이 드는데 그래 키웠는데도 글쎄 그게 그 마지막 가는 이 이 그 그 그날까지도 눈물 한방울 흘리지 않을 정도로 웃고 장난하고 앉 앉은 것을 보면 한심스럽다고 참
나 이거 이 이 참 이이 잉간 사훼가 이 이르케 변하나 한 새앙도이 이게 어이 내 생가그로 해씀니다	나 이것 이 이 참 이 인간 사회가 이 이렇게 변하나하는 생각도 이게내 생각으로 했습니다
아임미더	아닙니다
그음 머 만는 말씀이주	그것 뭐 맞는 말씀이지요
요즈엄 어뜨에 봄며너 아무래도예저너하고 쫌 무 그럼 부부네서 보음쫌 마니 차이 나는데	요즘 어떻게 보면은 아무래도예전하고 좀 뭐 그런 부분에서 보면 좀 많이 차이가 나는데
마이 암 망언차네 마이 달라져써요	예 많이많이 많이 달라졌어요
영 천지차제 머요	영 천지차이지 뭐요
저언 옌날 사러미 그릉 광경을 보옴 마르저 상문도함니다	저 옛날사람이 그런 관경을 보면 말이지요 문상도 안 합니다
가 뿜니다	가 버립니다
머 이른 데 내거 삼문할 끄인 머 인노 이 이랩끽 께레요	뭐 이런 데 내가문상할 게 뭐 있나 이 이랬을 거에요
옌날 어른들 거틈머 상주거 그른 행동이 요꿈맘 비앰 응 가 봄니얻	옛날어른들 같으면 상주가 그런 행동이 조금만 보이면가 버립니다
상주 암 무씀드앙	상주에게 안 묻습니다
잉 거 급 불효 거튼 금 머 구어 그	이 그 그 불효자 같은 그 뭐 그 그
그 그러며이 워 인제 쫌 으에전하고 요즘하고 쫌 그르케 바껸는데 어르신그럼며너이 요주엄먼 인제 귿 장이사으 그 병원 영안시레스 장이사예 이해스 주로 주도를 해싸 이루지고 그서 어째뜬매장을 할 꼉우에넌 예전네는상녀 가지고  문상을해씀미까 그지에	그 그러면 이 인제 좀 예전하고 요즘하고 좀 그렇게 바꼈는데 어르신 그러면은이 요즘은 인제 그 장의사 그 병원 영안실에서 장의사에 의해서 주로 주도를 해서 이루어지고 그래서 어쨌든매장을 할 경우에는 예전에는 상여 가지고  장례를 안 했습니까 그렇지요
예예 한 상예 상녀로 해찌언	예 한 상예 상여로 했지요
그염 요주움머여 어떠케 함미까	그러면 요즘은 어떻게 합니까
요즈멈 보이께네 마리야 뻐쓰에다 장이사 뻐쓰가 이 인는 데도 기 이꼬또 이쌔늠 마리시더 그 뻐쓰 마고 리무지이라 거느 조은 차가 익 이뜨라우구게여 이	요즘은 보니까 말이야 버스에다 장의사 버스가 있는 있는 데도 있 있고 또 요새는 말입니다 그 버스 말고 리무진이라고 그러는 좋은 차가 있 있더라고그게요 이
그겝 비싸드라꼬요	그게 비싸더라고요
그기 여어서 안동에써 봉와까지 도는데 오심마 안 달러 그래드라꼬여인 장이사 글짜요	그게 여기에서 안동에서 봉화까지 들어오는는데 오십만 원 달라고그러더라고요 장의사 그쪽에서요
그이 영구사 하너 실꼬 와따 가는데	그 영구차 하나 싣고 왔다가 가는데
그 그런 차를 가주고 으 그또 형펴니 점 나은 사늠드리고	그 그런 차를가지고그것도 형편이 좀 나은 사람들이고
또 여 머 이내 영세한 사럼드른 게 읻 기양 그 머 그 장이사 거마영구뻐쓰로 디에써고마우에는 상주들 타고 문상객 타고 미텐너이 영구차 구마 여 웨 시시인 실꼬 그래 가는 차도 이꼬 주로 그러씁띠다	또 여기뭐 이래 영세한 사람들은 그 이 그냥 그 뭐 그 장의사 그만영구 버스로 뒤에서어 그만위에는 상주들 타고 문상객 타고 밑에는 영구차 그만 여기 왜 시신 싣고 그래 가는 차도 있고 주로 그렀더라고요
그엄 쯔 예전 가틍 경우에너 이 매장할 때 주로 사람드릳 동네 사람드리나아아앙 갱꾼드리 가서 그게 이 친지나 그런 사람드리 이를 하지야	그럼 저 예전 같은 경우에는 이 매장할 때 주로 사람들이 동네 사람들이나계꾼들이 가서거기에 이 친지나 그런 사람들이 일을 하지요
예예 동네 사암드	예 동네 사람들
카며 요주움 요주엄뭉 그어기 머어 끄 웨 누워 사라미 함미까 어떠케 함미까	그러면 요즘 요즘은 거기 뭐 그 왜 누가 사람이 합니까 어떻게 합니까
요새는뇨 장이사에 부타글 하만 매장꾸이라능 께 이기 이써요	요새는요 장의사에 부탁을 하면 매장꾼이라는 게 이게 있어요
잉 으 거이 여나모지금 모도 소캐 인는 사럼드릳 이뜨라꼬	이거기 여남은씩 모두 속해 있는 사람들이 있더라고
근데 그에 장이사가 인제 에 실꼬 가 가주우 화장하는 데에는 그 화장은 실러 가차이에그 가 가주우 인젱 끄여 그 매장꾼드른 피료구 어우꼬 으 카 장꼬꺼 인제 화장에예예 에 이윽 거게 소캐 인는 그어 이기 사람드인 나와 가주고인제 이 영굴 실꼬 가먼 크 아네 가따 여붸 태아가주 나오머 인제 그 인제 그읍 크그는 매장꾸니 피료치 아느이께 인제 상주하꼬가차운 친척뜨리 인제그거릅 바다 가주고머 강엡 뿌려 뿐 사람똥 이뜨라꼬	그런데 그게 장의사가 인제싣고 가 가지고 화장하는 데에는 그 화장은 실어 가까이 가 가지고 인제 그 그 매장꾼들은 필요가 없고가지 않고 그 인제 화장에이 거기에 속해 있는 그 이것 사람들이 나와 가지고 인제 이 영구를 싣고 가면 그 안에 갖다 넣어 태워서 나오면 인제 그 인제 그 그것은 매장꾼이 필요하지 않으니까 인제 상주하고가까운 친척들이 인제 그것을 받아 가지고뭐 강에 뿌려 버리는 사람도있더라고
으 근데 또 그르치 아느먼 저레 가서 말씨더 그랜네 어꾸 고래 곰머 어윽모시는은느 저리 이때 또 그게요	어 그런데 또 그렇지 않으면 절에 가서 말입니다 그래그래 그만모시는 절이 있대 또 거기에요
그러 보이께 머 수타이 모셔 나따 사짐 부쳐 가주우	그래 보니까 뭐 숱하게모셔 놨다 사진 붙여 가지고
그른 데 가따 노은 사암도 이꼬 그러씁띠다	그런 데 갖다 놓은 사람도 있고그렀더라고요
주로 인지느	주로 인제는
요즘 그엄 사네 봉분 만드는 사암도 이찌예	요즘 그러면 산에 봉분 만드는사람도 있지요
이써용	있어요
그렁 경우에느 그 사암드러 매장꾼드리 그암며너 가서 인제아 이인	그런  경우에는 그 사람들은 매장꾼들이 그러면은 가서 인제 이 매장꾼드리 온 데는 그 인제 화장을 하 장꼬 어어 여즈 그 인제 에묘지에 매장을 하는서 사라믄 응 그 상가에서는 에 그 이 장이사에다설랑 요샌농초니 사러밈잉 그 잉 구 구하기 에루와요매장꾼들이 오는 데는 그인제 화장을 하지 않고저 그 인제 에 묘지에 매장을 하는 사람은 응 그 상가에서는 에 그 이 장의사에다설랑 요새는 농촌이 사람이이 그 이 구 구하기어려워요
그 여 우리 동네 거튼 데도오 꾸 구하자믄 힘드러요	그 여기 우리 동네 같은 데도 구 구하자면 힘들어요
첨부 지 지 이리 바쁘고 다 그래 노이 그게 이 여나무씩 씸나움씨 모키가에루와요	전부 자기 자기 일이 바쁘고 다 그래 놓으니 그게 이 여남은씩 스물씩모으기가 어려워요
그르이 장이시아다 고맙 부타글 래 뿜 그 장이사에 소깨 인늠 매장꾼드리 잉이뜨라꼬 보이께네	그러니 장의사에다가 그만 부탁을 해 버리니 그 장의사에 속해 있는 매장꾼들이 있 있더라고 보니까
커으 그 사럼드리 또 그 매장꾸드리 와도 벨러 할 릴또 업뜨라꾸요	그그 사람들이 또 그 매장꾼들이 와도 별로 할 일도 없더라고요
그 읻 사시릉 그게 그 매장꾼들 기양 고마돈 주능 게납 마창을네드라꼬	그 이 사실은 그게 그 매장꾼들이 그냥 그만돈 주는 것이나 마찬가지더라고
그 웨 그르냐 하이께네 매장꾸니 여리 와도 으업 우리가여 인 매장을하이께네 그으 사람 언 동네 사라미 업쓰이께 사람 사다구 구먼 며치나 사주노 사주꼬 그럼 아무래또 두 카래꾸는 데에 데께네 세 카래꾼 내지 두 카래꾸는 데에 데이께네 아홈 내지 여른 데에 데자나	그 왜 그러냐 하니까 매장꾼이열이 와도우리가여 이 매장을 하니까 그 사람동네에 사람이 없으니까사람을 사다오 그러면 몇이나 사 줄까 사 줄까 그러면 아무래도 두 가래꾼은 돼야되니까 세 가래꾼 내지 두 가래꾼은 돼야 되니까 아홈 내지 열은 돼야 되잖아
그램 인지 자기네어 보통 열씩 사 가주오 나오먼 그 밤메르 거 포꾸렝을 또사요	그러면 인제 자기네가 보통 열씩 사 가지고 나오면 그 반면에 그 포클레인을또 사요
포끄레이러 그능 거 이래땅 파고어 문능 거	포클레인이라고 그러는 것이래 가지고 땅 파고 묻는 것
그 니미 와서 매장꾼드른 케양 고마으 그게 인제 에 읃 장지까지 인제 믄 듬 미 에 영안 느응 그으 병워네서 느어럴 어이 시시너 실꼬 감 그어가따 내라 놈 그 사암드이 그걸 들고 사네 올라 가따 논능 거배끼 안 하드라꼬	그 놈이 와서 매장꾼들은 그냥 그만어 그게 인제 에장지까지 인제뭐 머 뭐 에 영안그 병원에서 널을시신을 싣고 가면 거기에 갖다 내려놓으면 그 사람들이 그것을 들고 산에 올라가서 갖다 놓는 것밖에 안 하더라고
나머지능 그 일 하능 거 저 땅 파고 머 하능포꾸레이 다 해 뿌에요	나머지는 그 일 하는 것 저 땅 파고 뭐 하는 것을 포클레인이 다 해 버려요
그래이 그 열 사래미랑 거느 이 기 기양 거여 머 거 가에 참서캐따그 뿍 뿌  이에용	그러니 그 열 사람이라는 것은 이 그 그냥 거기 뭐 그 가에 참석했다 뿐뿐이에요
잉 거 그르 시기 데드라꼬	이 그 그런 식이 되더라고
또 그러언 도 영 그른 데도 이꼬 또그 어뜬 데는 또 머탄 사람드렁그 그 가차운 쩌 이 친척 친지드리 이걸 쫌 해다공 이히 여어거 쫌 보기 시르이께네 말 삽찌를 쫌미 해 가주오 떼도 좀 더 이피고 마이지 좀 보기 조뜨럭 해다고 꺼 자꾸 요구울 하믄 응 그 사람떠에 인느 쫌 이 긍마지모태해 주긴 해줍띠다	또 그런 또 영 그런 데도 있고 또그 어떤 데는 또 무엇한사람들은 그 그 가까운 저 이 친척 친지들이 이것을 좀 해다오 이 여기가 좀 보기가 싫으니까 말이지 삽질을 좀 해 가지고 떼도 좀 더 입히고 말이지 좀 보기 좋도록 해다오 그 자꾸 요구를 하면그 사람도 이 좀 이 그마지못해 해 주기는 해 주더라고요
그 그른 시기 데드라꼬	어 그 그런 식이 되더라고 예
그 예저네너쁘 점부 여기 동네 사암드리 다 핸는데	그 예전에는 전부 여기동네 사람들이 다 했는데
예예이 점부 동네동네 사너미 해찜먼 그이기 예점뿐 아이지 지금 해방 유기오 사변 점만 해도 점브 동네 사러미 다 해쓰에	예 전부 동네동네 사람이 했지만 그게 예전뿐 아니지 지금 해방 육이오 사변 전만 해도 전부 동네 사람이 다 했어요
므 인 장이사게 이서씀니 꺼디 옌나레	뭐 이 장의사가 있었습니까 어디 옛날에
컴 동네 싸러미 그널 아무 찌엗 장사 지낸다 금 마이지에 그날 곰머 점부이 이럴 점페하고 으 그날 와서 장니에데 다 오싸 행상도 미고 가고 머 읻치 쩨 이 지베 일또으 그 그 집 장삳지베으 거드러 주고 머 그어 그 글때느서로 그게 상호가네읍 믕 그 그게읍 부조레요	전부 동네 사람이 그날 아무개 집에 장사 지낸다 그러면 말이지 그날 그만 전부 일을 전폐하고그날 와서 장례식에 다 와서 행상도 밀고 가고 뭐 이 저 저 이 집에 일또 그 그 집 상갓집을 거들어 주고 뭐 그 그 그때는 서로 그게 상호 간에 뭐 그 그게 부조에요
인 짜 이여 그려 참 그읍 푸마씨래 가이	이 저 이 그래 참 그 품앗이야가히
예르이 옌나렌느으미	옛날 옛날에는
또 내가 상주데믄 저 사러미 와서 해 주고 그런 시기 데그던	또 내가 상주되면 저 사람이 와서 해 주고 그런 식이 되거든
요주우믄 인제 머 주로 그어 장이사어드리 에 은 주도하에 하다 보니까 방금 이야기 그래 해찌머 예정 가트며너 여기서 동네에서 운구하고 행상 그 할려며너 동네에서 상녀 메는 사암드리 꿰 마너찌예	요즘은 인제 뭐 주로 그 장의사들이어 주도하에 하다 보니까 방금 이야기처럼 그래 했지만 예전 같으면은여기에서 동네에서 운구하고 행상 그 하려면은 동네에서 상여 메는 사람들이 꽤 많았지요
보통 한 이심 명은 다 너머이 데니더	보통 한 이십 명은 다 넘어야 됩니다
상일 민다 그멈 마리야	상여를 멘다고 그러면 말이야
소형 상에이가 열려서씨 미이께네아 이팔 쎵이 양짜이 여덜씩 미이께네 고게 저근 상에고요	소형 상여가 열여섯이 메니까 이팔에 십육 양쪽에 여덟씩 메니까 그게 적은 상여고요
보통 이심 명쓱 드가능 건 사심 며이 드가 미능 겜미더	보통 이십 명씩 들어가는 것은 사십 명이 들어가 메는 겁니다
엉 끄언 대영 행사인데 으 그릉 거 이쩌꼬	어 그것은 대형 행상인데 어그런 것 있었고
글땐 마이드 상두구인 더 마내이 데우 그래찌엄	그때는 많이 상두꾼이 더많아야 되고 그랬지요
예저느 그엄며너 주로 이 동네에서누가 장네를 치르게 뎀며너 상두꾼드리 여러 명 오고 그다으메 에어 그 그어 상녀 멜 때 그어버 소리 머기고 어하는 사럼 그런뜬 사암들 다 이서씀미까	예전에 그러면은 주로 이 동네에서 어누가 장례를 지르게 되면은 상두꾼들이 여러 명 오고 그 다음에그 그 상여 멜때 그 소리 먹이고하는 사람 그런 사람들 다 있었습니까
옌나렌 다 이서쩌요	옛날에는 다 있었지요
머 어우 그 아뻬흐에 상에 우에 타가주 마리야 검 머 그 소릴리 요새르 마하 껌 맹이이 거으 참 이 이 이 딴 사운램믿 드름믐 우수운 소린느 허쏘리라그능 거 해쏘리르 그능 그 메이 기얌쌈 마 머어 어엄 머 어이 인제 가머 언제 오나 머 그른 시그로 슬픈 곡짜을 부체 가주 마르아 상주드리 감도이 데드롱 마이야 일러 그른 새소리르 메게 가암상 그래 장사을 지낸 데도 이서찌쫌 마 기형	뭐그 앞에 상여 위에 타 가지고 말이야 그 뭐 그 소리를 요새로말할 것 같으면 말이지 그 참 이 이 이 다른 사람이 들으면 구슬픈 소리는 상엿소리라고 그러는 것 상엿소리라고 그러는 그 먹여 가면서 뭐 뭐뭐인제 가면언제 오나 뭐 그런 식으로 슬픈 곡조를 붙여 가지고 말이야 상주들이 감동이 되도록 말이야 이런 그런 상엿소리를 먹여 가면서 그래 장사를 지내는 데도 있었지 좀뭐 그
으 그거느이 요새러 말하 끔 부유층에서 장사 지낼 때고 머 서민층이요새 므 주로 업씸므 서미이라 그랩띠더마는 머쩌 영세한 사람드런 소영은 은 행상을 미음멘 소형에느 그 타지 모 한덴 소릴 몸 메게요	어그것은 아이 요새로 말할 것 같으면 부유층에서 장사 지낼 때고 뭐 서민층이 요새 뭐 주로없으면 서민이라 그러더라만은 뭐저 영세한 사람들은 소형어 행상을 메면소형에는 그 타지 못 해서 소리를 못 먹여요
몬 메기고 또 그르치 아느음 머 이 지게 지고 간 수도 이꼬 영이 영세한 사람들 마 행상을 몸 미고 저른 고마 사라미 그마 너를 질머 지고 상두군 대여씨 따라가주 고마 기양 매장마 하고 오느 오는 장사도 이꼬 그래 대종이 업쓰에	못 먹이고 또 그렇지 않으면 뭐 이 지게 지고 가는 수도 있고 영 영세한 사람들 뭐 행상을 못 메고 저런 그만 사람이 그만 널을 짊어 지고 상두꾼 대여섯이 따라가서 그만 그냥 매장만 하고 오는 오는 장사도 있고 그래 대중이 없어요
그건 인제 그거 참 은 대영 은 이 에이 이 그어이 이 저걸 메씬다 그넝 그넌 니엄 머어 잉 이 요새에로 말하 꺼 뜸 좀 경제가 종옹오에 확씨리 조은 사  럼들 그른 사럼드리야 하능 게고 고다으메이 중뉴충이 하능 기 인제 열려서세미능 거 소형 행상 고걸 가주우 짜이 지내고 고다으멘 또 영 영세한 민드른은 기양 고마 사라미 지고 가 지내는 수도 이꼬 그래 이그 참 대중여 업써에그으뜨	그것은 인제 그것 참대형이 이 이 그 이 저것을 모신다고 그러는 것은 이 뭐 이 이 요새로 말할 것 같으면 좀 경제가 좀 확실히 좋은 사람들 그런 사람들이야 하는 것이고 그 다음에 중류층이 하는 게 인제 열여섯이 메는 것 소형 행상 그것을 가지고 지 지내고 그 다음에는 또 영 영세한 사람들은그냥 그만 사람이 지고 가서 지내는 수도 있고 그래 이것 참 대중이 없어요 그것도
그 요즘므어므언 주로 그거 병원 영안시레서 하니까주로 음식 까틍 경우도 주로 사서 하어찌예	그 요즘은 주로 그것 병원 영안실에서 하니까주로음식 같은 경우도 주로 사서 하지요
레이 주로 사 쁘에	예 주로 사 버려요
이 끄 거게 인제 병워네서 에 인찌 병원니 느 그 장이 병워네도 장이사기이써용	이 그 거기에 인제 병원에서인제 병원이 이 그 장의 병원에도 장의사가 있어요
영안시리 따루에 장이사 인데 거게서 고마 상언 상주더룬 무루 노음맙 밥그럭 쑤 따제가주 돈 치드라꼬 보이껜 마레	영안실에 따로 장의사가 있는데 거기에서 그만 상 상주들은 물어 놓으면 밥그릇 수를 따져서 돈을 치르더라고 보니까말이지
예를 드러 내가 상주거 데따 그먼 내 지베 어응 그다아 인제으 그 식땅에당 이렐 해 뿌능 게라	예를 들어서 내가 상주가 됐다 그러면 내 집에거기에다가 인제 그 식당에다 의뢰를 해 버리는 거야
내 지베 온는 손니믄 당신네가 바블읍 대즈패 주시요 꼬 마이쩨	내 집에 오는 손님은 당신네가 밥을 대접해 주시요 하고 말이지
그래믄 잉 극 그 그거뚜 처뻐네 보이께네으 그어또 저이 요샌 자꾸 발따리데어거 사라미 그업 크른데 그 머리 조은 사람드리 그 그 머리 조응 걸 응 그조은 데 써멈 조은데그 나쁜 데 써멍 사럼드리 만트라꼬요	그러면 이 그그 그것도 처음에 보니까 그것도 저 요새는 자꾸 발달이 돼서 사람이 그 그런데 그머리 좋은 사람들이 그 그 머리 좋은 것을그 좋은 데 써먹으면 좋은데그나쁜 데 써먹는 사람들이 많더라고요
그려 장녀지베 장사 지낸 사러미 내가 상주거 데 가주언 내 지베 문상 오은 사람머 시꿔늘 조가즈 밤 무러 가라 소린느 모 탄다꼬 그 차마이 양시미 그게 마리찌	그래 상갓집에 장사 지내는 사람이 내가 상주가 돼 가지고 내 집에 문상 온 사람을 식권을 줘서 밥을 먹으러 가라는 소리는 못 한다고 그 차마 양심이 그게 말이지
그른데윽 그거또 자꾸 쏘기이께네 마리아	그런데 그것도 자꾸 속이니까 말이야
상주가 으어 그 익 계사늘 이래 해 보이껟 처이 처 보이께느 오늘 상 으음문상개기 한 시물 래지 시물 은 서넏 덴다 하은서 생가글 핸데 저짜두 청구동 엄 머 사심 명 머 사십오 명 이래 시 시꾸늘 참 저 요구걷 두오구 하이께네 요새늠 보이께네 시꿔늘 주드라꼬요	상주가그 이 계산을 이래 해 보니  까 쳐 쳐 보니까 오늘 상문상객이 한 스물 내지 스물서넛 된다 하면서생각을 했는데 저쪽에서 청구 들어온 것은 뭐 사십 명 뭐 사십오 명 이래 식 식권을 참 저 요구가 들어오고 하니까 요새는 보니까 식권을 주더라고요
그르이께느 느어 은 내가 그른 소릴 해써읻	그러니까어 내가 그런 소리를 했어요
대구에 하믄 상은 내 거 이 찌이 진는 참 친처긴데 가따 그 이 시꿘 주이야 이 사람 잉 그 밥 항 그릉 누가 에이여으 그금 머어이 시꿘 주 너이 그어이이게이 응 현서파다 이 시껀 치아러 그 머 백 끄륵 쏘길리겐나 내 그르게 너어가 모 싸멈 몰래어 그이 즏 차아라 응으 그른 소리또 해따코	대구에 한 번 상을 내 그 이 저 저 참 친척인데 갔다가 그 이 식권을 주기에 야 이 사람 이 그밥 한 그릇 누가그것 뭐 식권 줘 놓으니 그 이게섭섭하다 이 식권 치워라그 뭐 백 그릇 속이겠나 내 그렇게 너희가 못 살면 몰라 그 저 치워라그런 소리도 했다고
그른 녜도 이 이뜨라쿠요	그런 예도 있 있더라고요
그래 이 그 그게 현사파드라꼬이	그래 이 그 그게 섭섭하더라고
그기 어뜨에 보며너 쫌 예전네 인심마하고 요즘 인시미 또으 그르케읍 바끼능 가씀미	그게 어떻게 보면은 좀 예전의 인심하고 요즘 인심이 또 그렇게 바꼈는것 같습니다
그얼 바께떼 빠께뜨라 그게	그 바꼈데 바꼈더라 그게
또 어르신 그얼며너 예즈 예저네는 지베서 인제 장네 치를 때너 주로 어떤음식 장만합미까	또 어르신 그러면은 예전 예전에는 집에서 인제 장례 치를 때는주로 어떤 음식을 장만합니까
음시기 장녀라 그닝 게 요새러 말하 꺼 뜨먼 장녀읻 참 장 맹 삼실과가다 드가고 밤 감 대추 머얻그 어뜨 매 땅콩도 쓰고 머 추자두 쓰고 그르고 또 그 밤메얼 머 수 머 요샌 머 수박또 씁띠다 보이께르	음식이 장례라그러는 게 요새로 말할 것 같으면 장례 참 저 역시 삼실과가 다 들어가고 밤 감대추 뭐그 어떤 역시 땅콩도 쓰고 뭐 추자도 쓰고 그리고 또 그 반면에 뭐 수뭐 요새는 뭐 수박도 쓰더라고요 보니까
수박 차메도 머 채리 노씁띠다	수박 참외도 뭐 차려 놓더라고요
그래고 그 밤며 인제 펴니고 떠기라 그릉 거 인제 편떡	그리고 그 반면인제 편이고 떡이라 그러는 것은 인제 편
떠기래 그이고	떡이라 그러고
떠기고	떡이고
그려 사어무리고	그리고 사어물이고
어무리고 더 위 인제 어무리 인제 그게 인제 매아 소고기 데지고기인제으 게이끄러 달꼬기 으 그 세 가지는 반다싣 드가능 게고	어물이고 그 이인제 어물이 인제 그게 인제 뭐 소고기 돼지고기인제 그 닭고기그 세 가지는 반드시 들어가는 것이고
고다으멘 또 인제영 어물로는 조기가 드가고 고다으메옥 고등어가 드가고요거배끼 안 씁띠다	그 다음에는 또 인제 어물로는 조기가 들어가고 그 다음에는고등어가 들어가고 요것밖에 안 쓰더라고요
그애쓰 주로 인저그 제사 장네 치르 때 제사에 쓰느 엄식뜨리따 그지예	그래서 주로 인제그 제사 장례 치를 때 제사에 쓰는 음식들이다 그렇지요
그으 맹 비스탑떼드이	예 그 역시 비슷하더라고요
제사에 지내능 게너 장녀이 지내잉 게나 장녀 지낸 데도 맹 제사가엥 예이끄더	제사에 지내는 것이나 장례에 지내는 것이나 장례 지내는 데도 역시 제사가 있 있거든
그음 머 송거 은제 바린쩨가 이꼬 머 성복쩨가 이꼬 머 반혼제가 이꼬글때는 제사 지낸 음시꽈 또까치 해이 데능 게래	그 뭐 성그 인제 발인제가 있고 뭐 성복제가 있고 뭐 반혼제가 있고 그때는 제사 지내는 음식과 똑같이 해야 되는 거야
인제 그 탈상을 하고 나며 인제 제사를 안 지냄미까 그지예	이제 그 탈상을 하고 나면 인제 제사를 안 지냅니까 그렇지요
에그 제사느 어떤 종 어떤 제사가 이씀미까	어그 제사는 어떤종류 어떤 제사가 있습니까
크게 인제 읻 제사걷 조꿈 저네 얘기항 게 탈상얼 하기 뎀 인제 에어잉 기제사가 이쩨 머여	그게 인제 이 제사가 조금 전에 얘기한 게 탈상을 하게되면 인제어기제사가 있지 뭐요
기제사가 이꼬 케이제사라 그능 거느 주근 날짜에세게에이 지내고 차사라그능 거넌 파럴 추석 서레 도 그엄 밈 명저레 지내응 게 차사가 이꼬 그래치 머이	기제사가 있고 기제사라 그러는 것은 죽은 날짜에 지내고 차사라 그러는것은 팔월 추석 설에 또 그 명 명절에 지내는 게 차사가 있고 그렇지 뭐요
기제사 차사 지 지내자네 거으 성보글 참 저으탈쌍을 하기 데먼	기제사 차사 지 지내잖아 그 성복을 참 저탈상을 하게 되면
처째 인제 이 기제사는 망니느 주근 날짜 제사을 기제사라 그고 구어 그 인제 차싸르 근 거능 명절 삼 명절 추석 설 또 그래고 머로 와이굼 머 중기라 그나 머 으 그른 혹 염 명절 삼 명저레 쳐나능 걸 차사르 그르니다	첫째인제 이 기제사는 망인의 죽은 날짜 제사를 기제사라 그러고 그 그 인제 차사라 그러는 것은 명절 세 명절 추석 설 또 그리고 뭐냐 아이고 뭐 중기라 그러나 뭐어 그런 혹 이 명절 세 명절에 지내는 것을 차사라 그럽니다
차사 제사가 이꼬 기제서가 이꼬 그러	차사가 있고 기제사가 있고 그래
그엄며 주로 인제 그거 아까 이야기를 하셔씀다마너 그 기제사 이꼬 그다으메 차사 이꼬 쩌그다으메 혹씨 그거 가을거지하고 난 다으메시사도함미까 모심미	그러면 주로 인제 그것 아까 이야기를 하셨습니다만은 그 기제사있고 그 다음에 차사 있고 저그 다음에 혹시 그것 가을걷이하고 난 다음에 어시사도 합니까 모십니까
시사라 그응 게 그얻 쩌욛뚣 추자리라 그래가주 이 시월따레 인제 응애해꼬글 장만해쓰이께네 그 싱어 으이 자기 이 쁭이에 참 선조으껩 바친다 카는뜨스로 시사라 그능 게	예 시사라 그러는 게 그 저 추절이라 그래서 이 시월에인제햇곡을 장만했으니 그이 자기 이 뭐 참 선조에게 바친다고 하는 뜻으로 시사라 그러는 게
그게 인제 시사라 그능 게 잘 지낼러 거무 항정 어꼬요 잘 찌낼르 그므이옌나렌 재궁이 이써짠니껴	그게 인제 시사라 그러는 게 잘 지내려고 그러면 한정없고요 잘 지내려고 그러면 옛날에는 재궁이 있었잖아요
위토를 마이 사가주 잘사는 지베넌 내 어르늘 위해가주 노늘 머 열 마지이시무 마지이 바또 심 마지 사 가주고 그래 으 끄 거게 한 지블 사드록 해 조요	위토를 많이 사 가지고 잘사는 집에서는 내 어른을 위해서 논을 뭐 열 마지기스무 마지기 밭도 스무 마지기 사 가지고 그래그 거기에 한 집을 살도록 해줘요
으으 그게 인제어읻 재공이라 그래니더	어 그게 이제어 재궁이라그럽니다
그래믕 그 그 사럼드리 그 토지일 부쳐 머꼳 자기 머꼬 사고 쪼끔 나믕걸 인제 쥐이난테 주먼 주이는 그걸 까주고 은제 에 그어 제무를 장만해요	그러면 그 그 사람들이 그 토지를 붙여 먹고 자기 먹고 살고 조금 남은 것을 인제주인한테 주면 주인은 그것을 가지고 인제 에 그 제물을 장만해요
그 사름한떼 도느 싸리 으스 요새 쌀루 쩌 쌀 머 다서 깜마이 깝쓰오 바다씸머 다 주든지 그르치 아늠 머 세 가맘메 조 가주으 요걸 가주고 내 아부지 내 할배 내 얼매 이래 사 미이 고 인 지 잉 기 묘 한 니이를 그 은 함 붕지를 가저 한 위라 그래인니데 여	그 사람한테 돈을 쌀이 요새 요새 쌀로 저쌀 뭐 다섯 가마니를 값으로 받았으면 다 주든지 그렇지 않으면 뭐 세 가마니만 줘가지고 요것을 가지고 내 아버지 내 할아버지 내 어머니 이래 삼 위 그 이 저이 그 묘 한 위를 그한 묘지를 가지고 한 위라 그랬습니다 여기
우리가 이 이그 여섣 위이께넹 여섣 상부 제사을 지내드루 장보기해가주 제사을 지내라 에 지내드로 해다고 그램 그 인제 재궁지기는 그 읻 쥐인하꼬 가가주으 장보길 해요	우리가 이 이것 여섯 위이니까 여섯 조상 제사를 지내도록장보기해 가지고 제사를 지내라지내도록 해다오 그러면 그 인제 재궁지기는 그이 주인하고 가 가지고 장보기를 해요
니연 제사 지내까 머 어물 머 이릉 거 첨부 거 나물 채소 다 사고 머 제주도 사고 해가주 와 가주고 온늘을 내앨 거틈 오늘 저 점부 끄어 즈 제무를 장만해 가주고 내애를 으 그으 즈끄 궤에 나따 설건 내일 은제 은 흥 그 이 산소에 느이즈싣 지고 올라 가니드 그 음시거	이런 제사 지내니까 뭐 어물 뭐 이런 것 전부 그 나물 채소 다 사고 뭐 제주도 사고 해 가지고 와 가지고 오늘 내일같으면 오늘 저 전부 그 저 제물을 장만해 가지고 내일그 저 돼 놓았다가 내일인제어 그 이 산소에지고 올라 갑니다 그 음식을
거이뜨 재궁에 이떤 사럼드리 너이먼 너이 다서저읻 지고 가치 가먼 즈쩨그 집 쥐인 제간드런 따러가서 채여크 채리 가주고 거 은제 저럴 인제 이 배하고 거 인저 산소 다니 내려오지요 야	거기 재궁에 있던 사람들이 넷이면 넷다섯이 지고 같이 가면 인제 그 집 주인 제관들은 따라가서 차려 차려 가지고 그인제 절을 인제 이 배 하고 그 인제 산소 다녀 내령오지요 예
그거 인제 시사라 그르인드 그그 인제	그것 인제 시사라 그럽니다 그것을 인제
그러명 기제사는 보통 어떠게 지 지냄미까 여기서느	그러면 기제사는 보통 어떻게 지 지냅니까 여기서는
함무 절차에 대해서 함머 이야기해 주입쑈	한번 절차에 대해서 한번 이야기해 주십시오
익 키 기제사는 내가 인제 어르니든 조부듬 맹 또까튼데 그날 기제산나른 에 그 인제 으 감시리이리아 그는 지비 인제 이 인는 지베는 심주로 감시레 모시 나시이께네 그어서 모시 와가처 노우먼 데고 거 감시립 엄는 지베넌	어 이 기 기제사는 내가 인제 어른이든 조부든 역시 똑 같은데 그날 기제삿날은 에 그 인제감실이라고 그러는 집이 인제 이 있는 집에는 신주를 감실에모셔 놓으니까 거기에서 모셔 와 가지고 놓으면 되고 그 감실이 없는 집에는
그래 가주웁 감시레서 메시 와 가주설렁 우후예 상 위에 노코 그래삼멍 각 실과에더 삼실과 사 두에우 그으 웯 이 참 미 아까엗 시야 지내는 시그로 그어 머엄 어육 끄이 우육 점부 다 서거이 게육 다 써 가주고 달 달 달꼬기 소고이 데지고기 점부 그래 그 온늘 쓰고 명태 끄엄 머 그름 포 이릉 걷어이 종압패 쓰고 어무른 반다시 그 은제 고등어 조긴 드가이 데고 흐리고믁 그걸 채리 노코 인제 제사 지낸 집또 요 이꼬 또 그르치 모탄 지베능 감시리 엄는 지베는 어허어 그 인제 이 찌 지바이라꼬 쓰니더	그래 가지고 감실에서 모셔 와 가지고설랑 위에 상 위에 놓고 그래삼 뭐 각 실과에다 삼실과상 위에다 그 왜 이 참 뭐 아까 식 지내는 식으로 그 뭐 어육 그 우육 전부 다써서 계육 다 써 가지고 닭 닭 닭고기 소고기 돼지고기 전부 그래 그 오늘 쓰고 명태 그 뭐 그런 포 이런 것종합해 쓰고 어물은 반드시 그 인제 고등어조기는 들어가야 되고 그리고 뭐 그것을 차려 놓고 인제 제사 지낸 집도 있 있고또 그렇지 못한 집에는 감실이 없는 집에는그 인제 이 지 지방이라고 씁니다
지방을 인제 예를 드러 꺼떰 아부지 이 이 기제사 거트먼 머 형고처사부군시니라꾸도 쓰고 또 이 형고처사 므 학쌩부구니얄 써 고 두 가지이 씁띠다	지방을인제 예를 들 것 같으면 아버지 이 이 기제사 같으면 뭐 현고처사부군신위라고도 쓰고 또 이 현고처사 뭐 학생부군이라고 쓰고 그 두 가지를 쓰더라고요
처사로 쓴 사암도 이꼬 학쌩으로 쓴 사암도 이꼬요	처사로 쓰는 사람도 있고 학생으로 는 사람도 있고요
허르꼬 또 인제 모치닐 겨인쩨 인저 혐비유인 머 으게 아갸 예를 드르 므하르 꺼뜸 므어 기 김녕 김씨 그뗑 김녕김씨시니이이라꼬 여이 이래 쓰능 거또 이꼬 구래 인지 지 지방을 써 노꼬 은제 제사럴 치넨데 제사 지내은 데넘 반다시 그어 오 집사가 데야 데는데 머 우 그 지바니 망코 짇 자소니 너끄어겅 넝너칸 사럼드럼미 친처기 마은 사라멈 오 집사 너엄 사암드 마으뎌 보통 어능한 지벤 오 집살 몸 마차요	그렇고 또 인제 모친일 경우에 인제 현비유인 뭐 어어 예를 들어 말할 것 같으면 뭐 김 김영 김씨 같으면 김영김씨신위라고 이 이래쓰는 것도 있고 그래 이제 지 지방을 써 놓고 인제 제사를 지내는데 제사 지내는데는 반드시 그 오 집사가 돼야 되는데 뭐그 집안이 많고 자 자손이 넉넉 넉넉한 사람들은 친척이 많은 사람은 오 집사 넘는 사람도 많은데 보통 어지간한 집에는 오 집사를 못 맞춰요
긍구 웨냐 다서씨가 오 집사라 그거드요	그그 왜냐 다섯을 오 집사라 그러거든요
그 은제 으 은젇 초혼 아헌 종허니 인제 에 삼허니고요 고 은제 상주거  세 부이람 말 세 븐 세 번 수를 이런담 마리고 고 은제 오 집싸렁 어이 양 가에 집싸가 두리 부터 가지움 그 인젣 자늘 올릴 찌게 부어 바다그멍 그 바다으그 언제 이 시니에 가따 논능 걸 집사라 그러요	그 인제인제 초헌 아헌 종헌이 인제삼헌이고요 그 인제 상주가 세 번이라는 말 세 번 세 번 술을 이런다는 말이고 그 인제 오 집사란 게 양 가에 집사가 둘이 붙어 가지고 그 인제 잔을올릴 적에 부어 받다 그 받아 그 인제 이 신위에 갖다 놓는 것을 집사라 그래요
고래가주 구언데 삼헌하꼬 집사 둘하꼬 해 가주으 오 집사라 그러요	그래가지고 그러넫 삼헌하고 집사 둘하고 해 가지고 오 집사라 그래요
그어 다서시 데야 제사 지내능 기 시기 만는데 옌나렌 요샌 머으 그 그게대중도 업씨엄 머 아무이따나 머 어에웅 구마 두리도 지내오 혼자도 고마읻 지내고구마 그래 지냅띠다으	그 다섯이 돼야 제사 지내는 게 식이 맞는데 옛날에는 요새는 뭐 그 그게 대중도 없이 뭐 아무렇게나 뭐 어떻게 그만 둘이서도 지내고 혼자서도 그만 지내고그만 그래 지내더라고요
지낸 데는 그 끄으 그게 대조이 업써 그게	지내는 데는 그 그 그게 대중이 없어 그게
그엄며늗 그 제사 인젣 그어 제상을 마련해섣 차리 노코 어어 시니를 모시든지 앙 그염며너 즈그 지방을 쓰서 그다음 떠 인자 모셔 노코어엉 그럼며너 제사느 어떤 시그로 모심미까	그러면은 그 제사 이제 그 제상을 마련해서 차려 놓고신위를 모시든지 안 그러면은 저것 지방을 써서 그다음 또 이제 모셔놓고어 그러면은 제사는 어떤 식으로 모십니까
지방 쓰고	지방을 쓰고
그케 읻	그러게 이
처음	처음
제사을 모시능 게 인제인 처뻐네 처째가 인제 제사을 모실 땐늠 반 우에따덜 시니를 모셔 노코 그르암미 지방얼 부처 노코 고다으메 인제 제무를 가따아안 논능 게르 채리능 게러	제사를 모시는 게 인제이 처음에 첫째가 인제 제사를 모실 때는 반 위에다가 신위를 모셔 놓고 그 다음에 지방을 붙여 놓고 그다음에 인제 제물을 갖다 놓는 거야 차리는 거야
엄 머홍동백썬니 장더 머 에래우 머 중보 머 그 포럴 머 어이어데저딴 데늠 머 그어 끄에 그 끄그 머로 어에에 문중에 따러서 그게어 이 입 버비 틀렌 데가 이따꼬용	어 뭐홍동백서니 참 뭐 이러고 뭐 중포 뭐 그 포를 뭐어 어디 저다른 데는 뭐 그 그 그 그그 뭐냐 어문중에 따라서 그게이 이 법이 다른 데가 있다고요
그 가가예무니라꼬요 저 에 이 영천 저리 감맘미 중포 쓰는 데독 이따 그럽띠은 나안 안주거 참서근 안 해 반데 중포러 그능 거는 우리 여기선너 보통으론 포럴 을 어이 으 저 좌츠게 이을 이 제엘 끄테 이 이랩 포를 쓰은데 저리는 즈 끄 제쌍 중가네 포를 론다 그 그걸 중포라 그래찌엔데 그래 지낸 데두 이꼬	그 가가예문이라고요 저이 영천 저리 가면 중포 쓰는 데도 있다 그러던데 나는 아직까지 참석은 안 해 봤는데 중포라 그러는 것은 우리 여기서는 보통으로는 포를어저 좌측에 이 이 제일 끝에 이 이래 포를 쓰는데 저리는 저그 제상 중간에 포를 놓는다 그 그것을 중포라 그러는데 그래 지내는 데도 있고
크래 노코 인제 처뻐 네 인제 그래 쯔 제무리 다 진서리 데먼 제과니 인제 초헝과니 처 뻔 잔 데능 거즈 초호니라 그랭이드 웨	그래 놓고 인제 첫 번째인제 그래 저 제물이 다 진설이 되면 제관이 인제 초헌관이 첫 번째 잔 올리는 것을 초헌이라 그럽니다 왜
그 예를 뜨러 마알 까뜸 장자지	그 예를 들어 말할 것 같으면 장자지
장자라 근 사러미 초호니 초호니 그 시니에 고 에 강시니르 그릉이드 그거너	장자라 그러는 사람이 초헌이 초헌이 그 신위에 그 왜 강신이라 그럽니다 그것은
강시니러 그능 걸 시니에 고한단 뜨스로 저럴 하고 향을 피움미다	강신이라 그러는 것을 신위에 고한다는 뜻으로 절을 하고 향을 피웁니다
그게 인제 이 그 강시니르 근데 시널 예를 뜨르 아부짐 아부지이 이 제사이레예 제거 오늘 모심니다 하는 뜨스래 그게	그게 인제 이 그 강신이라 그러는데 신을 예를 들어 아버지면 아버지 이 제사 의례에 제가 오늘 모십니다 하는뜻이야 그게
까 강신네릉향을 피우고 저 쩐제 에 저를 하고 그으 에 크르 노음고다으 민제 각 제관드리 인제 그윽 끄 까암 에 처허니 강시널 하엄면 저를재배을 두 번 하니더	강 강신례라는 것 향을 피우고 저 저절을 하고 그어 그래 놓으면 그 다음에 인제 각 제관들이 인제 그 그 그초헌이 강신을 하면 절을 재배를 두 번 합니다
그으 그 각짜 은제 이 시뉘에 고하는 잉 이 이 인사지 그게	그 그 각자인제 이 신위에 고하는 이 이 이 인사지 그게
내가 어에 이 이 참 아부지 으어 이 기제사에 즈 참서카러 와씀미다 카능그게 이 인사를 저를 하먼 그려구 나아미 인제 고다으메는 그 인제 저 자늘올려 그르지 쯔 초호니란 즈 초허네르 근 사래미 인즈 수 수 술짜늘 은제어 브어 가주고 집사한테 주먼 아부지 잔 노코 또 이짜 좌측 집사는 모친 즙사노꼬 이른 수를 바드 노코 인제 흐레먼 에 인제 그래 초허니 그래 자늘을 올리기 데먼 그 추기랑 게 이써요	내가이 이 참 아버지이 기제사에 저참석하러 왔습니다 하는 그게 이 인사를 절을 하면 그러고 나면 인제 그 다음에는그 인제 저 잔을 올려 그래 저 초헌이란 저 초헌이라 그러는 사람이 인제 수 수술잔을 인제부어 가지고 집사한테 주면 아버지 잔 놓고 또 이쪽 좌측 집사는모친 술잔을 놓고 이런 술을 받아 놓고 인제 그러면인제 그래 초헌이 그래 잔을 올리게 되면 그 축이라는 게 있어요
추기라 그능 거넌 머 그날 도라가신 데드 애트탄 뜨스로 머 이 이래 표하는추기 인데 그게 엄는 지비이 찌 주로 마네용	축이라 그러는 것은 뭐 그날 돌아가신 데에 애틋한 뜻으로 뭐 이 이래 표하는 축이 있는데 그게 없는 집이 저 주로 많아요
그검 머 추걸 그 그 이 옌나렌 축 쓰는 집또 마네찌만 요즘믕 글때도 단추글 한 사러미 어아유 구맏 단자네 때 금 무 축 업씨무처구러 한느 사아미마네써	그것 뭐 축을 그 그 이 옛날에는 축 쓰는 집도 많았지만 요즘은 그때도단축을 하는 사람이그만 단잔일 때는 그 뭐 축 없이무축으로 하는 사람이많았어
끄은 지 요새는 으응 그 주로 무추기지 머여	그 저 요새는그 주로 무축이지 뭐요
그래 고마세어 스 세 부니 처 뻔 초온 두 번짼 아어니 잔 올리고 고듬매 종오니 잔 얼리고	그래 그만세 세 세 분이 첫 번째 초헌 두 번째는아헌이 잔 올리고 그 다음에 종헌이 잔 올리고
그른데 고 인지아 항 가지가 또 쪼꼼 묘심당 기아 에 아허니 술짜늘 올릴찌게 수 술짜음 올리 노으먼 그읃 지 자늘 읃 퉤자늘 쓰게지 앙코 종허니 뜨옹 올릴 땐 즈 찌 종허는 자늘 그 밥뚜껑에다 수럴 부어 가즈 첨자니라꾸 세번씩 개요	그런데 그 인제 한 가지가 또 조금 묘한 게아헌이 술잔을 올릴 적에 술 술잔을 올려 놓으면 잔을퇴잔을 시키지 않고 종헌이 또 올릴 때는 저저 종헌은 잔을 그 밥뚜껑에다 술을 부어 가지고 첨잔이라고 세 번씩 해요
종어네	종헌에
제일 끄테 세 번째 찌 잔 올린 사럼머 인제 요래 바다가주 양 애분애은떼 쪼꿈 세 번쓰익 첨자는 해여	제일 끝에 세 번째 저 잔을 올리는 사람은 인제 요래받아 가지고 양 어른한테 조금 세 번씩 첨잔을 해요
참 머 고골 인제 에 참 첨자이라 그러구	참 뭐 그것을 인제참 첨잔이라 그러고
그래먼 인제 종허니 에 이 재배을 하고 마을까 치먼 고다으멘 인젭 으음밥수까라글은제 이 메라 그래니더 그어 바블 해 농 거	그러면 인제 종헌이어 이 재배를 하고 마쳤다 치면 그 다음에는 인제밥숟가락을인제 이 메라그럽니다 그 밥을 해 놓은 것
거일 뚜껑을 여으고 어어으 그 우에 인제 수 수까라글 은제 꼬바 논니더 그래 인지 즈 무레 적쎼 갇	거기를 뚜껑을 열고그 위에 인제 숟 숟가락을 인제 꽂아 놓습니다 그래 인제 저 물에 적셔 가지고
그러겨 또 인제 쫑앙내이 즈 삽씨 데먼 삽시정저이라 그는데 근 메 저 이이으 근 에롬 마리고요 그래 삽시라 그능 여 수까락 꼬바 노코 인제 그려 무레 또 고 세 번 푸러 가주어 지 재차 노우먼 고게 인제 삽시정저이라 근데 그래고 나먼 그 웨 인 뚜 고다으메 읻 종오니 인제 잔 올리구어 종헌니 잉 잉 헌달 하기 데믄 고다으메늠 각 제관드려이 저럴 또 두 번 하네다	그러고 또 인제저 저 삽시 되면 삽시정저라 그러는데 그 뭐 저 이 이 그것은 어려운 말이고요그래 삽시라 그러는 것은 숟가락 꽂아 놓고 인제 그래 물에 또 그 세 번 풀어 가지고저 재차 놓으면 그게 인제 삽시정저라 그러는데 그러고 나면 그 왜 이 또 그 다음에 이 종헌이 인제 잔 올리고 종헌이 이 이 헌다를 하게 되면 그 다음에는 각 제관들이 절을 또 두 번 합니다
어녕 인지 작뼐제으저	어 이제 작별제이지
이 작뼐제제 태기지여	이 작별제인 셈이지요
으 잘 가시요 하능 걷 씨그로 저럴 두 번 하먼 제사 은지 철싸이러 근느제사 다 지내따고 그래먼 그날 기제산 다 지냉 기래	어 잘 가세요 하는 그 식으로 절을 두 번 하면 제사 인제 철상이라 그러는 제사 다 지냈다고 그러면 그날기제사는 다 지낸 거야
그담 그어기 어얻 제사어 철상하고 나면 엄보글 함미까	그러면 거기 제사 철상하고 나면 음복을 합니까
예 어은	예예
음복수주라꼬예 음보글 하니더	음복수주라고요 음복을 합니다
음보걸 제관드리 방에 모예 안지미 인제 그 아네서는 은 나 아음 메 인제그 제사에 서떤 제무를 점부 인제 풀고 이래 에임 머 업 마아 가주구 인제 쓰쓷 또 담고 하야 해 가주고 그래음보글 하니더	음복을 제관들이 방에 모여 앉으면 인제 그 안에서는어뭐 인제 그 제사에 썼던 제물을 전부 인제풀고 이래뭐모아 가지고 인제 저 또 담고 해 해 가지고 그래음복을합니다
방에 와가주 인제 에 상그 은제 이 제관들끼리 일가 친척 또 머 그날참서캐떰 분들 모동 안자 가주우 음보글 하우 하고 인제 그으 바블 멍너밥또 멍니더 그엉	방에 와 가지고 인제상그 인제 이 제관들끼리 일가친척 또 뭐 그날 참석했던 분들 모두 앉아 가지고 음복을 하고 하고 인제 그 어어 밥을 먹 밥도 먹습니다 그
밥또 인제 메 제사을 지나쓰이께네 밥 쁘 인제 이그 그글 은제 제사빠비라 그랭이다	밥도 인제 메 제사를 지냈으니까 밥 인제 이 그것을 인제 제삿밥이라 그럽니다
제사빠비 여언 안동에 가먼 허쩨사바비라구 파니더	제삿밥이 여기 안동에가면 헛제사밥이라고 팝니다
그기 마시 이써요 그이 머어 보옴뇨	그게 맛이 있어요 그게 먹어 보면요
그래가주 구 머 제사빰 머그러 간다 그고 모도 크으랜니더 웨	그래서 그뭐 제삿밥 먹으러 간다 그러고 모두 그랬습니다 왜
으 그르꼬이 인제으 술로 음보글 하고	어 그렇고 인제 술로 음복을 하고
그 인제 이 그 수럴 몸 머엉 사럼더 글때능 그응 음복 쑤른 쪼꿈식 핸니더웨	그 인제 이 술을 못 먹는 사람도 그때는 그 음복 술은 조금씩 했습니다 왜
웨 그른나 하고 잉 그 귀가 발가진다 그래 가주고	왜 그러냐 하면 이 그귀가 밝아진다 그래 가지고
그래 가즈어 음복 수런 몸 멍 수리라도마 찝 찌 쪼끔심 모두 다 머건니더 웨요	그래 가지고 음복 술은 못 먹는 술이라도뭐 조 조 조금씩 모두다 먹었어요 왜요
그다으미 그 혹씨 인제쓰 문중이나 동네마다 또 다 다른데 지베 지영마다 쪼옴씩 다르고	그 다음에 그 혹시 인제저 문중이나 동네마다 또 다 다른데 집에 지역마다 조금씩 다르고
예 예에 그 가가예무이락 거이 달라요	예예 그 가가예문이라고 거의 달라요
또까찐 아느	똑같진 않아
이 지역에스너 혹시 어르신 그거 제사상에 올리지 아는 올리집 올리면 안데는 그런 머 엄식뜰 까틍 거 이씀미까	이 지역에서는 혹시 어르신 그것 제사상에 올리는 않는 올리지 올리면 안 되는 그런 뭐 음식들 같은 게 있습니까
이찌에요	있지요
어뜽 게 쪼곰	어떤 게 조금
그으 공치 거틍 거 치 짜 드능 거늠 모 당에	그 꽁치 같은 것 치 자 들어가는 것은 못 해요
칼치 공치 이 이거늠 모 돌린니더	갈치 꽁치 이 이것은 못 올립니다
그다으메 혹씨 그으 먿떡 까틍 거또떡께늠 머 모 돌링 그렁 건 업쓰미꺼	그 다음에 혹시 그 뭐떡 같은 것도떡에는 뭐 못 올리는 그런 것은 없습니까
어물만 그러씀미까	어물만 그렇습니까
떠근 거이 떵에음 머어 굳 떠근능이응 고 공시기께느	예 떡은거의 떡 뭐 그 떡은응 공 공식이니까
그엄 머 쩜 므 찰떡 펴음 머 인절 므어 참 머 먿 펴엉 거 시루떡 송편이 떠건 거이 다 써요	그 뭐 저 뭐 찰떡 편 뭐 인절미 뭐 참 뭐 뭐 편 그 시루떡 송편 이 떡은 거의 다 써요
으언 므어 올리능 게으 워으 어으꼬 그 인제 에 치 짜 등 거느 인자 칼치 공치 이이거는 제사에 안 쓰따 그랩띠다	이것은 뭐 올리는 게없고 그 인제치 자 들어가는 것은 인제 갈치 꽁치 이것은 제사에 안 썼다고 그러던데요
여김 머 여어 여기는 똠 머 해삼물 중에서 빠져서느 안 데능 거넌 조기하고 고등언느	여기 뭐 여기 여기는 또 뭐 해산물 중에서 빠져서는 안 되는 것은조기하고 고등어는  예아 반다시 써에 데고 그언뇨반드시 써야 되고 그것은요
머 다릉 거늠 머	뭐 다른 것은 뭐
이 쩌 엠 명태하꽁	이 저명태하고
명태포우 그그늠 반다시 써이 데고요	명태포 그것은 반드시 써야 되고요
기 웨에늠 머 실과도 그래요 요샘 머 쉴가 므어탄 잔 지베 감 마구 마이올리 론데 옌나련 삼실과라 그르써요	그 외에는 뭐 실과도 그래요 요새는 뭐실과 무엇한 집 집에 가면 마구 많이 올려 놓는데 옛날에는 삼실과라 그랬어요
감 밤 대추	감 밤 대추
구어 삼실과라 그그덩	그것을 삼실과라 그러거든
요새 또 구으게으인제배 배 사과가 또 드가여 이시	요새 또 그게이제배 배 사과가 또 들어가요 이
조율이시라꼬 언제 그 그걸 인제 쓰고 그런데 고 기 웨에늠 머 써도 데거안 써드 데여 그금 머	조율이시라고 인제 그 그것을 인제 쓰고 그러는데 그 그외에는 뭐 써도 되고 안 써도 돼요 그것은 뭐
그다여 혹씨 제사 지낸능 게 예전하고 어르신 예저네 절머쓸 때하고 요즘므 제사 지내는 풍습 제사 풍습또 쫌 바껴씀미까 어떠쓰미까	그 다음에 혹시제사 지내는 게 예전하고 어르신 예전에 젊었을 때하고 요즘 제사 지내는 풍습 제사 풍습도 좀 바꼈습니까 어떻습니까
아이 마이 달려저쩨용	아이 많이 달라졌지요
마이 달릉 거 아이래 머 거이 머 이 천지개벼칸 셈이지 머에	많이 달라진게 아니라 뭐 거의 뭐 이 천지개벽한 셈이지 뭐요
옌나레는 기제산나리 다옴 어른 제사거 데뜨 조부 제사거 다오먼 참 정보글 하니드	옛날에는 기제사날이 다가오면 어른 제사가 됐든 조부 제사가 다가오  면 참 정복을 합니다
정보기라응 게 에에 함보글 이꼬 둘매이를 이꼬 그 우에 도포를 이꼬오어어 가설 쓰고 크래가주 인제 이 정 으응 정자참 정보글 하 하 하고설랑 그 저 으저 시니 아페 가서 지 저를 한데 요새는 이히 이븐 데르 항 그	정복이라는 게한복을 입고 두루마기를 입고 그 위에 도포를 입고갓을 쓰고 그래서 인제 이 정 응 정장참 정복을 하 하 하고설랑 그 저 저 신위 앞에 가서 절 절을 하는데 요새는 입 입은 대로 하는 거야
그게 인제 카나이 영 천지개벼기 데 쁘레꼬요	그게 이제 하나의 영 천지개벽이 돼 버렸고요
끄래 요새드 인제 그 저어 불처니 거튼 데 지낸 데늠 머 아주 제사 앋 제제과니 마이 모에고 그음 문중 제사 거튼 데는 그 이그 다 이 이꼬 지내지마는 기제사 거튼 데은 고에 추어로 고마 으 그르이 민는다 그게게찌 속따메말하멀	그래 요새도 인제 그 저 불천위 같은 데 지내는 데는 뭐 아주 제사제제관이 많이 모이고 그 문중 제사 같은 데는 그 이것 다 이 입고 지내지만은 기제사 같은 데는 그 주로 그만그러니 믿는다 그것이겠지 속담으로 말하면
아이 머 아부지한떼 머 므어 으으응 안 이붐 어떨라우 그래짜일러 그 그른 시기 데 잔나 하는 세기 데에 그	아이 뭐 아버지한테 뭐 뭐 응 안 입으면어떻겠어 그렇지 않나 그 그런 식이 되지 않나 하는 식이 돼요 그런
그리 요쌘느 영 응으하는 데돔 이쩨유 머탄 지베는	그래 요새는 영응하는 데도 있지요 무엇한 집에서는
좀 유유한 지베는	좀 유유한 집에서는
유유한 녀 풍조칸 지베는 그 맹 정보글 한 사름똥 이써요	유유한 집 풍족한 집에서는 그 역시 정복을 하는 사람도 있어요
조서언네드 이꼬 둘매이 이꼬 맹 도포 이꼬 갇 쓰고 그래 지내엔 집또이찌믄 기 웨 보편쩌그로 바서능 거이 다 고망 그날 으여 이 이 응 이버뜬대로 고마 우 우아끼나 관다 덜쳐 이꼬 고마 그래 제사 지내구 그래지 머	한복 입고 두루마기 입고 역시 도포 입고 갓 쓰고 그래 지내는 집도 있지만그 외에 보편적으로 봐서는 거의 다 그만 그날이 이 응 입었던 대로 그만 윗 윗옷이나 하나 걸쳐 입고 그만 그래 제사 지내고 그러지 뭐
그게 인제 천지개벼기 데텅 그헤	그게 이제 천지개벽이 됐다는 그게
며 옵 복짱이나 이렁 거또 차이 나고 머 혹시 제사 지널 시가니나 이렁거뚜 쫌 다	뭐 옷 복장이나 이런 것도 차이 나고 뭐 혹시 제사 지내는 시간이나이런 것도 좀 다
시가니 그케윽 그 그거또 천지개벼기래요	시간이 그러게 그 그것도 천지개벽이에요
요새믄 어쩐냐 꺼뜨머이 옌나려 안 열뚜 시 한 사이 지낸니더	요새는 어떠냐 할 것 같으면 옛날에는 한 열 두시 한 시 사이에 지냈어요
예를 드러 오느리윽 그르이 치뤌 시비 일 랄짜를 그게 떼먼 주근 사러임 오늘 시비 일 주거씨먼 사 어이 시비 일 꺼여 오후 오저네으 차이가 나오구더여	예를 들어 오늘이어 그러니 칠월 십이 일 날짜라 그러게 되면 죽은 사람이 오늘 십이 일에 죽었으면 십십이 일 그 오후 오전으로 차이가 나거든요
오저네 주거씨믄 십싸 미럴 제사을 지내이 데 새벼기 지내이 데고 시비 릴랄 주어쓰먼 시비 일랄기 열뚜 시 한 시 싸이읻 지나이 덴데 요새능 그거상관 업시 오늘 시비 일랄 도러가씸 시비 일랄 초저녀이 고마 일곱 시 여덜 지 뎀 제사 지내으	오전에 죽었으면 십삼 일에 제사를 지내야 돼 새벽에 지내야 되고 십일 일에 죽었으면 십이 일에그 열두 시 한 시 사이에 지내야 되는데 요새는 그것과 상관 없이 오늘 십이 일에 돌아가셨으면 십이 일 초저녁에 그만 일곱시 여덟 시 되면 제사 지내요
그게 인제 여게도 그런 풍서비 데 쁘러서 인저 스꽈니	그게 인제 여기에도그런 풍습이 돼 버렸어 인제 습관이
웨냐 점부가 절믐 분드리 도시스 사다 마래요 또 도시서 성장해꼬 커릉걸 포 장코 드또 보도 모 탄 이 이를 하자 그이께네 어으 어정쩡하고 하이께네고마 이게 간소화한다 그능 거 고마	왜냐 전부가 젊은 분들이 도시에서 살다가 말이에요 또 도시에서 성장했고 그런 것을 보지 않고 듣도 보도 못 한 일 일을하자 그러니까어정쩡하고 하니까 그만 이게 간소화한다고 그러는 거야 그만
그래가주 시비 일랄 아부지 기제상 고마 시비 일랄 쩌엗 저녁 끼응 일곱 씨에 제살 쩌이 여덜 씨 제사 찌내고 고마 저녁 겸 때아 쁘려요	그래서 십이 일에 아버지 기제사는 그만 십이 일 저 저녁 그 일곱 시에 제사를 지내고 여덟 시 제사 지내고 그만 저녁 겸으로 때워 버러요
으 저녀게 곰머 제사 지내 쁘이께네 머 그래 으 다 데 쁘이께네 그 그르이 머펼리하지으	어 저녁에 그만 제사 지내 버리니까 뭐 그래다 돼 버리니까 그 그러니 뭐편리하지요
그게 펼리하긴 머 옹 움 무 망고 펼리하지여 그르 옌날 대애먼	그게 편리하기는 뭐어 뭐 만고 편리하지요 그것을 옛날에 대면
그게 인제 참 마이 달러져쩨 머	그게 인제 참 많이 달라졌지 뭐
영 백팔씹 또 달러징 게러여	영 백팔십 도 달라진 거에요
거영 어째뜯 마봄며넌 예전하고 요즘 머 사 업 펴에 제사도 그러코장네도 그러코 사라 인는 사람들 편한 쪼그로 마니 가지	그러 어쨌든 뭐 어보면은 예전하고 요즘 뭐 살편 제사도 그러고 장례도 그렇고 살아있는 사람들편한 쪽으로 많이 가지요
이 즈 점부걷 자기 지 자기 주자 이이 즈 주이에이 참 에 편한 쪼그로 쫌 할라 그래 머더	예 이 저 전부가 자기 저 자기 주장 이 저 주의 참어 편한 쪽으로 좀 하려고 그래 모두
또 그 너무 에르께 하 꺼 머 인나 그런 식 데꼬 또요	또 그 너무 어렵게할 것 뭐 있나 그런 식이 됐고 또요
머 거이 거이 인지 요즈어멈 머 자기 편한 시그로 할라 한다 그지예	뭐거의 거의 이제 요즘은 뭐 자기 편한 식으로 하려고 한다 그렇지요
느그 그르체요	예 그렇지요 예
어르신 그 머 어제 이어서 쫌 이야기를 쫌 해 주십씨요	어르신 그 뭐 어제 이어서 좀 이야기를 좀 해 주십시오
예아	예
어제 우리 논농사에 대해서 이야기를 쫌 하션는데 그 그래서 오느릉 그 반농사에 대해스도 쪼곰 어이씨너 어르싱께서 아시는 대로 쪼금 이야기를 해 주시면 조케씀미다	어제 우리 논농사에 대해서 이야기를 좀 하셨는데 그 그래서 오늘은 그 밭농사에 대해서 조금 어르신 어르신께서 아시는 대로 조금 이야기르 해 주시면 좋겠습니다
그래습어제 급 반농사어너 주로 어떵 게 인는지 여기 진능 반농사가	그래서어제 그 밭농사는 주로 어떤 게 있는지 여기 짓는 밭농사가
여게 이 지여게는 주로 인제 머어 참언제 콩 보리 서숙 밀 또 그다으멘 인제 고구마 그래 크 이 이 찌 요중 간 인제 한 며 태 쩐부튼 저넨 녀땅꽁을 안 해은데 한 해방 후 한 오륭 년 은 은 저우 후버트먼 여 땅콩도 한다꼬요	여기에 이 지역에는 주로 인제 뭐 참인제 콩 보리 조 밀 또 그 다음에는 인제 고구마 그래 그 이 이 저 요즘 와서 인제 한 몇 해 전부터 전에는 여기 땅콩을 안 했는데 한 행방 후 한 오륙 년어 저 후부터는 여기 땅콩도 한다고요
딷 땅콩도 지이꼬 극 극 끄 감자 주로 그릉 게 웨 반농사른녜	땅 땅콩도짓고 그 그 그 감자 주로 그런 게 왜 밭농사는요
그언너 거기 그 반농사 논농사에 비해섭 그어 반농사 하는데에 여기선너주로 그럼 제일 마니 하능 겝 버리하고	그러면 거기 그 밭농사 논농사에 비해서 그 밭농사 하는데 여기서는 주로 그럼 제일 많이 하는 게 보리하고
감자지 머	감자지 뭐
버리하우 감자가 만씀미까	보리하고 감자가 많습니까
글치여우 고담 콩이고	그렇지요 그 다음이 콩이고
쁘어 버리느 그람머 언제 주로 심꼬 어떠케 함미까	보 보리는 그러면 언제 주로 심고 어떻게 합니까
버리느 인제으 갈버리라 그능 거능 긍 으 참 쩌어 그 갈버리라 그응가을게 감니자 나락 비 네구 추수하고	보리는 인제어 가을보리라 그러는것은 그참 저 그 가을보리라 그러는 것은 가을에 갑니다 벼를 베 내고 추수하고
크렴 인제 언능 그 나락 뜽거리 인는 쓰 새에다 인제 수루루 후끼로 가음상타 뿌고 타 뿌고설랑 거게 버릴 뿌래고 그 저어 그 써레라 그능 녀 까주어이래 드 소에 메 가여 땡기고 나오 와따 가따 그러 뿌먼 그 버리가 무챔니다	그러면 인제그 벼 묶음이 있는 사이 사이에다가 인제 수루룩 쟁기로 가면서타 버리고 타 버리고서는 거기에 보리를 뿌리고 그 저 그 써레라고 그러는 것을 가  지고 이래 저 소에 메 가지고 당기고 나오며 왔다 갔다 그래 버리면 그 보리가 묻힙니다
커려 음제읍 고 사이다 인제 고러 사람 댕길 고 고를 쥐이 노코 그래가주인제 나 두먼 내염 보메 까 이지야 저 지 느점믄능 가을게 가믕 그 싸기 틈니다	그러면 인제 그 사이에다가 인제 골 사람 다닐 골 골을 지어 놓고 그래서 인제 놓아 두면 내년 봄에 그 이 저 저 늦은 가을에 가면 그 싹이 틉니다
싸기 터 가지 이래 조와 오르믄 추울 때 가먼 한 송꾸락 한 기리택 뗌다버리가 조응 게	싹이 터 가지고 이래 좋게 오르면 추울 때 가면 한 손가락 한 길이쯤 됩니다 보리가 좋은 게
그릉 게 인제 파랑 게 나와 이씸믕 그게 기여를 람니다	그런 게 인제 파란게 나와 있으면 그게 겨울을 납니다
기여를 람믕 보메 인제 또 그넘머 그이 보메 거 인제 이 시비라 그능 이 여인제에 비료라 그능 게 이씨다	겨울을 나면 봄에 인제 또 그러면 그게 봄에 그인제 이 시비라 그러는 게 여기 인제 비료라 그러는 게 있습니다
요샘 은지 이 옌나레능 머 똥짱구이 지곰 마리야 오줌하콩 이래 가주이즏지고 이 뎅기민썽 인제 쪼꿈씨 쫑우섭 뿌래 주고 핸데 요새에능 그거느 인제요굼머 숙 저 뿌고 비료럴 가주 인제 야깐씨 조 노씀다	요새는 인제 이 옛날에는 뭐 똥장군을 지고 말이야 오줌하고 이래 가지고 지고 이 다니면서 인제 조금씩 조금씩 뿌려 주고 했는데 요새는 그것은 인제 그만 싹 져 버리고 비료를 가지고 인제약간씩 줘 놓습니다
주 쭈 조 노코 인제 또 고다으메 인제 어아 봄뻐리러응 게 또 이씀미다	줘 줘 줘 놓고 인제 또 그다음에 인제봄보리라는 게 또 있습니다
봄뻐래르 그응 근 보메 기열 라고 봄 한 양녀 칸능 음냐 칸 사멀 리 양녀 칸 사월 사월경 므 데 가주 인제 버리를 감니다	봄보리라 그러는 것은 봄에 겨울 나고 봄 한 양력 한 음력 한 삼월 이 양력 한 사월 사월경에 뭐 돼 가지고 인제 보리를 갑니다
보메 가라 그은깐	봄에 갈아 그러니까
바테도 가고 노네도 가고 다 가는데 그 인제 그 그 봄뻐리는 쌀버리가또 이꼬 주로 쌀버이르 그응 그느 훼기가 적씁니다	밭에도 갈고 논에도 갈고다 가는데 그 인제 그 그 봄보리는 쌀보리가 또 있고 주로 쌀보리라 그러는 것은홰기가 적습니다
요래 인제 껍떼이거 똥뚜안 나오고 인저 쌀버리두 하고 껍버리드 하고	요래 인제 껍질이 똥글똥글하게 나오고 인제 쌀보리도 하고 겉보리도 하고
그래 인제 맹 갈버리도 맹 꺼뻐리 봄뻐리 함니다	그래 인제 역시 가을보리도 역시 겉보리 봄보리 합니다
그래 똑까지여그 그걷 추 추수하고 그담메 응 감자라 근 거는 양녀 칸 사멀 응 그 그으또 맹 마치여 사월 초생쭘 데머 인제 바철 갈고 고를 타고거 인제 이으 거르멀 려콩 허래 가주이 요샌 비롤 쪼꿈시읍 꼬레 가 인제으 그감자씰 여어 가주고 인제 그 그느미 나멍 가꽈 가주고 그래 갇까 감자는 양녀기 유월 초순 치럴 초에 캠니다 그거너	그래 똑같이 그것 추 추수하고 그다음에 응 감자라고 그러는 것은 양력 한 삼월 응 그 그것도 역시 마찬가지로 사  월 초순쯤 되면 인제 밭을 갈고 골을 타고 그 인제 이 거름을 넣고 그래 가지고 요새는 비료를 조금씩 뿌려 가지고 인제 그 씨감자를 넣어 가지고 인제 그 그놈이 나면 가꿔 가지고 그래 가꿔 감자는 양력 유월 초순 칠월 초에 캡니다 그것은
캐가지 머꼬	캐서 먹고
버리도 역씨 유월 참 오월 초이 유월마릴경 데믄 이 팯 다 여 다여뭄니다	보리도 역시 유월참 오월 초유월말일경 되면 이 패고 다 여 다 여뭅니다
그래므 그으 가주쓰쪼에 인제 비 가주윧 추술 하고 거러 인제 거 콩이라 그능 거는 옌나레는 어이 요새느 인제 이 기양 콩을 고마	그러면 그것을 가지고인제 베 가지고 추수를 하고 그러고 인제 그 콩이라 그러는 것은 옛날에는요새는 이 그냥 콩을 그만
노지로 가는 데두여 노지라 그능 거 인저 받 전체 앙 꺼또 안 하고 콩먼가능 게 이써요	노지로 가는 데도 노지라 그러는 것은 인제 밭 전체에 아무것도안 하고 콩만 가는 게 있어요
그게 인제윽 그르코	그게 인제 그렇고
옌나레는 버리 감잘 으 인제 그 새애 꼬레다 그리라 그음상 인제 그 콩얼시머슴다	옛날에는 보리 감자를인제 그 사이 골에다 그리라 그러면서 인제그 콩을 심었습니다
소를 메아 호끼루 수루 타고 또 그르음 사라미 끌꼬 함 타고 거 여어가주은제 그 콩 으으흠 머로 버리 감자를 추수얼 한 디엔는 그 거랑을 또 탐니다	소에 메어서 쟁기로 쓱 타고 또 그 다음에 사람이 끌고 한 번 타고 거기 넣어 가지서 인제 그 콩뭐냐 보리 감자를 추수를 한 뒤에는 고랑을 또 탑니다
후끼로 타먼 그그 콩을 무더 줌다	쟁기로 타면 그 콩을 묻어 줍니다
이래이 야깐 무채머으 글티 사라미 감 호무로 이자 무씀니다	이래 약간 묻히면 그때 사람이 가면서 호미로 인제 묻습니다
무더가드 그 인제 가을게 추수하꼬 그르코	묻어서 그 인제 가을에 추수하고그렇고
서수건 또 인제 서숭 농사는 에 버리보다 초끔 느께 감니다	조는 또인제 조 농사는 에 보리보다 조금 늦게 갑니다
요즘 가아껴이 요즘 아이따 오월 한 금 저께 데먼 그 그거 역씨도 인제으 그리라 그꼬 인제 그 감자받 새에도 여꼬 버리받 새에도 여 맹 콩과 마차이래	요즘 갈 거야 요즘 아니다 오월 한 지금 정도 돼면 그 그것 역시도 인제 그리라 그러고 인제 그 감자밭 사이에도 넣고 보리밭 사이에도 넣는 역시 콩과 마찬가지야
그래으 그리라꺼 그 탕을 여어 가주고 그으 가을게즈 추수하능 게고 그래가반농사느읻 주로 고마요	그렇게 그리라고 그 땅을 넣어 가지고 그 가을에 추수하는 것이고 그래서 밭농사는 주로 그만요
그람 그러가 여기느 혹시 미른해씀미까	그러면 그래서 여기는 혹씨 밀은 안 했습니까
여어도 미를 하인 옌나레 해써여 점뇨	여기도 밀을 하긴 옛날에 했어요 조금이요
요새엔 밀함니다 여느	요새는 밀 안 합니다 여기는
미리 잘 안 데 또 요새엔뇨	예 밀이 잘 안 돼 또 요새는요
여이	아 여기
저으	저 예
이 끄이 기후가 웨 변도이 생기니 여언 미른 쪼끔 정 거치 안 데드라꼬	이 그 기후가 왜 변동이 생겼는지 여기는 밀은 조금 전 같이 안 되더라고
그래거 미른 드무고	그래서 밀은 드물고
주로 그검 머 볼 버리나 이렁 검마 한다 그지예	주로 그것 뭐 보 보리나이런 것만 한다 그렇지요
고욛아음메 인제 땅콩 거 가는 사람도 망코	그 다음에 인제 땅콩을 가는 가는 사람도 많고
땅콩은 머 언제 갈르가 언제 하미까	땅콩은 뭐 언제 갈아서 언제 합니까
땅콩은 구 구 코게 인제 양녁 사멀 은 삼뭘 맹 감자 시믈 때 으 글때 함먹 시뭄니다 그언	땅콩은 그 그 그게 인제 양력 삼월삼월 역시 감자 심을때그때 한 번에 심습니다
그언 시머 노으먼 그건느 인제 가을게 가서 근 다릉 게 뎀므 쪼끔 느 때지	그것은 심어 놓으면 그것은 인제 가을에 가서 그것은 다른 것에 대면 조금 늦게 되지
으 그 그 땅콩은 일모작빼끼 모 함네더 거느	어 그 그 땅콩은 일모작밖에못 합니다 그것은
곤 땅콩바텐 다릉 거 어이 시가니 업써 할 쌔가 업써	거기 땅콩밭에는 다른 것시간이 없어 할 여유가 없어
곰 미 땅콤망 캐 가주어 하고	그것 뭐 땅콩만 캐 가지고 하고
그다으메 인제 므어 가을 떼믕 그 빔 바테 머 저 채마도 가고 배추도 시므고 심꼬 그 무꾸도 갈고 그다음 이여 창깨도 함내	그 다음에 인제 뭐 가을되면 그 빈 밭에 뭐 저 채마도 갈고 배추도 심고 심고 그 무도 갈고 그 다음 여기참깨도 합니다
창깨 뜰깨는 그키 마이느함니다 요새에는	참깨 들깨는 그렇게 많이는안 합니다 요새는
자기 머글 만침 해찌만 저네느 또 며 태 저네는 그 땅 깨 이 즈 칟 창깨를 마이 해쓰임다	자기 먹을 만큼 했지만 전에는 또 몇 해 전에는 그 참 깨 이저 참 참깨를 많이 했습니다
웨구 왜냐 창깨 깝씨 비싸 노이께네 다릉 가이보다여 지 장머기 수이비 좀 나따 그래어 그 곰머 점부 바테다 멘 마지이를 땅꾹 깨 하는 사람도 마는데이 요새드 그른 사람 맹 이써요 하기는	왜 왜냐 참깨 값이 비싸 놓으니까 다른 가격보다 작 작목이 수입이 좀 낫다 그래서 그 그만 전부 밭에다 몇 마지기를땅 깨 하는 사람도 많았는데 요새도 그런 사람이 역시 있어요 하기는
그랜 너허 반농산 주로 그 그러쓰미다 머	그래 뭐 밭농사는 주로 그 그렇습니다 뭐
그어기 그럼 아까 그어 거리라능 거리라고 해씀미까 사이에 그거 악 어으  가능 거	거기 그럼 아까 그 그리라는 그리라고 했습니까 사이에 그거어가는 것을
예예 예예	예 예
그 그어게 그암먿 사알 곡식 사이	그 그게 그러면 사이 곡식 사이
그리 그리라 그능 거	그리 그리라 그러는 것
그리	그리
그리라 그능 건 요 인제 이거 감자가 요래오래 심혀이 요올 이 요래 딕 어그 고리그더 감자 고리거드 요오요	그리라 그러는 것은 요기 인제 이것 감자가 요래요래 심기면 요기를 이 요래 저그 골이거든 감자 골이거든 요기요
요 사이가 쪼꼼 비 이씀미다	요 사이가 조금 비어 있습니다
여길 요래 그 으 탐니다	요기를 요래 그탑니다
스 사러미 끄은 수뚜 꼬 소가 끄음데 그걸 그리이 연는다 그램니다	사람사람이 끄는 수도 있고 소가 끄는데 그것을 그리 넣는다고 그럽니다
그리 연는다 그래	그리 넣는다고 그래
그리 연는데 그게 그암 일쫑에 사이지끼다 그지예	아 그리 넣는데그게 그러면 일종의 사이짓기다 그렇지요
일쫑에 다른 장물 사이에 이래 파는	어 일종에 다른 작물 사이에 이래파는
예 그 다른 장물 사이에 시무능 게 마자여	예그 다른 작물 사이에심는 게 맞아요
고래가주 그이 저네 장물 캐내믕 그걸 또 인제 으으 그루 한다 그릉이	그래 가지고 그것 전에 작물을 캐내면 그것을 또 인제그루한다 그럽니다
또 그은데 또 인쩨 으 탐니다	또 그런데 또 인제탑니다
그 캐뜬 데를 요래 콩 시머 노꼬여 서숙 시머 나떤 데는 니 요 사이예 이그 감자나 버리 뜽 거 그 베 내 쁘먼 고 짜꾸거 나끄더	그 캤던 데를 요래 콩심어 놓고 조 심어 놨던 데는 이 요 사이에 이것 감자나 보리 같은 것 그 베어 내버리면 거기 자국이 남거든
이 꺼 구 고골 또 탐니다	이 그 그 그것을 또 탑니다
또 타요	또 타요
또 타가지 이어 이여 이 이릉 걸르 타먼 니어 흘기 갈라짐다 이래 데먼	또 타서 이 이 이 이런 것으로 타면 이 흙이 갈라집니다 이래 되면
끄익 이래 뎀 이짝 타 과먼 그래으 콩 뿌릴 무더 주기 데요	그 이래 되면이쪽 타고 가면 그래 콩 뿌리를 묻어 주게 되요
고래 데믄 덜 무첸 데는 사라임남 호미러 끌씀니데 이램	그래 되면 덜 묻힌 데는 사람이 호미로 긁습니다 이래
그래 무더 주고	그래 묻어 주고
그르 콩 뿌리를 든드이 하는	그래 콩 뿌리를 든든히 하는
거므 어르싱 거기에 그 우리가 끄 받또 밤매기를 하지야	그러면 어르신 거기에 그 우리가 그 밭도 밭매기를 하지요
쁘 아이거 밤배기 하지러요	예 밭 아이고 밭매기 하지요
바츤 어떠여 바츤 어떠케 맴미까	밭은 어떻게 밭은 어떻게 맵니까
밤매기느 인제 여 그 감자받뜨 버리받 콩받 밀받 다 맴니다 매기는	밭매기는 인제 여기 그 감자밭 보리밭 콩밭 밀밭 다 맵니다 매기는
다 매이 다 함번씨그 다 매이 든뎁	다 매야 돼 한 번씩은 다 매야 되는데
푸리 조으믄 그느믈 뽀바 조이 데지으 그르미 너무 조아 뿜 곡쓰까 거 어울 어울려 뿌래	풀이 좋으면 그놈을 뽐아 줘야 되지 그놈이 너무 좋아 버리면곡식하고 그 어울 어울려 버려
그래 가주으 곡써기 지자이 이끼 때므에 점부 그을 뽀꼬 매정거 그르 또 이래 점무 훌터 주고 그래 예헥 응 그 맴니다밤매기릉 기 다 함니다	그래가지고 곡식이 지장이 있기 때문에 전부 그것을 뽑고 매고 그리고 또 이래 전부 훑어 주고 그래응 그 맵니다밭매기라는 걸 다 합니다
놈매기는 아까 우리 어제 보통 두 번 하고 피 뽀꼬 이러케 피 뽁 옏 그렫피 뽀금능 게 마지마기라해씀미까	논매기는 아까 우리 어제 보통 두 번 하고 피 뽑고 이렇게 피 뽑고그렇게 피 뽑는 게 마지막이라 안 했습니까
마지마기그 그렴 농사 다 지꼬 인제 추수한다 그르게	예 마지막이고그러면 농사 다 짓고 인제 추수한다 그러지요
그른데 여기 그암면 밤매기느 바튼 보통 메 뻠 맴미까	그런데 여기 그러면은 밭매기는 밭은 보통 몇 번 맵니까
바천능 그 그게 대종이 엄니더	밭은 그 그게 대중이 없습니다
바천 니금 믐 매기라앙 게 여서 딸 응 게소케 매이 뎀다	밭은 이것 뭐 매는 게 여섯 달 응 계속해서 매야 됩니다
이으 감자밤 매이 제으 감자밤 매고 남 또 궁우 콩밤 매이 데지러요	이 감자밭 매야 되고 감자밭 매고 나면 또 그 콩밭 매야 되지요
고 사이에 감자 캐 무꼬 남 콩 구루 타 가정으 이래 이여 콩 쪼끔 조으믕그으또 푸리 좀 나이 매 조이 데지로요	그 사이에 감자 캐 먹고 나면 콩 그리타 가지고 이래 이 콩 조금 좋으면 그것도 풀이 좀 나니 매 줘야 되지요
또서숙빠또 쫌 매 조이 데지르요	또조밭도 좀 매 줘야 되지요
그은 머 이 여서 딸 도안 쭉 달램니다 그응 업 밤매기라 그능 거너	그것은 뭐 이 여섯 달 동안 쭉 매달립니다 그런 것 밭매기라 그러는 것은
바츨 머 그어 또 계속 뽀어 내고 또 다릉 거 시미니까	밭을 뭐 그 또 계속 뽑아 내고 또 다른 것을 심으니까
예 다릉 거 시므니까 그그또 매 조이 데그더	예다른 것을 심으니까 그것도 매 줘야 되거든
그어 또 푸리 나그등	거기에 또 풀이 나거든
그르이 여서 딸 또아늘 일 려네 농사랑 겓 주로 중요할 때가 여서 따리그더요	그러니 여섯 달 동안을 일 년에 농사란 게 주로 중요할 때가 여섯 달이거든요
여 쩌 인자 사멀 사월 오월 유월 치럴 파럴까지그더요	여 저 이제 삼월사월 오월 유월 칠월 팔월까지거든요
요 사이 인제 점부읃 장모글 바까 하니까 고우여 바츤 게소켜 매 조이 데능게라	요 사이 인제 전부 작목을 바꿔 하니까 그 밭은 계속해서 매 줘야 되는 거야
노는 응 끄어 그 그 나락빼게 안 하니까 두불놈매임므 해 뿌오 피사리해 뿡고마 단데 바츤 여서 짤 또아늘 그 이 종 꾸주니 다다알 거이 다다리 매는 수가 이 이써 그건뇨	논은 응 그 그 그 나락밖에 안 하니까 두벌매기 해 버리고피사리해 버리면 그만 다인데 밭은 여섯 달 동안을 그 이 좀 꾸준히 다달이 거의다달이 매는 수가 있어 있어 그것은요
그염 머 하이튼 대으다 그지예	아 그럼 뭐 하여튼 힘들다 그렇지요
예아	예
밤매기넌	밭매기는
밤매기능 그래 함니더	예 밭매기는 그래 합니다
이 여서 딸 또안 다 또 파럴딸 데먼 쩌어 김장밤 매그더 또요	이 여섯 달동안 다 또 팔월이 되면 저 김장밭 매거든 또요
어호 무꾸받 으흔 으흐 또 머 파받 또 그르코 머 배추받 다 매야 데그더	어 무밭어 또 뭐 파밭 또 그렇고 뭐 배추밭 다 매야 되거든
그르이 꿍구주니 달래 밤매기는녀	그러니 꾸준히 매달려 밭매기는요
그음명 꺼기 급 부고 그거 이 그거 받 까틍 경우에끄 곡식 쁘어 뿌리 나응 그 그어른 머 야깐 두툼한 그걸 부기라 함미까	그러면 거기 그 북 그것 이 그것 밭 같은 경우에그 곡식 뿌 뿌려 놓은 그 그런 뭐 약간 두툼한 그것을 북이라고 합니까
망 망 진는다어고 핸는데 망 만든는능 거 아임미까 그기	망 망 짓는다고 했는데 망 만드는 것 아닙니까 그것이
골 탄다 그래 골 탄다고	골 탄다고 그래 골 탄다고
골 타고	골 타고
응어 망응 고럴 타먼 망에	응 망 골을 타면 망에
고럴 타먼 망이 나와	골을 타면 망이 나와
이끼 이래 스르룰 타먼 스루우 타먼 여게는 응우 꾸워 사래미 소가몰고 나거 사럼미 후낀 나강 기 이건누 고리 데고 여페 흘 러머 간 데는망이 데여 망이	이게 이래 스르르 타면 스르르 타면 여기에는 응어 그사람이 소가 몰고 나가고 사람이 쟁기로 나간 게 이것은 골이 되고 옆에 흙이 넘어간 데는 망이 돼요 망이
망이 데공 그래 그 망이라 그능 거느	망이 되고 그래 그 망이라고 그러는것은
그엄며느 그 망 가틍 으인제 그른데 그거 무 고추나 고추바치나 이렁 거시머 노으며너 이래 흐글 이러케 쫌 해글	그러면은 그 망 같은 인제 그런데 그것 뭐 고추나 고추밭이나 이런 것 심어 놓으면은 이래 흙을 이렇게 좀 해야
부끌 조엗 부끌 디응	북을 줘야 북을 돋우어야
부글 북 도둔다 하지예 그걸	북을 북 돋운다고 하지요 그것을
그러치 북 도둔다	그렇지 북 돋운다
그 흘글 끄러므아 준 수도 이꼬 부글 도둬	그 흙을 끌어모아 주는 수도 있고북을 돋워
요새느 주로 인제 또 비니룰 씨아 뿌이껜 마리야 옌나렝 그랭데 요새늠 비니룰 씨어 너먼 그 으 북 쭝 건 업써	요새는 주로 인제 또 비닐을 씌워 버리니  까 말이야 옛날에는 그랬는데 요새는 비닐을 씌워 놓으면 그북 주는 것은 없어
거 구마 비니룰 씨아 가주 이래 해 나 뿌이 푸리 안 올로 오이께네 그 소게서 고마 이래 데고 옌나렌 그 비누루가 세우지 앙고 할 때는 점부 이래 부껄조 가주 풀또 뽀꼬 이래 나가암 삭 끄러마아꼬에우 그래 조따꼬 그렁어이	거기그만 비닐을 씌워 가지고 이래 해 놓아 버려서 풀이 안 올라오니까 그 속에서 그만이래 되고 옛날에는 그 비닐을 세우지 않고 할 때는 전부 이래 북을 줘 가지고 풀도뽑고 이래 나가면서 삭 끌어모아서 그래 줬다고 그렇게
요샌 그 꼬치 끄러모능 건 업써 지에 비니룰 씨아 뿌이께네	요새는 그 고추 끌어모으는 것은 없어 저 비닐을 씌워 버리니까
일딴 시아 나아니까	일단 씌워 놓으니까
예아	예
제 그러니까 요즘 비닐 하고 나스너 그검 머야 드러 풀 뽐능 거또 마닏이리 더러께따 그지예	저 그러니까 요즘 비닐로 하고 나서는 그것 뭐야 더러풀 뽑는 것도 많이 일이 덜었겠다 그렇지요
그르치 마이 더러찌	그렇지 많이 덜었지
이 이럴 일름 꼬추박 꺼틍 거 그 비니를 씨우먼 농사 지은 데 바니를 해뿌능 게라	이 일을 일 고추밭 같은 것 그 비닐을 씌우면 농사짓는 데 반일을 해버리는 거야
머 잉푸를 구거 인제 추수할 때꺼진 은 으 푸럴 매지 아느이께네 매진 안 하니 구마 수황마 해 뿌고 에 비니루 뻬끼 뿜 또 농사 다 지이 뿌이껜	뭐 이풀을 그것 인제 추수할 때까지는어 풀을 매지 않으니까 매지는 안하니 그만 수확만 해 버리고비닐을 벗겨 버리면 또 농사 다 지어 버리니까
그르이 옌나레는 농사진는 사럼드리 더 바쁘고 더 머 이거 이그 이 애럴마이 머찌 머	그러니 옛날에는 농사짓는 사람들이 더 바쁘고 더 뭐 이것 이것이 애를 많이 먹었지 뭐
그르이 순 근 소느로 하이께네 일려그로 노동녀그로 그래 해찌먼 요샌느기게가 또 나와 가저요 쭈 이짇 참 조치	그러니 순 그것은 손으로 하니까 인력으로 노동력으로 그래 했지만 요새는 기계가 또 나와 가지고 저 저 참 좋지
농사가 머 크래 가주고 농사진는 사럼드리 이럴 마이 더러 가조이 찌 저네농사지떤 사람 대 마이 편하다꾸 요샌	농사가 뭐 그래 가지고 농사짓는 사람들이 일을 많이 덜어 가지고 저 전에 농사짓던 사람에 대면 많이 편하다고 요새는
그다으메 그어 쩌기 겁 바아 바꼴 타능 거는 농꼴 타능 거랑 비슫함미까어떠씀미까	그 다음에 그 저기 그 밭 밭골 타는 것은 논골 타는 것이랑 비슷합니까 어떻습니까
노는 골 타능 게 이꺼 가능 게 바꼬른 으응 으응 노네능 골 타능 게 업써	논은 골 타는 게 아니고 가는 것이고 밭골은 응 응 논에는 골 타는 게 없어
욱 골 타능 게 그 어꼬 바꼴 타지 주로	없 골 타는 게 그 없고 밭골 타지 주로
에 바꼴 타카	예 밭골 타서
거을 그르지여 바꼬를 타지	어 그래 그렇지요 밭골을 타지
그 그엄 머우 그음며 농 가능 거하고 박 가능 거는	그 그러면 뭐 그러면  논 가는 것하고 밭 가는 것은
농 가능 거하코 노는 가능 거는 간다 거 바또 가능 거느 간다 그거	논가는 것하고 논은 가는 것은 간다 그러고 밭도 가는 것은 간다 그러고
바츤 다 가능 거느 이래 바츨르 점부 다 두베 가능 게러	밭은 다 가는 것은 이래 밭을 전부 다 뒤집어 가는 거야
요리 두베그 요리르 요리 요거능 간다 그리고 이래 드문드문 사이를 이이걸 등얼 뚜고 으 어우골 탄다 그능 건 여기에 이 여게으 고리 데 뿌이께느 골 탄다 그렁 게러	요리 뒤집고 요리 요리 요것은 간다고 그러고 이래 드문드문 사이를 이 이것을 등을 두고어골 탄다 그러는 것은 여기에 이 여기에 골이 돼 버리니까 골 탄다 그러는 거야
골 탄다 그러제	골 탄다 그러지요
그르체	음 그렇지
가능 거는 싹 다 가능 걸 가주 그 간더	가는 것은 싹 다 가는 것을 가지고그 간다고
가러 어퍼 버리능 거 그찌예	갈아 엎어 버리는 것을 그렇지요
거즉 가라 어퍼 쁜다 그르그	그렇지 갈아 엎어 버린다 그러거든
그러잉꺼 그 차이가 이따 그지예	그러니까 그 차이가 있다 그렇지요
옝 그르치	예 그렇지
엉 그럼며너 그억 인지 그다으메 보리발끼를 하지예	어 그러면은 그 인제그 다음에 보리밟기를 하지요
버리발끼 하지유 버리발	보리밟기 하지요 보리밟기
여기 쫌 예저네 마니 해씀미까	여기 좀 예전에 많이 했습니까
옌날레는 응 귀게 여새 인제 저 머로르에 으에에 버리 입 버리를 요샌 쫌저끼 해	옛날에는 응 그게 요새 인제 저 뭐냐보리보리를 요새는 좀 적게 해
허이 이 지방으로는 버리 가능 게 별로 업따끄 이진 말	거의 이 지방에서는보리 가는 게 별로 없다고 이제는 말이야
혹 떠러 이찌만 옌나렌능 이모자그로 거이 버리를 다 가라꼬 노네도 바테도	혹 더러 있지만 옛날에는 이모작으로 거의 보리를 다 갈았고 논에도 밭에도
나가지언 학생들또 동원하고 버릴 발바따이께네	나아가서는 학생들도 동원하고 보리를 밟았다니까
양녁 시비월 이 이뤌 이월 으이 이럴 이 시비월 이리 이럴 고 사이래어	양력 십이월 이 일월 이월일월 이 십이월 이 일월 그 사이에요
곧 두 달 사이예 그그업 버리 이으 가을버릴르꺼 가릉 게 버리발릉 께라	그두 달 사이에 그것 보리 이 가을보리를 가는 게 보리밟는 거야
응 봄뽀린능 그은 머 음녀 어지 아느이께네	응 봄보리는 그것은 뭐얼지 않으니까
가을버리 가러 나떵 거늠 올로 완데이 이느미 야깐 투 소께 뿐다꼬	가을보리 갈아 놨던 것은 올라 왔는데 이놈이 약간 저 솟아 버린다고
소께능 걸 라두먼 어러 가주 뿌리거 주거 뿌기 때므레 이거 무체라꼬 발바주능 게라	솟은 것을 놔두면 얼어 가지고 뿌리가 죽어 버리기 때문에 이것이 묻히  라고 밟아 주는 거야
결과저그로 어쩨 무체라꼬 밤능 게나 마차이래	결과적으로 어떻게 묻히라고밟는 것이나 마찬가지야
끄으 그래 해따꼬	그 그래 했다고
밀루에 밀또 발바 조이 데 맹 므엉	밀 밀도 밟아 줘야 돼 역시 뭐
응으 끄 갈미런	응 그 가을밀은
그 결과저그로겨울 라헤 겨울 라게 데며느 해동하음면서 보리가 뜬다그지예 뿌리가	그 결과적으로겨울 나게 겨울 나게 되면은 해동하면서 보리가 뜬다 그렇지요 뿌리가
그르치 여으 뿌얻 뜨에 따잉 어러 가주 붕 떠 뿌이께네 그 그 뿌리읻 죽죽찌 마라꼬 발바 주능 게러이	그렇지 여기 뿌 떠 땅이 얼어 가지고 붕 떠 버리니까 그 그 뿌리가 죽 죽지 마라고 밟아 주는 거야
결과저우러 동해 방지래 그게	결과적으로 동해 방지야 그게
극 그으 그때 바리바어 보리발끼할 때 이를 때 먿 노래 불릉 거나 이렁거또 이씀미까 앙 그응 앙 그럼므 그냥 머 발꼬 치움미까	그 그 그때 보리밟기 보리밟기할 때 이럴 때 뭐 노래 부른 것이나 이런 것도 있습니까 안 그럼 안 그러며는 그냥 뭐 밟고 치웁니까
아이지 그게엡 발릉 게 임 마알찐 노래하고 머 으 그릉 건느 어꼬 혹 학상드리 동원뎀머 으쌰으쌰 그믄상 인제 서로 에낄 자꼬 이래 발바 가음상 인저 우쌰우쌰 금 뎅기능 거느 이써스엑	아니지 그게 밟는 게 이 말이지 노래하고 뭐그런 것은 없고 혹 학생들이 동원되면 으쌰으쌰 그러면서 인제 서로 어깨를 잡고 이래 밟아 가면서 인제 우쌰우쌰 그러면서 다니는 것은 있었어
그른 녜느 이써도 근느 하떼 일바닌드름 머 윽 기양 므음 기양 잡땀해 가므상 마리야 이래 즈 주꿈 주꿈 발바꼬	그런 예는 있어도 그런데 하여간 일반인들은 뭐그냥 뭐 그냥 잡담해 가면서 말이야 이래 저 조금 조금 밟았고
그 옌나레 인제 그 머 학쌩드 중고드 초고에 초등하 학쌩므이 중우 중고등학쌩더마아 가주 발블 땐는 서로 인제겨 이 에낄 리끼 이래 지 자븜상 이래 이래 발바고 우이쌰우샤 금 발반쩨	그 옛날에 인제 그 뭐 학생들 중고등 초등 초등학 학생들 중 중고등학생들모아 가지고 밟을 때는 서로 인제어 그 이 어깨를 이렇게 이래 저 잡으면서 이래 이래 밟았고 우쌰우쌰 그러면서밟았지
끌른 녜느 이써쑤	그런 예는 있었어
호 혹씨 그거 그 밀서리너 콩서리나 이렁 거 에음 머 해	혹 혹시 그것그 밀서리나 콩서리나 이런 것뭐 해
해찌 그르체	했지 그렇지
예저네 해 봐씀미까	예전에 해 봤습니까
마자이	음 맞아요
어트케 하은지 하음머	어떻게 하는지 한번
에 아이래 콩쓰리 아이르어	어 아니야 콩서리가 아니야
밀사리 밀사리 버리사리 콩사리 사리라 그으따 우리	밀사리 밀사리보리사리 콩사리 사리라고 그랬다 우리는
사리 밀사리라 그능 언 콩사리	서리 밀서리 그러는 것 콩서리
그래 인제 에잉 그게 버리가 인제 이 여무러 가주 밀 버리 또까치 여무거덩	그래 인제그게 보리가 인제 이 여물어 가지고 밀 보리가 똑같이 여물거든
이래 나오믕 그능얼 뽀바 가주우 마리야 이래 이그 이 저 언니 낭글 이잉 그 보드란 낭글 리리 쭈어 갈비 거틍 머 나무 뿍떼이 거틍 거 나무입 꺼틍얻 주마 가주어 부럴 찔르 롬머 그 인제 이래 소누르 부울 래 돌래 감스암 이이쿠먼 이피 그 싹헤 이 그 쇔미가 타 뿌고 시커머짐 이랩 비베 가주고 이래이베 터르 여코 머꼬	이래 나오면 그놈을 뽑아 가지고 말이야 이래 이것 이 저어 나무를 이 이 그 보드라운 나무를 이래 주워 솔가리 같은 뭐 나무 북데기 같은것 나뭇잎 같은 것 주워 가지고 불을 질러 놓으면 그 인제 이래 손으로 불 이래 돌려 가면서 이 익히면 잎이 그 싹 이 그 수염이 타 버리고 시커멓게 되면 이래 비벼 가지고 이래 입에 털어 넣고 먹고
또 콩사리라 그능 거는 그 맹 마차이래	또 콩서리라 그러는 것은 그것 역시마찬가지야
콩이 다 이거쓸 찌 누룸해쓸 쯔게 뽀바 가주고 또 쿠아 읍 불럴 질러 가주우 거다 인제 이래 자끄 두베머 이켄다꽁	콩이 다 익었을 적에 누렇게 됐을적에 뽑아 가지고 또 콩불을 질러 가지고 거기에 인제 이래 자꾸 뒤집으며 익힌다고
그염 코 인지 시커머끼 이 시커머꿰 에익 끄러 가주구 그래 뎀 으 그넘 인제꺼 엗 까머거 끈 응 콩사리 한다 그 저네	그러면 콩이 인제 시커멓게이 시커멓게 이 그을어 가지고 그래 되면그놈을 인제그까먹어 그응 콩사리 한다 그 전에
그래 뎀 이제 밀싸리 콩사리 함 이베 나치 막 시커며치 믁 끄러미 무더가주	그래 되면 이제 밀서리 콩서리 하면 입에 낯이 막 시커멓지 뭐 그을음이묻어 가지고
그래두 그에 마신는 재미러 마래어	그래도 그게 맛있는 재미로 말이야
요새능 그 머라 거드 자 람 머으께르	요새는 그것을 먹으라 그래도 잘 안 먹을거야
그 리 옌나레 그 배가 고파 그래끄덩	그것일 이 옛날에 그 배가 고파서 그랬거든
아이 그케 머낀 머어더 옌나렌능 그게 겐자이 심해끄더	아니 그러게 먹기는 먹어도 옛날에는 그게 굉장히 심했거든
먹으 께 업쓰니까	먹을 게 없으니까
아함 머글 께 귀해 가주이 요새느 끄 머 쩌 이 여 응 학생 아드려 콩사리하능 거 좀처럼 어옘 마스로 그 어데억 학 함번 하능 건 바도 옌날 거치 그키심하지은 안는따꺼 요샌	어 먹을 것이 귀해 가지고 요새는 그 뭐 저 이 여응 학생 아이들이 콩서리 하는 것을 좀처럼 어떻게 맛으로 그 어디 한 한 번 하는것은 봐도 옛날 같이 그렇게 심하지는 않다고 요새는
이 배가 부르이께네 마리여	이 배가 부르니까 말이야
그업 콩사리나 머 그거 콩사리나 밀사리나 이렁 거 하며너 검 쫌 낭어 집  꺼 하며는 머라함미까	그 콩서리나 뭐 그것 콩서리나 밀서리나 이런 것 하면은 그 좀 남의 집 것 하면은 뭐라 안 합니까
머라 커제이씨	뭐라고 하지요
주이니 보먼 주께지	주인이 보면 뭐라 하지
웨 나모 고 코 콩사릴 입데 꼬 콩을 꺼 카노 그래지마느 근 장나느롣 쳐주고 글때는	왜 남의 콩 콩 콩서리 이 콩 콩을 꺾고 그러냐 그러지만은 그것은 장난으로 쳐 주고 그때는
또 모두가 이해를 해따꿔	또 모두가 이해를 했다고
그언데 그 인제억 예정 가트며 그 어째뜬 거름 부부네스 쪼곰 이해느 해 주따 그지예	그런데 그 인제 예전 같으면 그 어쨌든 그런 부분에서 조금 이해는 해줬다 그렇지요
잉 그 그러체여 여이 쩌 이 찌 쩜 마여이 에음 머타 꺼트머 야단너언능야다안데 또 그 밤며네 머그라 그능 게 어이 항 가지 인제 옌나렌능 읻 수박서리 위서리라 그능 게 이써따꼬	이 그 그렇지요 이 저 이 저 좀 많이무엇할 것 같으면 야단은 야단인데 또 그 반면에 뭐라 그러는 게한 가지 인제 옛날에는 이 수박서리 참외서리 그런 게 있었다고
흐른데 인제 위 따무으러 나무 바테 마리아 이 차멛 시머 노머여 누런 차메 마리아 끄어기 결과저그론 은 위럴 훔체러 가능 게라	그런데 인제 참외 따먹으러 남의 밭에 말이야 이 참외 심어 놓으면 누런 참외 말이야 그게 결과적으로는참외를 훔치러 가는 거야
바메 초저녀게 설근설근 나무이 주이넌 이 여어능 그 마글 윈드마기라 근다꼬	밤에 초저녁에 슬금슬금 남의 주인은 이 여기는 그 막을 원두막이라 그런다고
윈드마게 주이니 잔다꾸 그어서	원두막에 주인이 잔다고 거기에서
저으 수박하꾸 시머 노코느	저기 수박하고 심어 놓고는
그래므 거 인제 저쭘 수박빠치며이 여으성 우리 인제 칭구들끼리 무 두리믄서읻 서이 나아 가즈엉 수박 따므어러 가자 차메 따므어러 가자 그이 결과저그로훔쳐 멍능 게리 그거넌	그러면 그 인제 저쯤이 수박밭이면 여기에서 우리인제 친구들끼리 뭐 둘이면 셋 셋이 나와 가지고 수박 따먹으러 가자 참외 따먹으러 가자 그게 결과적으로훔쳐 먹는 거야 그것은
그래 가주 인제 살짝 기이 드가 가주고 그너멀 이이 이런 쓰봉을 번다꼬	그래 가지고 인제 살짝 기어 들어가 가지고 그놈을 이 이런 바지를 벗는다고
쓰봉을 버더 거드이 여어를 메 뿌고 여다 따 연다구	바지를 벗어 가지고 여기를 메 버리고 여기에다 따 넣는다고
그래 여 찌 쓰봉 빤쓰만 이꼬 여다 여가주 인제 이래 쩨 읻 찌 찌 질멀찌구 라온 수도 이꼬 또 이래 머 들고 나온 수도 이꼬 그은 머 때에 따라 다름응게고	그래 여기 저 바지 팬티만 입고 여기에다 넣어서 인제 이래 저 이 저저 짊어지고 나오는 수도 있고 또 이래 뭐 들고 나오는 수도 있고 그것은 뭐 때에따라 다른 것이고
수 수 수박 꺼틍 언 또 걱 그느 이 엽 굴거 노이껨 항 개배끼 모 까즈온다꼬	수 수 수박 같은 것은 또 그 그것은 이굵어 놓으니까 한 개밖에 못 가져온다고
응 그른 녜도 그 그게 재미이따꼬 그래다 노으머 인제 예를 뜨러 가주우다들레 노으멈 마려이 주이니 요놈들 커우 웨 인 나무 웨를 웨 따노 수바글웨 따너 그 핵뜩 다리에 내려오노 드툼드툼 내려온다구 그램 여어 이씀니다커면 수바글 내던지고 항엳 항게 나온다꾸 디에 제르 띠에 싸렁구 놀래내라끄 쭈이러	어 그런 예도 그 그게 재미있다고 그래다 놓으면 인제 예를 들어 가지고 들켜 놓으면 말이야 주인이 요놈들 거기 왜 이 남의 참외를 왜 따느냐 수박을왜 따느냐 그 잽싸게 사다리를 내려와 주춤주춤 내려온다고 그러면 여기 있습니다하면서 수박을 내던지고 밖 밖에 나온다고 뒤에 제일 뒤에 사람이 놀리느라고 주인을
헝 그 그른 녜도 이써따이께러이	응 그 그런 예도 있었다니까
끄거 이 그 그귿 장나니공	그것 이 그 그것은 장난이고
끄언데 어째뜬 예저네느 그릉 게 쫌 이써따 그지예	그런데 어쨌든 예전에는 그런 게 좀 있었다 그렇지요
이 이서껌 이 짜네 마네써 글떠느이 옌나른	있 있었고 있지 않아 많았어 그때는 옛날에는
그아므 이 동네에 그얻 차메나 그업 수박 까틍 걸 재배하기도 핸네예	그러면 이 동네에 그 참외나 그 수박 같은 것을 재배하기도 했네요
어어 더러 해째이	어 더러 했지
어이 더러 해써	어 더러 했어
마이넘 안 해도 인제 어에 드문드문 상꼬레 인제 여로 마거 저짝 꼴 이짝고레 인제 메 찝슥 해싸	많이는 안 해도 인제드문드문 산골에 인제 여기 말고 저쪽 골 이쪽 골에 인제 몇 집씩 했어
한 동네 한 대여서 찝씩 해따꾸	한 동네에서 한 대여섯 집씩 했다고
어르신 그럼며느 혹씨 예저넫 닥서리나 이렁 거는 닥사리나 이렁 건해즏	어르신 그러면은 혹시 예전에 닭서리나 이런 것은 닭서리나 이런 것은 안 하셨습니까
아익어 읻 쯔 쯔 처기 달뚜 자암머으겅	아어 이 저 저 저기 닭도 잡아먹어
거 인뜨	그 인제
그렁 꺼또 해쓰미	그런 것도 했습니까
달도 읻 달두 자아머어	닭도 이 닭도 잡아먹어
어떤 니리거 달두 자아믕 게 인제 그게 맹 배가 고프이 그릉 게라	어떤일이냐 닭도 잡아먹은 게 인제 그게 역시 배가 고프니 그런 것이야
저녀그로 인저 으이 이래 모에 노다 보믄 요샌 인제 머 점부 직짜아 나가고 점부 그리음 바쁘이 그치므 옌나릉 벨 직짱도 어꼬 주로 인데 농경 사회느잉 농사지꼬 사는 사럼더느 무 갈 떼가 어끄등 마카 한 동네 여 모도 모에 사이께네 오느름 머 첨방엠 머모엔다든지 그르이으 기여레 추울 땐 누 집사랑에 모인다든지 흐레 모에 노다 보멈 설툴함머 누 집 디 달 짜아무러 가자 그르 인제 으 크래 카주고 메치 가쓰 은제 달거 한두 마리 짜바 가주 와서그어 먹따 그에 다들렌 또 야단남니다	저녁으로 인제이래 모여 놀다 보면요새는 인제 뭐 전부 직장에 나가고 전부 그래 바빠서 그렇지만 옛날에는 별 직장도  없고 주로 이런데 농경 사회는 농사짓고 사는 사람들은 뭐 갈 데가 없거든 모두 한동네 여기 모두 모여 사니까 오늘은 뭐 냇둑에 뭐모인다든지 그리고 겨울에 추울 때는 누구 집 사랑에 모인다든지 그래 모여 놀다 보면 출출하면 누구 집 닭 닭잡아먹으러 가자 그래 인제그래 가지고 몇이 가서 인제 닭을 한두 마리 잡아가지고 와서 그것을 먹다가 그 들키면 또 야단납니다
거 엉겨 달깜 무르준 수두 이써 잠타머	그 어디 닭값 물어주는 수도 있어잘못하면
엉 거 우움 모 주이니 달라 검 조이 데지 우엔노 말다	응 그뭐 주인이 달라고 그러면 줘야 되지 어떻하겠느냔 말이야
그려 무러달라 근 즌 사럼더 저꼬 또 메 으에 또 그은 고마 장나느로 쳐뿌고 그래 가주우 하으 으에아 한 동네 사럼드리이께네 구체도 어꼬 기양 너머가저이	그래 물어달라고 그러는 저 사람도 적고 또 뭐또 그것은 그만 장난으로 쳐 버리고 그래 가지고 한한동네 사람들이니까 구처도 없고 그냥 넘어가지
야다너 치지	야단은 치지
그러치예	그렇지요
응 야단치유 너머어우	응 야단치고 넘어가고
고다으메 그릉 게 마내찌	그다음에 그런 게 많았지
마내썩	많았어
또 그러코 인제 저 머로 집상총 거튼 데는 우리 동네뿐 아이래 아문 데을더 거 머 그 집썽엄 무섬 머 박까든찌 깅가든지 머 유가든지 유씨든지 하응 그동네 집썽초니 이끄드	또 그렇고 인제 저 뭐냐 집성촌 같은 데는 우리 동네뿐만아니라 아무 데나 그 뭐 그 집성촌 무슨 뭐 박가든지 김가든지 뭐 유가든지 유씨든지 하는 그 동네 집성촌이 있거든
끄은 데 마이 모에 산 데늠 사웨라꼬 와 장갸옴 사럼 인제 우리 일가 딸뜰한데 장애 그 손니미 옴므 새소니러 그래 그 사럼	그런 데 많이 모여 사는 데는 사위라고 왜 장가온 사람 인제 우리 일가 딸들한테 장가 그 손님이 오면 새손이라 그래 그 사람을
사으 새소니래	새 새손이야
거게 모에먼 이 인제 으 사웨드리 으 오먼 거어 가서 은녀 사웰 데루 장난뜽녀 압체 가주 인제	거기에 모이면 이 인제사위들이오면 거기에 가서인제 사위를 데리고 장난쳐 앞세워 가지고 인제
거 이거 떠 인 달또 자아머거	그 이것 또 인제 닭도 잡아먹어
사웨럴 압소워 가주고	사위를 앞세워 가지고
거 이 저 드 장나니라	그 이 저 저 장난이야
그래데엔네 그 지베 가서믕 그 지비선 위 달기 왱 게로 그먼 어어이 그 사아가 자보와따 크런 장난초루 그래 가주우 가치 그결 꼬아 머꼬 노기도 하고그런 냬기 이서	그래 됐는데 그 집에 가서는 그 집에서는 이 닭이 왠 것이냐 그러면그 사위가 잡아왔다 그런 장난조로 그래 가지고 같이 그것을 고아 먹고놀기도 하고 그런 예가 있어
금 머 별 짱나니 마네	그 뭐 별 장난이 많아
마능게요	많아요
응 흥이 그릉 게 마네	응 흔히 그런 게 많아
일뜨암 머 그때 머 다른 노리도 어꼬 또 머글 꺼또 어꼬 그러니까	일단 뭐그때 뭐 다른 놀이도 없고 또 먹을 것도 없고 그러니까
을 그르 다른 노리도어 어꼬 또 쌔거아 집썽초니 지 절믄 사럼드리 마카 모에이 이쓰께 으데 나가도 한동네 마카 다 이씸 모에무 머 이심 녕삼심 명슥 데이께네 으 장난도 치고 그른 녜거 마네	어 그래 다른 놀이도 없없 없고 또 저아 집성촌이 저 젊은 사람들이 모두 모여서 있으니까 어디 나가도 한 동네 모두 다 있으니 모이면 뭐 이십 명 삼심 명씩 되니까장난도 치고그런 예가 많아
또 사위 가틍 경우넌 머 별로 머라 칼 수도 어꼬	또 사위 같은 경우는 뭐별로 뭐라고 할 수도 없고
그러치	어 그렇지
새손이니까 그지예	새손이니까 그렇지요
허 그이까 새소잉끼따 그증 긷 그래가주 인제 압싸아 가주 장난한 수도 이써 그 사웨르 압싸아 가주	어 그러니까 새손이라서 그저 그 그래서앞세워 가지고 장난하는 수도 있어 그 사위를 앞세워 가지고
그더으미 그 어르심 보리찌비나 버리찌비나 밀찝 까틍 경우너 주로 머에사용해씀미까 이 동네에서너	그다음에 그 어르신 보릿짚이나 보릿짚이나 밀짚 같은 경우는 주로 뭐에 사용했습니까 이 동네에서는
버리찜 밀찍 꺼틍 거는 주로 퉤비에 마구에 여어 가주고 마구 거르멀 맨드러찌	보릿짚 밀짚 같은 것은 주로 퇴비에 마구에 넣어 가지고 마구 거름을 만들었지
마구 거르음 맨드구 또 머 머탄 지베는 으언 나무로도 때꼬 나므 므어썽어어어 브어케 굼불또 여코 그래도 써꼬 먿 다른능 그 그래배께 쓴능 느쓰 썬능 건 업따	마구 거름을 만들고 또 무엇한 집에서는나무로도 땠고 나무 뭐 써 부엌에 군불도 넣고 그래도 썼고 뭐 다른 그 그래밖에 쓴 쓴 쓴 것은없어
근 머이 짐 니능 거또 아이코 하이 때므레	그것은 뭐 집 이는 것도 아니고 하기 때문에
머 이렁 보리찌비나 밀찝 이렁 거너 그 방서이나 이렁 거늠 머 암 만드러써	뭐 이런 보릿짚이나 밀짚 이런 것은 그 방석이나 이런 것은 뭐 안 만들었습니까
아이찌여 그는 방성 맨등 거언 지푸로 만드고 밀찝버리찍 거틍 거넝이 그그는 여어섬 머어 그 그릉 기술또 어꼬 공예푸멀 몸 맨드러 그언녀	아니지요 그런 방석 만드는 것은 짚으로 만들고 밀짚보릿짚 같은 것은 그것은여기에서는 뭐 그 그런 기술도 없고 공예품을 못 만들어 그것은요
응 거 그 그릉 거는 머 봉테이도 몸 맨드고 머 소구리도 모 싸암 몸 맨드고 주로 고마 퉤비 화모그로 써찌 머	응 그 그 그런 것은 뭐 바구니도 못만들고 뭐 소쿠리도 못 싸 못 만들고 주로 그만 퇴비 화목으로 썼지
그으구 굼불 때꼬	그리고 군불 때고
검 머 저으 걷 또 어여 소 여물 싼는 데도 쓰고 쌈는 데도	그 뭐 저 그또소 여물 삶는 데도 쓰고 삶는 데도
그래 써찌 머	그래 썼지 뭐
그다으메 그읍 그 응 곧 여기늠 머 옥쑤수나 이렁 거 강내이느 재배 안함	그다음에 그 그 응 그 여기는 뭐 옥수수나 이런 것 옥수수는 재배 안 합니까
시머데 이그	심여요 여기
강내이는 재배해요	옥수수는 재배해요
그은 머으 거이가 대량으론 안 허이	그것은 뭐 거의가 대량으로는 안해요
요즈멈 머 어여 그으겓 대량으로 한 데 익 이뜨라끄 저 우여 올라가다 보이껜 마에지에 한 서너 마지이 덴 데 점먹 강내이 다 해 거주	요즘은 뭐그게 대량으로 하는 데가 있 있더라고 저 위에 올라가다 보니까 말이지 한 서너 마지기 되는 데 전부 옥수수 다 해 가지고
그으또 인제 에 머으 으 거 달리 쓰능 거 아리으 그르애 대량으로 하능건 사료로 쓰드라꼬	그것도 인제뭐그 달리 쓰는 게 아니고 그렇게 대량으로 하는 것은 사료로 쓰더라고
허구 억 그걸 마구 비 가주 인제 고마 그 저 윽 윽 그 머로 으 어으 슫어 이래 둘뚤 마라 가주오 마리찌 으 소 메기 하드라꼬 본네으	그래그것을 마구 베 가지고 인제 그만 그 저어 그 머냐어 스이래 둘둘 말아가지고 말이지소 먹이 하더라고 보니까
소 사료 소 메기로	소 사료 소 먹이로
응 으 응 보충을 하드라꾸	응응 보충을 하더라고
소 메기로 하구 그르치 아늠 인제 이른 찌 지 꺼튼 데는 저 바 까 어엳찌 집 뜨레 이리어 담 밑 머 언 언 은 저 박 기사리 으 끄 그른 두루 나감상 더러 시머 가주우 찡여	소 먹이로 하고 그렇지 않으면 인제 이런 집 집같은 데는 저 밭 가지 집 뜰에 이리 담 밑 뭐어저 밭 귀퉁이 어그 그런 데로 나가면서 더러 심어 가지고 짓고 음
마스로 먹찌	맛으로 먹지
거 여기늠 머 다름 머 트굥 장무른 괃씨리나 이렁 거는 별로 하능 게 업쓰미까 이 동네는	그 여기는 뭐 다른 뭐 특용 작물은 과실이나 이런 것은 별로 하는 게 없습니까 이 동네는
트굥 장물로 과실 가틍 겁 과이리 재배하능 걷	특용 작물로 과실 같은 것과일 재배하는 것
과실 거틍 건 여에 벨로우거 이에 지 써 옌나레 사과가 여어 메 찌피해쓰억	과실 같은 것은 여기에 별로 안 하고 여기 저 사 옛날에 사과를 여기에서몇 집 했어
과실 사가바치 사가바치 이썬데 그거 이 요샌 여거 그 사과가 잘 안 데드라꼬	과실 사과밭이 사과밭이 있었는데 그것 이 요새는 여기 그 사과가 잘 안 되더라고
기후가 타심 모얘이라	기후가 탓인 모양이야
그 병이 생기가주 낭게 불화뼝이랑 기 생기 가주우 사과가 반저미 생기고머 가치가 업써 가주우 으 다 비 뿌려따끄 연	그 병이 생겨서 나무에 반점병이라는 게 생겨 가지고 사과가 반점이 생기고 뭐 가치가 없어 가지고다 베 버렸다고 여기는
여는 트쑤한 응 과시른 업따꾸 여이는	여기는 특수한 응 과실은 없다고 여기는
거름 주로논농사하고 반농사먼	그러면 주로논농사하고 밭농사만
글지여 논농사 반농사 또 인저 과시라 꺼를 인저 이 위 수이 요샌 녀 수바 칸 사러미이 드러 만타꼼 메 찝 데드라꼬	그렇지요 논농사 밭농사 또 인제과실이라 할 것은 인제 이 참외 수박 요새는 여기 수박 하는 사람이 더러 많다고몇 집 되더라고
그르꼬 거 읻 쭈 주로 또 인제 축산 하는 사럼 소 메긴 사럼드리 소 메긴사럼드리 메 찝 이꼬 그래 다릉 건 머 여게 부어브로 하능 건 은 벨로 업따꼬 여게 마르에	그렇고 그 이 주 주로 또 인제 축산 하는 사람 소 먹이는 사람들이 소 먹이는 사람들이 몇 집 있고 그래 다른 것은 뭐 여기 부업으로 하는 것은어 별로 없다고 여기 말이야
혹씨 예저네 그어 이 받뚜기나 드리나 이러은 데 나늠 풀 이르미나 머 나물이름가 나물 가틍 그어 쫌 이 동네엗 머 어떵 기 주로 인는지 아시는 데로 꼬함 이야기해 주이소	혹시 예전에 그 이 밭둑이나 들이나 이런 데 나는 풀 이름이나 뭐 나물 이름 나물 같은 것 좀 이 동네에 뭐 어떤 게 주로 있는지 아시는 데로그 한 번 이야기해 주십시오
그래 흑 마자 그거으 그 얘기 그래	그래맞아 그것 그 이야기 그래
바뚝 꺼튼 데 가먼 논뚜게도 그에 이써이	밭둑 같은 데 가면 논둑에도 그게있어
바뚝 거떠이 이 양녁 사멀따레 감먼 쑤기 난더 쑤기랑 거	밭둑 같은 이양력 삼월에 가면 쑥이 난다 쑥이란 게
쑤기 그걸 뜨더 가주우설랑 그 멉 억 그 갈글 무쳐가주 마아찌 밀깔글 무쳐가주우 마알찌 그 뭄 머 그래가주 쪄 가주고 채바네다 채바니러 근 데다 이랟쪄 가주고 그래여읍 그걸 머으멈 마시따꼬 그에요	쑥이 그것을 뜯어 가지고서는그 뭐그 가루를 묻혀서 말이지 밀가루를 묻혀 가지고 말이지 그 뭐 뭐 그래가지고 쪄 가지고 채반에다 채반이라고 그러는 데다 이래 쪄 가지고 그래 그것을 먹으면 맛있다고 그게요
이 요줌 배가 부른 사홰라도 그염 마시써 그게	이 요즘 배가 부른 사회라도 그게 맛있어 그게
또 그 긍강에 조타네 그게요	또 그 건강에 좋다네 그게요
조아가주 그래 쪄 멍 사러미 망코 그 쑤걸	좋아 가지고 그래 쪄 먹는 사람이 많고 그 쑥을
또 그르치 아음 그 쑤걸 뜨더 가주설랑 요주먼 냉장고 고마 아네 노이 마래쌀마 가주오 쑤걸 쌀마 가즈여 쌈는당 거 은저 불 때 가조임 이킨담 마려 인제 에 소테다 가마소떼 쌀마가주 그누믈 씨이가주 좨기로 뭉치드라꼬	또 그렇  지 않으면 그 쑥을 뜯어 가지고설랑 요즘은 냉장고 그만 안에 놓으니 말이야 삶아서 쑥을 삶아 가지고 삶는다는 게 인제 불을 때 가지고 익힌다는 말이야 인제 어솥에다 가마솥에 삶아 가지고 그놈을 씻어 가지고 좨기로 뭉치더라고
좨기르 짜 가즈설렁 냉장고 보과늘 하드라꽁	좨기로 짜 가지고설랑 냉장고에보관을 하더라고
냉장고이 여어가주 나와뚬머 올래 올보메 그래 나씨먼 이 인제 숙 저 뿌고또 인저 올 파럴 구월 시워레능 이 쑤기 조오 몸 머꺼드 너무 씨우꼬 해 가주고	냉장고에 넣어서 놔두면 올해 올봄에 그래 놨으면 이 인제 쑥 져 버리고 또 인제 올 팔월 구월 시월에는 이 쑥이 좀 못 먹거든 너무 쓰고 해 기지고
글때 인제어 두꼼 함 뭉찌 한 재기씽 내 가주고 인제 방까네 가주 가	그때이제 조금 한 뭉치 한 좨기씩 내 가지고 이제 방앗간에 가지고 가
요제 떡찌베 떡빵까니르 근 데 가	요새 떡집에 떡방앗간이라 그러는 데 가
떡빵깐네르 감멍 그놈하꼬 으 쌀라코 부등어 한 떼 고마 빠아 뿌드라꼬	떡방앗간에 가면 그놈하고살하고 부어서 한 데 그만 빻아 버리더라고
빠아 뿌이께 쑥떠기 데드라 꾸우게	빻아 버리니까 쑥떡이 되더라고 그게
쑥떠으거 또 구러치 아느멍 그걸 인제 기여레 예를 뜨러 가주 인제 시비이시 이 시비럴 시비월리 이뤌 이월 이 사이 인제 머 아므꺼또어어슬 때그글가주 또 짜아가주 쑥떡뜨 해앰 머꾸	쑥떡을 또 그렇지 않으면 그것을 인제겨울에 예를 들어 가지고 인제 십이 십 이 십일월 십이월 일월 이 사이에 인제뭐 아무것도없을 때 그것을 가지고 또 빻아 가지고 쑥떡도 해 먹고
또 구걸 또오 갈글 무쳐 가주서러이 찌드라꼬이	또 그것을 또 가루를 묻혀가지고설랑 찌더라고
쩨이께네 으 그거뚜 마시드라꾸 쑥떠기라 그능 거	찌니까그것도 맛있더라고 쑥떡이라 그러는 것
크래 머꼬	그래 먹고
어 읍 그 그 쑤기라 그능 게 그 농촌네느 사용 가치가 괭자이 만타 구이께네 그	어어 그 그 쑥이라 그러는 게 그 농촌에서는 사용 가치가 굉장히 많다 그러니까 그
그른데 그 그게쓰 농초뿐 아이래 여읻 지베 요새느 인제 도시 나가 인넌 사람드이 그거 쩜 해 달라꼬 자꾸 우 부모들한떼이 전활 한다꼬	그런데 그 그게농촌뿐 아니라 여기 집에 요새는 인제 도시 나가 있는 사람들이 그것 좀 해 달라고자꾸부모들한테 전화를 한다고
올개 그이 그 쑤걸 쫌 마이 뜨더 달라꼬 마에지여 크래 거 부탁또 하고 그도시 사름도우 그걸 조아 근데이	올해 그 그 쑥을 좀 많이 뜯어 달라고 말이지요 그래 가지고 부탁도 하고 그 도시 사람도 그것을 좋아 한데요
그 이거 겅강 시푸미라네여	그 이것 건강 식품이라네
그이 참 조타이더 그게	그게 참 좋답니다 그게
그여 여즘 사럼 이으 임마또 땡게고 으 겅강도 조코 그른데으 끄 그릉 기고	그 저 사람 이 입맛도 당기고건강에도 좋고 그런데 그 그런 것이고
그 밤며네 또 인제 한 기열 한 으으은 찌 양녁 거염 이럴 이월 고 사이에 인제 받뚜렁 바테 뜨 나먼 쑤기 이 참 이 언 나섀이랑 기 이써 나새이	그 반면에 또 인제 한 겨울 한저 양력 그 일월 이월 그 사이에 인제 밭두렁 밭에 또 나가면 쑥이 이 참 이냉이라는 게 있어 냉이
나새이라 그는 나무리 인데 그 나물또 인제 정월따레 뎀먼 정월 보름저께가머 인제 으 보루무 신다꼬 인제 그 보룸 으으은 나무르아 그래검저쓰 어이나이 뜨드루 가	냉이라 그러는 나물이 있는데 그 나물도 인제 정월이 되면 정월보름쯤에 가면 인제보름을 쇤다고 인제 그 보름나물이라 그러면서냉이뜯으러 가
인제 부인들 처녀드리 나가 바테 가주 인제 이릉 거 으여 너으 흐끄 가르카럴 들고 나거주 고놈 요리 뽀꼬 따드머 가주설렁 그걸 린제 콩까루우라 그러여느 인제 콩깔글 빠아 농 걸 무쳐 가주고 구걸 끼레 머꼬 응 그게 마시따꼬나새이꾸기라 그능	인제 부인들 처녀들이 나가서 밭에 가서 인제 이런 것어흙 칼 칼을 들고 나가서 그놈을 요래 뽑고 다듬어 가지고설랑 그것을 인제 콩가루라 그러는 여기는 인제 콩가루를 빻아 놓은 것을 묻혀 가지고 그것을 끓여 먹고 응그게 맛있다고 냉잇국이라 그러는
그르코 금 머거 두이 다능 멍으 기 웨드 내 모른 나무리 만타꼬요	그렇고 그 뭐그 저 다는 뭐 그 외에도 내가 모르는 나물이 많다고요
다 알 쑤느 어코	다 알 수는 없고
그르코 또 여 속새라 그능 게 이써	그렇고 또 여기 속새라 그러는 게있어
씀바구라 그르기기도 하고	씀바귀라 그러기도 하고
그 그거또 인제 뿌리쨉 뽀버 가주언 논뚜럭 바뚜게 거이 다 이딱 그릉 거으	그 그것도 인제 뿌리째 뽑아 가지고 논두렁밭둑에 거의 다 있다고 그런 것
그느믈 뽀바 가주고 여흔 우리지베 보이께네 그걸 뽀바 가저이 이 이래 칼로드엽 뿌리느 이래 따듬뜨라꼬 이래 이으 허 헐라꼽 뻬끼 뿌고 씨이 가주설랑그걸 머설쩍 쪄 가주우 마리야 그러 무쳐 노이께네 밤마시 쩌 이 졷트라꼬 그게	그놈을 뽑아 가지고 여기 우리집에 보니까 그것을 뽑아 가지고 이 이래칼로 저 뿌리는 이래 다듬더라고 이래 이 흙 흙하고 벗겨 버리고 씻어 가지고설랑그것을 뭐 이래 살짝 쪄 가지고 말이야 그래 무쳐 놓으니까 밥맛이 좋 이 좋더라고그게
어우 그걸 해 머이 씨구와 그넘 싸곰항 게 마리야	어 그것을 해 먹으니써 그놈이 쌉싸름한 게 말이야
그걸 또 기양 바로는 몸 모	그것을 또 그냥 바로는 못 먹어
울꽈야 데	우려야 돼
이래 따드마 가주어 저 무레 당가가조 메칠씨 당가 나둔다끄	이래 다듬어가지고 저 물에 담가 가지고 며칠씩 담가 놔둔다고
그래응 그 대기 쑤붐 마씅 거이 다 빠져	그러면 그 되게 쓴 맛은 거의 다빠져
그래응 그 그너믈 무쳐 노음녀 싸금항 게 그걸 은제 밤 머을 찌이겐 응어 고 한 저름씽 머으먼 반찬도 데고 고 또 싸곰항 게 밤마시 조아	그러면 그그놈을 무쳐 놓으면 쌉싸름한 게 그것을 인제 밥 먹을 때 응그 한 점씩 먹으면반찬도 되고 그 또 쌉싸름한 게 밥맛이 좋아
잉임마더 어시뿐지 그 머음 바비 더 머꼬 수꼬 이 임마시 땡겐다 근다구	이입맛이 없을 때 그것을 먹으면 밥이 더 먹고 싶고 이 입맛이 당긴다 그런다고
그 머 나무리 마아네	그 뭐 나물이 많아
돌라무리라 그응 거또 이꼬 머 요새 요 머 가이 분초 머 그릉 게 마네	돌나물이라 그러는 것도 있고 뭐 요새 요기 뭐 가위 부추 뭐 그런 게 많아
만체마는 그이 다 모도 그거는 은 응 그읃 따드마 가조우 거이가 다 해 머꼬 반찬도 해 머꼬 구래치 머	많지만은 그 다 모두 그것은응 그 다듬어 가지고 거의가 다 해 먹고 반찬도 해 먹고 그렇지 뭐
분초늠 머얼 분초러 함미까	분초는 무엇을 분초라 합니까
분초라 근능 게 요새 저 머로 자아 나능 거 머제 그게	분초라 그러는게 요새 저 뭐냐 장에 나오는 게 뭐지 그게
우리늠 분초라 근데	우리는 분초라 그러는데
아야 정구지	어 정구지
분초 정구지러 그은데 아이래 요새 자아 나능 게 그게 머 이 이르미틀러	아 분초 정구지라 그러는데 아니야 요새 장에 나오는 게 그게 뭐 이 이름이 달라
머어라 그래드라	뭐라 그러더라
그게래 이게 웨 이 읻 낄쫌한 파 거치 웨 이 이래 나응 거	그거야 이것왜 이 이 기다란 파 같이 왜 이 이래 난 거
아이 끄 이 이래 여이 뻐우 불가추 생가캐이 이기안 나	아니 그 이이래 이 그 갑자기 생각하니 이게 안 안 나
그게 아응아	그게 응아
가위늠	가위는
가위늠 멈미까	가위는
가위늠 머가 또 가위임미까 아까	가위는 뭐가 또 가위입니까 아까
가능 거는	가는 것은
아니 가위라고 핸는데 가이	아니 가위라고 했는데 가위
어이	어
분초 또 그 아까 머 이야기허이 하션능중에서 나물 이야기하심면서분초 그다임 머 가 가위 그러셤미까	분초 또 그 아까 뭐 이야기하 하신 것중에서 나물 이야기하시면서 분초 그 다음에 뭐 가 가위 그러셨습니까
아이래	아니야
분초라 그기도 하고	분초라 그러기도 하고
그꺼 엠 머 언 정구지러 까앵녀 우루 우리니 지 정구지러 그고 분초라그고 으 그 가라멍응 꺼 가라서 멍능 게거 초네선	그것뭐정구지라 그랬나 우리 우리는 정 정구지라 그러고 분초라 그러고그 갈아먹는것 갈아서 먹는 것이고 촌에서는
혹씨 머 이런 데 머구이피나 이렁 거또	혹시 뭐 이런 데 머위 잎이나 이런것도
머구이피 이찌	머위 잎이 있지
머군니피라 그능 거느 인제 습찐 바까나 농까에 가므 이릉 게이 끼단항 게인제 이 이릉 게 나온다꼬 그	머위 잎이라 그러는 것은 인제 습한 밭가나 논가에 가면 이런 게 길다란 게 인제 이 이런 게 나온다고 그
그게 은제머 머구채라 그 먹처이	그게 인제뭐 머위초라 그 머위초
여게늠 머구채라 그러그더	여기는 머위초라 그러거든
머구취라 그래가주 그걸 비가주 인제이그 응 엗 쯛 비 가주고 입싸군 짤러 뿌고 쌀마 가주여 껍떼이를 까이 덴다 꾸거	머위초를 그래서 그것을베 가지고 인제이것 응저 베 가지고 잎사귀는 잘라 버리고 삶아 가지고껍질은 까야 된다고 그것
껍떼이를 까 가주설릉 그거 가주 인제 나물또 무쳐 머꼬	껍질을 까 가지고설랑 그것을 가지고 인제 나물도 무쳐 먹고
거 그 아으 머 시워남 마시우 국또 끼러 머꼬	그 그뭐 시원한 맛이고 국도 끓여 먹고
그 떠 제사에도 그 은제 제사 지낼 찌 그 거 으 거으 그거뚜 쑤드라꼬	그또 제사에도 그 인제 제사 지낼 때 그 그그 그것도 쓰더라고
머군닙녜	머구취요
어어 머구취 가주 이래 써에	어 머위초 가지고 이래 써요
취 머우취로	취 머위초로
어어	어
그다으메 어르신 혹씨 이 추수할 때 에 예저네 탈곡하덤 방법하고 요좀 탈곡하늠 방버븐 쫌 마니 바끼어찌예	그다음에 어르신 혹시 이 추수할 때예전에 탈곡하던 방법하고 요즘 탈곡하는 방법은 좀 많이 바꼈지요
바께고 마고지	바뀌고 말고지
떠 이 예나렌 추수울 하기 뎀 마아쩽이 저네도 말해찌음멍 나라글 비먼 무노네는 나라글 삐먼 이 그글 추당 모으이께 이른 새끼를 이랜 나라글 하 하낟따 캐가주 이래 재가리 홀체거 이 기만찌 이만 함 빨 떼능 거 이랟 땅에무노네 땅 노코 나라글 삐 가즈그 크단하이 므은다 그 그	저 이 옛날에는 추수를하게 되면 말이지 전에도 말했지만 벼를 베면 무논에는 나락을 베면 이 그것을 추당으로 모으니까 이런 새끼를 이런 벼를 하 하나 딱 해 가지고 이래 재갈을 홀쳐서이 그만큼 이만큼 한 팔 되는 것 이래 땅에무논에 딱 놓고 벼를 베 가지고 커다랗게 모은다 그 그
그걸 무다니라 그랜다꽁	그것을 무단이라 그런다고
무다느로 무꺼가주 인제 이래 드어 탁 서와 노우먼 햐껌 무리 좀 뺀 디웨디여 한데선 지 저 나른다꼬	무단으로 묶어서 이제 인래 저 탁 세워 놓으면약간 물을 좀 뺀 뒤에 뒤에 한쪽에서는 져 져 나른다고
저 날러가주 인제 첨방 버튼 데 어덩이 므엠 이어근 도금 쪼그로 물 안 채앤 데 잘 마를 때 이 겹 벧 잘 뜨고 양지바른 데 가따 넌다꼬	져 날라서인제 냇둑 같은 데 어디 뭐 이 돋은 쪽으로 물이 안 차는 데 잘 마를 때 이 그 볕이 잘 들고 양지바른 데 갖다 넌다고
너능 게 인제그 그게 저 무다느로 기양 너는 집또 이꼬 또 구걸 피  이가주 고마 이르 쭉 피이 너능 게 이떠 빨리 마르러꼬	너는 게 인제그그게 저 무단으로 그냥 너는 집도 있고 또 그것을 펴 가지고 그만 이래 쭉 펴 너는 게 있어 빨리 마르라고
그램믕 그거는 인제 다 마르맘 무끌 찌이 사 사러미 요만항 이걷 타작따니라꼬이 요망 깽 깨 잉 깨땀마꾸 므이 요마꿈씀 뭉는다꼬	그러면 그것은 인제다 마르면 묶을 때 사 사람이 요만한 이것 타작단이라고 요만 깨 깨 이 깻단만큼 하게 요만큼씩 묶는다고
끄음믕 그걸 자꾸 무꼬 노으먼 또 디에서는 소바리 실릉 거또 이꼬 소도인제 멍엘 메이가주 마알찌에 그래가 실꼬 나르고 사럼도 저 나르고	그러면그것을 자꾸 묶어 놓으면 또 뒤에서는 소바리 싣는 것도 있고 소도 인제 멍에를 메가지고 말이지 그래서 싣고 나르고 사람도 져 나르고
끄넘머염 머우 구루마도 나르고 이에이 옌나렌 저렁 게웅기랑 게 미 업서쓰이께네	그러면은 뭐 수레로도 나르고 이 옛날에는 저런 경운기라는 게 뭐 없었으니까
그래 가따 노으멍 그 까주 인제 에 와랑와라 그능녀으 그 억그 그 우발로 발릉 게러 그어는녀	그래 갖다 놓으면 그것을 가지고 인제왕왕 그러는그어 그 그발로 밟는 거야 그것은요
그 그른 타자글 옌나렌 쫌 시매꼬	그 그런 타작을 옛날에는 좀 심했고
그걸로 해꼬 주로가	그걸로 했고 주로
으 탈고끼	어 탈곡기
요새느 또으 기양 머어 저 웅 탈고끼가 바로 나와 뿌이 마르야	요새는 또그냥 뭐 저탈곡기가 바로 나와 버리니 말이야
꿈 마 그 업 바인다라 그능 게 고마 이그 인 노네서 바로 비가주 구마 여엉 끄 가마이로 옴 무꼬 나와 쁘이께네	그 뭐 그바인더라고 그러는 게 그만 이것 이 논에서 바로 베 가지고 그만어 그 가마니로묶어 나와 버리니까
벼찌범 벼찜대르 나앙꽁 그 그래 탈곡또 요샌 머으 괜자이 쉬어이즘	볏짚은 볏집대로 나오고 그 그래 탈곡도 요새는 뭐 굉장히 쉬어
근데 옌나렌 또 그 그게 마리야 요새능 그 그그에 어인 이 저거 나라글음 비먼 그 머러 그저지 짜가치 훌쳐이께읻짜가찌라꼬 요렁 게 무꺼 농 기 이써	그런데 옛날에는 또 그 그게 말이야 요새는 그 그게이 저것 벼를베면 그 뭐라 그러지 벼훑이 벼훑이라고 요런 게 묶어 놓은 게 있어
생나라글 마리지으 비 가주어승 우섬 바쁘이께네 싱냥은 어으꼬 그루믈 이래이디언 나라글 한 대애 폭씨 무꼬 이래거 쭈 쿨룬따꾸 이래	생벼를 말이지베 가지고는 우선 바쁘니까 식량은 없고 그놈을 이래이래 벼를 한 대여섯 포기씩묶고 이래서 쭉 훑는다고 이래
이으 찌께라 그래 이걸	이것을 벼훑이라 그래 이걸
나락찌껠 맨드러가주 우어 우 웅 무 훌터 내가주 그너미 마르먼 그 나러글소테 야깐 쩌 부레	벼훑이를 만들어 가지고어뭐 훑어 내 가지고서 그놈이 마르면 그 쌀을 약간 쪄 버려
부럴 때 가주어 야깐 쪄 뿌먼늑 꾸와음 궏 찌 찐싸리 데어기랑 겍 그게라	불을 때 가지고 약간 쪄 버리면 그 그 찐 찐쌀이라는 게 그거야
그래더에 쪄가주 고마 에 베떼 야깜 말리어드 께 기양 이걸루 저 훌터가주말륜 나라근 한 즈 사나을씽 말랴야 데제만 이 쩌가주 항 건 하로나 이틀 말랴 뿜 다 돼	그래 쪄서 그만볕에 약깐 말리면 그 그냥 이걸로 저 훑어서 말린 벼는 한 저 사나흘씩 말려야 되지만 이 쪄서 한 것은 하루나 이틀 말려 버리면다 돼
그램므 그걸 방아 가서이 인 디딜빠아르 요새리 옌나레느	그러면 그것을방앗간에 가서 이 디딜방아야 요새는 옛날에는
부인들 남자드 인데 디들빠아 똑딱빠아다 찌이 가주고 응 그걸 린제 까불거 싸럴 해 가주우 으 바벌 해 머꼬	부인들 남자들 인제 디딜방아 똑딱방아에다 찧어 가지고 응 그것을 인제 까불어서 쌀을 해 가지고밥을 해 먹고
그 그으 뜽 으 싸리 글땐 참 싸리어리 싱냐익 귀얄 때니까 거 우선 말랴가주 머을 새미 어꼬 그래 생나라글 훌떠 가주고 그래 쩌 말랴 가주얻 바아 찌가주 싸를 맨드러 싱냥을 해따꼬	그 그 저쌀이 그때는 참 쌀이 식량이 귀할 때니까 그 우선 말려서 먹을 새가 없고 그래 생벼를 훑어 가지고 그래 쪄 말려가지고 방아 찧어서 쌀을 만들어서 식량을 했다고
그래 거 인저 머 모숭기하은 참 멈 머 어에 그 가을할 때으 그거 싱냐이위쏜 쪼체니꺼 그을로 인제 이 일꾼들 머르 밥또 해 주고 그래찌	그래 그 인제 뭐 모심기한 참 뭐 뭐그 가을할 때 그것 식량이 우선 쫓기니까 그것으로인제 이 일꾼들 뭐 밥도 해 주고 그랬지
그르 웨 탈고기랑 게 그르이 여러 가지래	그래 왜 탈곡이라는 게 그러니 여러 가지야
그음 므어 뚜디레 하능 거또 이꼬 마리지이 머 엉 그 그	그 뭐 두드려서하는 것도 있고 말이지 뭐그 그
그 그럼명 그 요즈먼 어째뜬 마니 편해져따 그지예	그 그러면 그 요즘은어쨌든 많이 편해졌다 그렇지요
엉 끄 평꼬 마고지으	어 그 편코 말고지요
끄른데 그르이 농사진능 게 요새 사러미 여 여 어디 저 언 이 이기 교수임도 여 다니 바찌만 저으 으 노가다 일한 사럼 메 디쩨 드레 사람 비엡띠까	그런데 그러니 농사짓는 게 요새 사람이 여 여 어디 저이 이게 교수님도여기 다녀 봤지만 저막일 일하는 사람 몇 있지 들에 사람 보이던가요
그르 겨 사람 여 농사진는 사러미 그만한 농사어 한 육칠심 마지이 한 배겨 마지이 너머도 사람 대여서쓰빼께 안 데	그래 그 사람 여기 농사짓는 사람이 그만한 농사 한 육칠십 마지기 한 백여 마지기 넘어도 사람 대여섯밖에 안 돼
그 사럼드리 기겔 가주 다 한다꼬	그 사람들이 기계를 가지고 다 한다고
여으도 요 농기게이 이앙기 와 이짜니 여도옹기	여기에도 요기 농기계 이앙기 와 있잖아 여기도
저래여이 저르므 인녀 다 써쓰이께 또륻 쩌르 나따 안족 자기네가 소니 바쁘고 하이께느 저그또 은제 읻 쩌 우선 저래 나뚜능 게라	저래 저놈은 인제다 썼으니까 또 저래 놨다 아직 자기네가 손이 바쁘고 하니까 저것도 인제 이 저우선 저래 놔두는 거야
인제 가을 농사 가을 은 데먼 저그 또 인저이 엄 보과늘 해이 데 기름칠하고 마이데	인제 가을 농사 가을되면 저것 또 인제보관을 해야 돼 기름칠을 하고 말이지
그애이 그 농사진능 기 머 사러앰 메 단 덴다꼬 인녀	그래 그 농사짓는 게뭐 사람이 몇 안 된다고 인제
에저느 그럼며너 탈곡 그 해 가주고도 어덷 말리 벼를말려가 어떠케	예전에는 그러면은 탈곡 그 해 가지고도 어디 말려 벼를말려서 어떻게 함미까어떻게 함미까
옌나레능 거 으	옛날에는 그 으
함미까 어떠케 함미까  아이지 그이 옌나레는 그래 나라그로 말륜다 어이께네	아니지 그 옛날에는그래 벼로 말린다 하니까
나라글 피 너러 말류능 거또 이꼬 또 무다느로 넘 말류능 거또	벼를 펴널어 말리는 것도 있고 또 무단으로 널어 말리는 것도
무단 말류능 건넌드 한 서러씨비 두베 준다꼬 까서 이게이	무단 말리는것은 한 서너번씩 뒤집어 준다고 가서 이게
이래이 이래 너르 나으떵 이래 베치 자르 두베도 말류꼬	이렇게 이래 널어놨다가 이래 볕이 잘 들게 뒤집어서도 말리고
그램 그 그 나락끄으게 벼찌베서 나러기 다 말라	그러면 그 그 벼 어거기 볏짚에서 벼 낟알이 다 말라
다 말라엉 코마 으게 탈고글 하먼 바로 고마 응 가마이 여어 가주고 정미쇼로 가주 가고	다 마르면 그만 이걸 탈곡을 하면 바로 그만 응 가마니에 넣어 가지고 정미소로 가지고 가고
거기 그엄면 탈곡 예저네 이럼 머 발른 탈고끼 까 이래 그 발꼬 하다 보며너 머 어기 거기에 뿍떼기나 이렁 거또 마이 나오지예	거기 그러면은 탈곡 예전에 이런 뭐 밟는 탈곡기를 가지고 이래 그 밟고 하다 보면은 뭐 어디 거기에 북데기나 이런 것도 많이 나오지요
거르지 뿍떼기 나오지읍	그렇지 북데기 나오지요
뽁떼기가 그래 인제 그 발른 탈고글 하고 우어 와랑와랑하능 그 기게 따 탈고글 하기 데먼 하나이 서 가저 꽉찌러 그르 옌날 이릉 이릉 걸	북데기가 그래 인제 그 밟는 탈곡을 하고왕왕하는 그 기계 탈 탈곡을 하게 되면 하나가 서가지고 갈퀴라 그래 옛날 이런 이런 것을
꽉찌르 가주 서울슬 끄러땡긴다꼬	갈퀴를 가지고 슬슬 끌어당긴다고
으르땡기먼 나르아기 끼 암 알배이느 그 떠러지고 껍떼이는 그 읻 지페야껀 덜 털레 나강 거는 이 꽉찌에 클레 나간다꼬	끌어당기면 벼 그 알 알맹이는 그 떨어지고 껍질은 그 이 짚에 약간 덜 털려 나간 것은 이 갈퀴에 끌려 나간다고
그럼 인저 뿍떠기를 그래 추우 마 가즈 한짜으럳 재인다꼬	그러면 인제 북데기를 그래 주워 모아 가지고 한쪽으로 잰다고
한짜으루 이래 미러 노으먼 그 인저 탈곡 찌 에 이여여 바로 나온 나라근 인저 탈고글 다 마치먼 으 거 으 커걸 언제 이래 으 그 부체능 게 이따꼬	한쪽  으로 이래 밀어 놓으면 그 인제 탈곡 저어 바로 나온 쌀은 인제 탈곡을 다 마치면그그것을 인제 이래그 부치는 게 있다고
키이라 그러	키라고 그래
키라 그려 까부능 키가 이셔따꼬 옌나레	키라고 그러는 까부는 키가 있었다고 옛날에
그늠 키를 가주고 한 사러미 이래 종가리러 그능 게 이써 이래	그놈 키를가지고 한 사람이 이래 종가리라 그러는 게 있어 이래
나무 사까래리 요새는 마래똔	나무 사까래야 요새로 말하면
나무 사까래거 낭그로 맨드에 넙뜨깡 이릉 에	나무 사까래가 나무로 만든넓적한 이런 게
그을로 히떡 두벤다꼬	그것으로 히뜩 뒤집는다고
이래 나라글 휘떡 뚜벰 문지가 퐁 나모 확 뿌체먼 근 나라간다꼬	이래 벼낟알을 히뜩 뒤집으면 문지가 푹 나면 확 부치면 그게 날아간다고
그걸 부체가지 또 저짜로 그으 뿍떼기르 점부 쓰르 낸다꼬 비로	그것을부쳐 가지고 또 조쪽으로 그 북데기를 전부 쓸어 낸다고 빗자루로
쓰러 내먼 그래 메 뻡 부체고느 그 문질 야깐 날리 뿌구는 말로 데 부는다꼬	쓸어 내면 그래 몇 번 부치고는 그 먼지를 약간 날려 버리고는 말로 대 붓는다고
함 말 두 말 해가 마 항 가마이 열땀 마리 드간다 꾸게	한 말 두 말 해서뭐 한 가마니에 열다섯 말이 들어간다고 거기에
항 가마이가	한 가마니가
나러기 열땀 마럴 대 여우먼 그 나락 항 가마이러 끈다구	쌀 열다섯 말을 대넣으면 그 쌀 한 가마니라 그런다고
잉 으 그럼 그래무꼬 내고 또 대이고 흐래 가주 인제 오늘 타자기머 이거 쩌기 쥐이니 머 한 사오십 성 나따 그먼 보통 옌나레는 함 마지게 너어그연 네 가마이 이 머끼도 쫌 바쁘다꼬	이그러면 그래묶고 내고또 대고 그래서 인제 오늘 타작이 뭐 이것 저기 주인이 뭐 한 사오십 석 났다 그러면 보통 옛날에는 한 마지기에 네 네 가마니를 먹기도 좀 힘들다고
그 그 글때는 비로가 귀해가주 마리지 기양 머 좀 억 그른데 비로 나오곤옴 므 대여서 까마이싱 머꼬 그랭이	그 그 그때는 비료가 귀해 가지고 말이지그냥 뭐 좀그런데 비료 나오고는뭐 대여섯 가마니씩 먹고 그랬지
요주멈 머 여덜 까마이 멍 데드 이꾸 일고 까암머 그르치머느이 글때느 네가마이 멍응 게 마이 머으떠 그르따구	요즘은 뭐 여덟 가마니 먹는 데도 있고일곱 가마니 그렇지만은 그때는 네 가마니 먹는 게 많이 먹었다 그랬다고
그 예를 뜨러 다섬 마지이기를 다섬 마지이르 금 여느 아만 은 함 마지이가 삼백 뼈이 함 마지이 포주기래	그 예를 들어 다섯 마지기를 다섯 마지기라 그러면 여기는 아마한 마지가 삼백 평이 한 마지기 표준이야
이 다섬 마지이라 그먼 사 모 시보 그르이께 천오백 평이 이 마지기이 그 평수라꼬	이 다섯 마지기라 그러면 삼 오 십오 그러니까 천오백 평이 이 마지기 그평수라고
그래 이 언 다섬 마지이만 네 가마니 사 오 이 이시비 네 가마이 치먼 시무  가마이먼 아이근녀 나락 잘 라따 그러따꼬	그래 이다섯 마지기면 네 가마니 사 오 이 이십 네 가마니 치면 스무 가마니면 아이고 벼 잘났다 그랬다고
엉 연 올 온느 올 롱사 괜차이 지이따 그르따꼬	어올 올 올해 농사괜찮게 지었다 그랬다고
그래고 인제 그걸 다 마친 디에능 급 뿍떼이러 그능 거늠 마는 지베는 쪼매난 지베는 쪼매 한 대앰 마지인 너댄 마지 지뜬 지베능 그 그날 구마 타장바트머 그 이튼날 그넘 떠 말랴가주 구마 베떼 마당아 피 는다꼬	그러고 인제그것을 다 마친 뒤에는 그 북데기라 그러는 것은 많은 집에는 조그마한 집에서는 조금 한 대여섯 마지기 너댓 마지기 짓던 집에는 그 그날 그만 타작 같으면 그 이튿날 그놈을 또 말려서 그만 볕에 마당에 펴 넌다고
그려 꽈쩌르 글 이래 너르 가주고	그래 갈퀴로 그것을 이래 널어 가지고
그르 다일 말랴가주 그 이튼날 고마 타자그어 으 도리깨질로 곰 뽀 뽁떼기 타자칸다꼬	그래 당일 말려서 그 이튿날 그만 타작그도리깨질로그만 북 북데기 타작이라고 한다고
뿍떼겨 도리깨르 그능 게 인젱 이래 넹기 쳐가즈 때리응 거	북데기 도리깨라 그러는 것은 인제 이래 넘겨 쳐서 때리는 것
끄 그을러 인제 뚜드레먼 그 나라기 부터뜽 게 떠러진다꼬	그 그것으로 인제 두드리면 그 낟알이 붙었던 게 떨어진다고
떠러지응 그걸 인제 뿍떼이 타자기라 근데 그걸 인제 다 마치가주 인제 꽉찌루 또 뻐으끄 그래 메 숨베를 뚜드레먼 거이 다 떠러져다 시푸멈 꽉찌루 또거 끄른다끄 이래	떨어지면 그것을 인제 북데기 타작이라 그러는데 그것을 인제다 마쳐서인제 갈퀴로 또 긁고 그래 몇 번을 두드리면 거의 다 떨어졌다 싶으면갈퀴로 또 그 긁는다고 이래
끄먼 뿍떼이만 끌레 나오고 오 끄 처레고 나라긍 거 떠러져 이따꼬	그러면 북데기만 끌려 나오고그 추려 내고 낟알은 거기 떨어져 있다고
그래믕 거 뿍떼이 추려 내으 그거 역씨도 인제 에 케지를 해이 데	그러면그 북데기 추려 내고 그것 역시도 인제키질을 해야 돼
이래 어브 으 그 요새드 이녕 이래 약콱 부체먼 마리야 두베 주먼 뿍떼이갇 껍떼이가 나라나머 문지가 나라나검 그글 인제 나락시 주우 다웅 뿍떼이나라 캐따 그래가	이래어 그 요새도 이래 이래 확확 부치면 말이야 뒤집어 주면 북데기가 껍질이 날아가면 먼지가 날아가면 그것을 인제 낟알을 주워 담으면 북데기 낟알이라고 했다 그래서
그게 뿍떼이 타자기	그게 북데기 타작
아하 마저 뿍떼이 타자기라 그릉 게	아 맞아 북데기 타작이야 그런 게
혹시 그럼며너 보리는 여르메 하니까 보리 타자근 쫌 다름미까 어떠씀미까	혹시 그러면은 보리는 여름에 하니까 보리 타작은 좀 다릅니까 어떻습니까
버리 타작끼읻 다르지	보리 타작이 다르지
그 즈 버리 타자근 얻 한창 더울 때 요지가너이 조 미씨므 하 끼레아에	그저 보리 타작은한창 더울 때 요즘 좀 있으면 할 거야
여기 요새 인제 버리 비 가주고 요새도 버리 타자기 마리지 그으 응 기게로 하능 거느 쉽찌마느이 옌나레는 글 인제 점부 재이 나 둔다꼬	여기 요새  인제 보리 베 가지고 요새도 보리 타작이 말이지 그 응 기계로 하는 것은 쉽지만은 옛날에는 그것을 이제 전부 재 놓아 둔다고
떠 이기 대버네 안 해 타자글	또 이게 대번에 안 해 타작을
마르라꽁	마르라고
버리까랠 해가주 이래 버리 이래 은 드걸 맨드러 가드 버리뜨기라 그능 게낭글 비가주 버리뜨글 맨드러 이래 상각경으로	보릿가리 해서 이래 보리 이래어 덕을 만들어서 보리 덕이라 그러는 게 나무를 베 가지고 보리 덕을 만들어 이래삼각형으로
멕 거 은제 뜨 이래 노우먼 이 중가네 바러미 통하머 이으 버리거 빨리마른다꼬	음 뭐 그 인제 또 이래 놓으면 이 중간에 바람이 통하면 이 보리가 빨리 마른다고
끄름 한 달짱간씨그 드어레 그래 이 그 가래 나아 도옹	그러면 한 달씩 들에 그래 이 그 가리로 놓아 둬
나 두먼 다 마르먼 인제 그걸 뜨 인제 져다가 마다아 노코 그 머 역 도르깨러 한다꾸 구또	놔 두면 다 마르면 인제 그것을 또 인제 져다가 마당에 놓고그 뭐도리깨로 한다고 그것도
뿍떼이 타자카는 시그로	북데기 타작하는 식으로
옌나렝 끄으 이래 버릴 이래읍 마뿌터 노꼬 도르깨륻 때린다꼬	옛날에 그이래 보리를 이래 맞붙여 놓고 도리깨로 때린다고
때리응 그 버리가 으러진다꼬	때리면 그 보리가 떨어진다고
버리인 떠러지고 으 버리다음만 껍떼이먼 나망아인	보리는 떨어지고 그 보릿단만 껍질만 남아서
그거 역씨도 맹 마차이르	그것 역시도 또한 마찬가지야
그래 인네여 뻑떼이거 다 떠러지먼 그 또 추레 꽉찌루 추레 내구	그래 인제 북데기가 다 떨어지면 그 또 추려 갈퀴로 추려 내고
그거또 뿍떼이거 나와 맹	그것도 북데기가 나와 역시
뿍뗑이 나오고 움 버리 알 라오 그래믄 버리 아음먼 주우 당꼬 뿍쩨인 또재차 그으쁘 뿍떼이 타자글 해이 덴다 그그또 멍 버리도	북데기가 나오고 어보리 낟알 나오고 그러면 보리 낟알만 주워 담고 북데기는 또 재차 그 북데기 타작을 해야 된다 그것도 뭐 보리도
맹 나라 카는 시그로 그래 해 가주우 당꼬 그래 한더으 그	역시 벼 하는식으로 그래 해 가지고 담고 그래 한다고 그
그 밤며네 또 허 머 달리 하는 사럼더 이께찌여	그 반면에 또뭐 다르게 하는 사람도 있겠지요
머머 어인 타자기라 그능 게	뭐뭐타작이라 그러는 게
자기 시꾸끼리 쪼매끔 하능 거는 머 이 당일 곰마 방매이드 뚜드레 한 사음도 이써	자기 식구끼리 조금 하는 것은 뭐 이 당일 그만 방망이로 두드려 하는 사람도 있어
메 딴씩 안 데능 거느요	어 몇 단씩 안 되는 것은요
그르코 으 그그 인제 어어 끄 버리 타자그 마이 한 지베는 사람 해 가주고 노블 해 가주우 한다꼬	그렇고그것 인제그 보리 타작을 많이 한 집  에는 사람을 해 가지고 놉을 해 가지고 한다고
옌나른 노비라 그르따	옛날에는 놉이라 그랬다
노블 해가주 인제마 서너씨 드러드 막 소리 해 감 뚜드렌다꼬 그언	놉을 해서 인제뭐 서넛씩 들여서 막 소리 해 가면서 두드린다고 그
그르꼬 머 쪼매끔 한 지벤 머여 저겨 부지깨이 타작또 이따꼬 그엄 머 여이쪼매꿈 뚜드레가 메 딴씩 해가즈 멍능 그너	그렇고 뭐 조금 한 집에서는 뭐 저기 부지깽이 타작도 있다고 그 뭐 이 조금 두드려서 몇 단씩 해 가지고 먹는 것은
그럼므는 그 버리 가틍 경우너 여르메 하께네 마루운다 해도 장마철 가틈며너 비가 옴며너 잘 암 마르겐네예 그으게야	그러면은 그 보리 같은 경우는 여름에 하니까 말린다고 해도 장마철 같으면은 비가 오면은 잘 안 마르겠네요 그게
그래 가주욷 더글 해가주 가리 나끼 때이 비가 와도 우우우 우에는 상대베엔는 더퍼 나끼 떠므러 무리 안 드가	그래 가지고 덕을 해서 가리를 쳐놨기 때문에 비가 와도 위 위에는 상부에는 덮어 놨기 때문에 물이 안 들어가
이게 꺽찌론능 이 이래 데 이끼 때므 점 무리 새 뿌레	이게 끝으로는 이이래 돼 있기 때문에 전부 물이 새 버려
새브언 잘 말라	새면 잘 말라
그래 여 이래 이 새에늠 바라미 통하니까 그래 지 잘 마르지 잘 말라	그래 이 이래 이 사이에는 바람이 통하니까 그래 저 잘 마르지 잘 말라
잘 마르 그래 타자칸다그	잘 마르고 그래 타작한다고
그는 크게 그르케 해으떠 장 덕짱 덕 그걸 해 나 나이	아 거기는 크게그렇게 해 덕 덕 덕 그것을 해 놓아 노서
응 그르치어이	응 그렇지요
트럴 해 나끼 때므느에이 비거 와도 상과니 업써 장마가 저동	틀으해 놨기 때문에이 비가 와도 상관이 없어 장마가 져도
우만 꼬마 그 이 든 나래로 한 뜨 그 읻 더브언 두러 나 뿌먼 싸 겐 데먼더퍼 나 쁘언 자여니 미텐 뿌리 인는 데는 끄으 그 비가 안 드간닥 비가 와도	위에만 그만 그 이 그 이엉으로 한 그 그 이 두어 번 둘러 놔 버리면 싹 있는 데만 덮어 놔 버리면 자연히 밑에는 뿌리 있는 데는 그 그 비가 안 들어간다고비가 와도
혹씨으 콩 여 콩 타자금 머 쫌 다름미까 콩 타가건	혹시 콩 여기 콩 타작은 뭐 좀 다릅니까 콩타작은
콩 타자건 다르지	콩 타작은 다르지
콩 타자근 어뜨케 함미까	콩 타작은 어떻게 합니까
콩언 콩도 역쎼이 비스태	콩은 콩도 역시 비슷해
옌나렌넝 그 맹 도리깨르 핸데 콩언 뽀브멈 바떼서 인제 뽀바 가주우 이래가주 사라미 비능 거또 이따 거 나설 가주고	옛날에는 그 역시 도리깨로 했는데 콩은 뽑으면 밭에서 인제 뽑아 가지고 이래서 사람이 베는 것도 있다 그 낫을가지고
비 뿌능 거또 이꼬 또 우떤 싸르너 뽀바	베 버리는 것도 있고 또 어떤 사람은 뽑아
뿌리채러 다 뽀바가주 고마 에이거 콩따늘 무꺼 가주고	뿌리채로 다 뽑아 가  지고 그만 이것 콩단을 묶어 가지고
콩도 역씨 그래	콩도 역시 그래
그 이래 더글 맨는다꼬 이래 이읍 버리매이로	그 이래 덕을 만든다고 이래 이 보리처럼
더글 맨드러 가조 이 이 이짜끼짜거 서로이 자이 올리누가주 인제 그 우에다 나랠 더퍼 뿌고 그래 노으먼 이 사이로 엄 마르고	덕을 만들어 가지고 이이 이쪽저쪽을 서로 재어 올려 가지고 인제 그 위에다 이엉을 덮어 버리고 그래 놓으면 이 사이로마르고
콩언 인제에가알쭘 멍 응 가을게 추수하그드 그억 콩은	콩은 인제어가을쯤 뭐 응 가을에 추수하거든 그 콩은
인지 나락그 인니 인제 빌 무레 맹 쪼꿈 이따 그으또 뽀바	인제 나락어 그 인제 인제 벨 무렵에 역시 조금 있다 그것도 뽑아
뽀버가즈 그래 재이 노우먼 인제 나락쯛 타작 거이 다 마칙할 무레 콩 타저 마이 진느 이 저 미 또 콩 타자칸다꼬	뽑아 가지고 그래 재 놓으면 인제 나락 타작 거의 다 마칠 무렵에 콩 타작 많이 짓는 이 저 뭐 또 콩 타작한다고
쪼꿈씩 하능 거 므 대정도 어꾸 머 다일 하능 거뚜 역 그르침만 마는 지베바또 이 여러 마지이 부첸 지벤 콩까리도 크다꾸 므탕 거는	조금씩 하는 것은뭐 대중도 없고 뭐 당일 하는 것도 있고 그렇지만 많은 집에 밭도 이 여러 마지기부치는 집에서는 콩가리도 크다고 무엇한 것은
그르거 재이 나따이 기여레 해 그거늠	그래 그 재 놨다가 겨울에 해 그것은
웨냐 하게 데멍 그언 시비얼딸 이 이럴딸르 글때 떼먼 어먼 나리 추무여콩읻 잘 떠러진다꽁	왜냐 하게 되면 그 십이월 이 일월 그때 되면 얼면 날이추우면 콩이 잘 떨어진다고
도리깨 야깜 마즈어더 똑 쪽 또개지지망 축추칼 찐 잘 앙 깨기으더	도리깨에 약간만 맞아도 똑 쪽 쪼개지지만 축축할 때는 잘 안 깨지거든
그너미 그 인제 추와 가주어 어렁끼가 어먼 그 콩이 지 잘 떠러지익 때므에레 추울 때 한다 꾸은	그놈이 그 이제 추워 가지고 얼음이 얼면 그 콩이 저 잘떨어지기 때문에 추울 때 한다고 그것은
서딸 정월 글때 가서 인제 함 맹 으응 으 그어 으 버리매이르 마당에다 피이 노코 피 노코 여러에 두리 서 두리 서듬 머 으 머 마능 건느 암 마이 여러이 해이 데고 쪼맨항 건 머 혼자두 하고 두리두 하우 그래 인제 도르깨질르 뚜드린다꼬	어 섣달 정월 그때 가서 인제 한 역시 응그보리처럼 마당에다 펴 놓고 펴 놓고 여럿이 둘이서 둘이서든 뭐뭐 많은 건 아무래도 많이 여럿이 해야 되고 조그마한 것은 뭐 혼자도 하고 둘이서도 하고 그래 인제도리깨질로 두드린다고
뚜드렘멍 콩이 인제 바싹바쌍흠말라떠 그 으응 어러떵 게 콩이 똑똑 또개저이끄 까져 뿐다꽁	두리리면 콩이 인제 바싹바싹한말랐던 그 응 얼었던게 콩이 똑똑 쪼개져서 까져 버린다고
그럼 인제 콩만 누러케 낭꼬우 그으또 요씨 그래 구 어덴 뜩 꺽떼이으 콩껍떼이를 주우 가주 두숨두숨 나스로 이래 이래 가주여 은젣 대강 이램 무꺼  가즈어 내 노꼬 거으더 찌끄래이가 나온다꼬	그러면 인제 콩만 누렇게 남고 그것도 역시 그래 그 어디 저 껍질 콩 껍질을 주워 가지고 주섬주섬 낫으로 이래 이래 가지고 인제 대강 이래 묶어 가지고 내 놓고 거기에도 찌꺼기가 나온다고
덜 까징 게 이따꼬으	덜 까진 게 있다고
그으또 인제 꽉찌르 역씨 이래 가주우 한투운 낸 내몬다꼬	그것도 인제 갈퀴로 역시 이래 가지고 한쪽으로 내 내몬다고
그 내모라 노코 나먼지 그래 다 마치먼 그떠 이 옌나레는 이 그 요새던능거 풍구대가 나와 가주써리 옌나릉 그을로 부체찜만 옌나렝 거 키라 그능 거까주 이래 마카 이래 이 이래 워 부쳐따꼬	그 내몰아 놓고 나머지 그래 다 마치면 그것도 이 옛날에는 이 그 요새는 그 풍구가 나와 가지고서는 옛날에는 그것으로 부쳤지만 옛날에는 그 키라 그러는 것을 가지고 이래 모두 이래 이 이래 뭐부쳤다고
콩얼 이래가 이래 이으 끄어 지찌 으 그 머 으데 종가래러 그능 거 이러흔 나무까래 마리아 으이 여가 이리 히떡 뜨베음 콩이 이래 올러검므 문지가펑 난다구	콩을 이래서 이래 이 그 저저그 뭐 어디 종가래라 그러는것 이런 나무 가래 말이야 그것을 넣어서 이리 히뜩 뒤집으면 콩이 이래 올라가면서먼지가 퍽 난다고
끄렴 키로 확 부쳐 뿜 저 멀리 나간다꼬	그럼 키로 확 부쳐 버리면 저 멀리나간다고
그래음 저 그래 부쳐고 남능 거늠 콩반 그 역씨도 인제 멤 마리 어잉 에이음머마이 지은 지벤느 메 까마이 난노 시퍼가주 인제 가마이 대족칸다꽁	그러면 저 그래 부치고 남는 것은 콩만 그 역시도 인제 몇 마지기어음 뭐많이 지은 집에서는 몇 가마니 났나 싶어서 인제 가마니를 대조한다고
말루어 대 뿌꼬 인데 그 끄기 대능 게 재미때거	말로 대 붓고 인제 그 그게대는 게 재밌다고
함 마리요 두리요 서이요 함상 거 인쩨 헝이 노래 비스타이 해릉 넹겐더으	한 말이요 둘이요 셋이요 하면서 그 인제노래 비슷하게 해서 넘긴다고
열땀 말 하음제게 땅 너믕 겡거우 그랟 흑 커 그래 넹기고	열다섯 말 하면서 딱 넘은 것이고 그래그 그래 넘기고
므어탕 거느 인제 므 한 한 서너 대 한 머 대여섬 말씽 난 지벰 머 아이구머 그 그 두 말 라따 서 말 러따 콩을 그래고	무엇한 것은 인제 뭐 한 한 서너 대 한 뭐 대여섯 말씩 난 집에서는 뭐 아이고 뭐 그 그 두 말 났다 서 말 났다콩을 그러고
그래헤 그래따꾸 크게 이게 끄게	그래 그랬다고 그게 이게 그게
옌날 소리뚜 참 니	옛날 소리다 참 이
요새늠 머으 그 끄 오 콩이 마내더 기에가 이서이 마에저 거 여 뿜 머 트루루해 뿌머 껍떼인 껍떼이 나아 콩 콩알때루 나와 뿌이 구마 대벙 끄게 십따꼬요샌	요새는 뭐 그 그콩이 많아도 기계가 있어니 말이지 거기 넣어 버리면뭐 드르륵해 버리면 껍질은 껍질대로 나오고 콩은 콩대로 나와 버리니 그만 대번에그게 쉽다고 요새는
옌나렝 그게 그역 콩 타작 꺼틍 거는 기여레 하이 덜하저 버리 타작 깐능  거 참 애멍은다꼬 남	옛날에는 그게 그 콩 타작 같은 것은 겨울에 하니까 덜하지만 보리 타작 같은 것은 참 애먹는다고 참
삼복찌가네 으엳 타자글 해 바에 그게	삼복지간에타작을 해 봐요그게
뜨거블 때니 그러찌에	뜨거울 때라서 그렇지요
요새 좀 이시음 한다꼬 타자 낀제	요새 좀 있으면 한다고 타작 인제
버리 타작	보리 타작
따멀 찔 수건 메머 수거니 드멍덤 다 전다꼼	땀을 질 수건을 매면 수건이드문드문 다 젖는다고
먿 드이 옌나렌능 그 그어 머여 읻 이이 삐기 베옫 비스탕 거 이으 득쳐오시라 근늗 따모시러 거 즈 베를 가주 마리 잠배이 오시라꼬 베르 가주오 익그 이그 이 일꾼들 임는 장배이오시 이르 이르 므 이릉 그일 잠배이 오시라 근데 베로 맨드고이 요만찌음 삼베 해 가저인 내 오 꺼등 요런 사멘 요쯤 데이끼 아나	뭐 등이 옛날에는 그 그 뭐 이 이 베 베옷 비슷한 것 이 득쳐옷이라 그러는 땀옷이라 그 저 베를 가지고 말이야 잠방이라고 베를 가지고 이 그 이것 이 일꾼들 입는 잠방이가 이런 이런 뭐 이런 것을 잠방이라 그러는데 베로 만들고이 요만큼 삼베 해 가지고 내 옷 같은 요런 소매는 여기쯤밖에 되지 않아
거 은지으 베로 맨드러 노이꺼 다 어레이지 머이	그 인제 베로 만들어 놓으니까 다 얽어지지 뭐요
그느미 덤벅더먹 다 져저 그래도 머	그놈이 듬뿍듬뿍 다 젖어 그래도 뭐
그른 타저캐으 사우저	그런 타작해서 살았지
무넌 워넌 뜨거우니까 나리 그지예	물론 워낙 뜨거우니까 날이 그렇지요
그이겨 더운너금 삼복찌가네 그으 떠 겨 그 타작해 바여 그 얼마나 떠웅	그래 더우니까 삼복지간에 그 또 그 그 타작해 보면 그 얼마나 더워
고 이썯 더운데 그게요	가만 있어도 더운데 그게요
그 옌나레 사라나온 사럼들 참 생가킴머 불쌍해	그 옛날에 살아나온 사람들참 생각하면 불쌍해
요새 사람드릉이 그래두 농사진 사러미 머 요새 농사지은 사람드른 호 호강스로온데 요새 사름 그 농사라 안 내 버리로 아라	요새 사람들은 그래도 농사짓는 사람이 뭐 요새 농사짓는 사람들은 호 호강스러운데 요새 사람 그 농사로 안하고 벌이로 알아
꺼르스 옌나레느 요주음먼 얻째뜬 예저네 점부 사람 히므로 다 해따 그지에	그래서 옛날에는 요즘은 어쨌든 예전에 전부 사람 힘으로 다 했다 그렇지요
히므로 다 해꼬	힘으로 다 했고
요새 사람드런 옌날 사람드런 어어틍 으염 미 농초네 농사지이가 쪼꼼 밥수리나 머꼬 살고 부자 하는 사럼드리 그게 나미 볼 때이 요새드 맹 그 돔 버러가 잘사는 사암드에 머 수끼 버는 사르미쎅 이껜니껴	요새 사람들은 옛날 사름들은어 뭐 농촌에 농사지어서 조금 밥술이나 먹고 살고 부자라 하는 사람들이 그게 남이 볼때 요새도 역시 그 돈 벌어서 잘사는 사람들이 뭐 쉽게 버는 사람이야 있겠습니까
옌나레는 그 농사나 볌 마찡이낟 저 지이 가주우 머 어윽 백 석 으 한응 그 이 이백 썩 칸다 근 사암드리 그 우때 어른드느 가이 굴머따꺼 바에 난볼 때	옛날에는 그 농사나 몇 마지기나 저 지어 가지고 뭐백 석한 응그 이 이백 석 한다 그러는 사람들이 그 윗대 어른들은 가히 굶었다고 봐요 나는볼 때
그른데 농사르 짐 함 마찌이게 싸리 한 한 요새르 말하 끄음마 한 항 가마이 나와따 그머 그너믈 가주설라 시꾸이 요랑을 해 가주우 갱주기랑 게 이써이	그런데 농사를 지으면 한 마지기에 쌀이 한 한 요새로 말할 것 같으면 한 한가마니 나왔다 그러면 그놈을 가지고설랑 식구가 요량을 해 가지고 갱죽이라는 게있어요
갱주글 써가주 콩기름 녀쿠 해가주으 바블 멈므 싱냐이 마이 데이께느마래	갱죽을 쑤어서 콩기름 넣고 해 가지고 밥을 먹으면 식량이 많이 되니까 말이야
그래 가즈여 그글 싸를 일 려네 항 가마이 두 가마이 그 그겨 나므믕 그걸파라 가주고 장내도 늘구고 돈도 늘곡 캐 가즈으 그래 가주굳 하은 하 마지이사고 밤 마지 사고 이래 가주우 끄으게 마아 가주설랑 머으여 엉 거 이 쪼꿈잘사는 사름더 이써꽁 그래따구	그래 가지고 그것을 쌀을 일 년에 한 가마니 두가마니 그 그것 남으면 그것을 팔아 가지고 장리도 늘리고 돈도 늘리고 그래 가지고 그래 가지고 한 한 마지기 사고 반 마지기 사고 이래 가지고 그게 모아 가지고설랑 뭐그 이 조금 잘사는 사람도 있었고 그랬다고
근데 요새 농사진 사람드럼 일 려네 티끌 모아이 옌날 사렁드릉 쪼매끔 므악트라도 알뜨리 하자거 티끌 모아 태사니러능 말 시그로 사라와끄더	그런데요새 농사짓는 사람들은 일 년에 티끌 모아 옛날 사람들은 조금씩 모으더라도 알뜰히 하자고 티끌 모아 태산이라는 말 식으로 살아왔거든
근데 요새아 사른드능 티끌 모아 태사이라 긍 거느 근 멀리 가 쁘래써 하마	그런데 요새 사람들은 티끌 모아 태산이라 그러는 것은 그것은 멀리 가 버렸어벌써
웨냐 함 뻐네 하로 농사을 지먼 며 첨마 넘 버러에 데능 게러	왜냐 한 번에 한해 농사를 지으면 몇 천만 원 벌어야 되는 거야
그까지 쪼매항 거늠벙 거또 아이래	그까짓 조그마한 것은번 것도아니야
그깐니이 그 그깐니 그이 도늘 개코도 엄는 사럼드리 마려지 이 그 그얘 돈 첨마 너기 이첨마 널 우수히 아래 요새 사람드리으	그까짓 그 그까짓그 돈을 개코도 없는 사람들이 말이지 이 그 그 돈 천만 원 이천만 원을 우숩게알아 요새 사람들이
그 사럼드리 농사가 만해가주 마리지 자기 농살 다 해가저 그만찜 한 사랑끄어뜨믄 조키두 바	그 사람들이 농사가 많아서 말이지 자기 농사를 다 해 가지고 그만큼 한 사람 같으면 좋게도 봐
아이 굼 모 구마냠 데지 므	아이 그 뭐 그만하면 됐지 뭐
나무 농사지이가주 마애지이 그귿 도지 이 도지 쩌 으 끄기 여 옌나르머 소자기라 근데 여드먼 도지 제도구더 나무 해 쫌 함 마지기 두 가마이 머 으요 항 가마이 도지 주고 그래가주 멍능 거 옌날 때멈 기양 멍능 게지머	남의 농사지어서 말이지 그 도지 이 도지 저그 옛 옛날에는 뭐 소작이라 그랬는데 요즘은 도지 제도거든 남의 것 좀 한 마지기 두 가마니뭐한가마니 도지 주고 그래 가지고 먹는 것 옛날에 대면 그냥 먹는 거지 뭐
옌나름 반씽 농기 머어끄더	옛날에는 반씩 나눠 먹었거든
두 가운나 하능 여이 쥔 는 주인 항 가마이 내 항 가마 이랜데 요새늠 보멈 마에찌에 그게 인제 이 직뿌끄미라그 또 나오그더 어샌너	두 가마니 한 것주인주인 한 가마니 내 한 가마니 이랬는데 요새는 보면 말이지 그게 인제이 직불금이라고 또 나오거든 요새는
함 마지이이끼에 항 가마이 깝 거이 체	한 마지기에 한 가마니 값 거의 쳐
그름믄 쌀로 주인 항 가마이 주공 직뿔쩨 지 항 가마이 따베이 지인 기양공짜배이 멍능 게러 시방언	그러면 쌀로 주인 한 가마니 주고 직불제 자기 한가마니 따니 자기는 그냥 공짜배기 먹는 거야 시방은
다 므음상도 그른데 그 사러미 도을 메 첨마 넘 버러가주 마르제 잘사먼조왕	다 먹으면서도 그런데 그 사람이 돈을 몇 천만 원 벌어서 말이지 잘 살면좋아
대콛 잘사은 모 헝 게 머 자동차나 몰고 뎅기 머여 큼 푸구자 거친 날찌엄딛 두베이 보머 쓰능 게 더 마내 이 사러미	개코도 잘 살지도 못 하는 게 뭐자동차나 몰고 다니고 뭐냐 큰 부자 같이 나다니고 뒷 뒤집어 보면 쓰는 게 더 많아 이 사람이
기름 쓰지 차 쓰지 머 거이 다 끌고 뎅게	기름 쓰지 차 쓰지 뭐 거의 다끌고 다녀
실쩨 그른상도 이 에으 에익 이 이른 소리 머 으여 으 근 으으사시리이께네	실제 그러면서도 이어 이 이런 소리 뭐어 그음 사실이니까
그려도 도니 뱅마 넝 거트이 근녀네 뱅마 너기 도이라 그륵 이 그 이 기이래드라꼰	그래도 돈이 백만 원 같으면 근년에 백만 원이 돈이야 그래 이 그이 그 이러더라고
내 그래 하이 참 미이 저 사암드리 괭자이 마이 부능게 따 그으고 얼마너수이비 데그때 돔 뱅마 너을 까지끼 돔 뱅마 넝 그러겓	내 그래 하이 참 이저 사람들이 굉장히 많이 버는가 보다 그러고 얼마나 수입이 되기에 돈 백만 원을까짓것 돈 백만 원 그러겠어
그랜는 어이 지 시방 사웨라꼬 내가	그런저 시방 사회라고 내가
흐르이 도니 고마 대번 하 일 려네 농살 지음 메 첨마 너언지 딱 쥐야 고마 그 머으이야 한 내 이태 지이가주 첨마 늠 맨드너 근 도니 아이래보이께네	그러니 돈이 그만 대번 한 일 년에 농사를 지으면 몇 천만 원 딱 쥐어야그만 그 뭐어 한 해 이태 지어 가지고 천만 원 만든 그것은 돈이 아니야 보니까
대벙 고망 거 즌 첨 마 이첨 만 쥐기야 데얌	대번 그만 그 저 천 만 이천 만 원 쥐어야 돼
근디 옌날 사람브더 항 가마이 두 가마이 늘러가주 소 빠리 메기가주 소아  지 함 마리 파라 가주고 그래 머은 사럼드리 오른 부자라꼬 그게	그런데 옛날사람들은 한 가마니 두 가마니 늘려서 소 몇 마리 먹여서 송아지 한 마리 팔아 가지고 그래 모은 사람들이 옳은 부자라고 그게
여 그른 사러믈 종경해 조이 덴데 마리지	여 그런 사람을 존경해 줘야 되는데 말이지
기러이 그게 이 요새 사럼드리 마알지 나먼 돔 벙 게 기양 번 줄 안다이께너 말	그러니 그게 이 요새 사람들이 말이지 남은 돈 번 게 그냥 번 줄 안다니까말이지
하이 그르 지가 버러 바야아라	하이 그래 자기가 벌어 봐야 알알아
그 사훼가 그키 바께따 그 마리야 내가여	그 사회가 그렇게 바꼈다 그 말이야 내가요
나믈 머 그 뜬능 게 아이래 내가	남을 뭐 그 헐뜯는 게 아니야 내가
어이 얘에기르 항 게르	어 이야기를 한 거야
현 사웨가 그래요	현재 사회가 그래요
흐르이 그게 따카드라꼬 내가 볼 때 마리야	그러니 그게 딱하더라고 내가볼 때 말이야
좀 덜 쓰고 늘구코 그래에 덴데 돔 뱅마 넌 머으 그 커른데 차가 말 요오 간데드 차 가주 가요	좀 덜 쓰고 늘리고 그래야 되는데 돈 백만 원 뭐 그그런데 차가 말이지 요기 가는데도 차를 가지고 가요
그 웨 기리미 함범 멀르 까멍 끄 어으 저거도 한두 덷 다 드능 거 아이래요	그 왜 기름이 한 번 몰고 가면 그적어도 한두 되 다 드는 것 아니에요
구꺼역 그른 거는 다 써 뿌고 마에치이	그러니 그런 것은 다 써 버리고 말이지
요즘머 기름깝또 비싸서	요즘은 기름값도 비싸서
예아 비싼데 글쎄	예 비싼데 그러게
저어 놈물 보러 감자 차 가주 가고 마에지 놀로 간데 차 뎅기그 마에찌에시꾸 때우구 덜루 뗑기구 마러지	저 논물 보러 가면서 차 가지고 가고 말이지놀러 가는데 차 다니고 말이지 식구 태우고 들로 다니고 말이지
요음 농진니 껴 그게 농얻진능 거뜨 아이래여	요즘 농사짓는 것 그게 농사짓는 것도 아니에요
호가이래 요샌 옌나른 농운찡임썽요	호강이야 요새는 옛날에 농사지으면서요
예전하고 요즘 마이 달라져씀미	예전하고 요즘 많이 달라졌습니다
예아 실쩌이 그래	예 실정이 그래
