dialect	standard
그러면 인제 인자는 이 할머니 인제 자시네 데한 이야기예요 자시 자기에 데한이야기 자어디서 테어나셔따고요	그러면 이제 이제는 이 할머니 이제 자신에 대한 이야기예요 자신 자기에 대한 이야기 자 어디서 태어나셨다고요
저 진상면 청암니서 태어나저저 배천니	저 진상면 청암리에서 태어나 아저저 배천리
베천니서이 에	배천리에서 예
금니리 지그믄 금니리 저네는 배천니라고	금니리 지금은 금니리 전에는 배천리라고
응 지그믄 무슨 니	응 지금은 무슨 리
금니리	금니리
금니리	금니리
이천	이천
이천	이천
베천니니까 이천 그러머넌 인자 그 사 그 어릴 떼 함 번 이야기를 헤바 어어어릴 떼는 주로 가정형펴니라든지 먼 니를 허고 사션는지 함 번 고거 옌날 베천베처네서으 셍활을 함 번 헤 보 이야기를 헤 보십씨요	아 배천리니까 이천 그러면은이제 그 사 그 어릴 때 한번 이야기를 해 봐어 어릴 때는 주로 가정형편이라든지 무슨일을 하고 사셨는지 한번 그거 옛날 배천  배천에서의 생활을 한번 해 보 이야기를해 보십시요
저네 긍깨 발랑구니 마나가꼬 우리 클 쩌게는	전에 그러니까 반란군이 많아가지고 우리 클 적에는
발랑구니	반란군이
그러면	그러면
유기오 떼	육이오 때
유기오 떼	육이오 때
유기요 아네	육이호 안에
유기요 너머 가꼬 인자 유기요예 나 포돕씨 유기요 되든 뗃 인자 그 년 보메 인자 이팍해 써요	육이오 넘어가지고 이제 육이오에나 겨우포돕씨는 겨우의 방언형
인자 이파글 핸는디 긍깨 사뭘 따레 이팍 허고 사월 오월 유월따레 유기요가나가꼬 고마 하꾜를 몬 가써요 그래가 하꾜를 몬 강 거이 마 그를 모 빼우고	이제 입학을 했는데 그러니까 삼월에 입학하고 사월 오월 유월에 육이오가 나가지고 그만 학교를 못갔어요 그래가지고 학교를 못 간 것이 글을 못 배우고
유기요가 나가꼬 부모드른 점부 저 서메 서미라고 저그 태인도 지그믄 태인도	육이오가 나가지고 부모들은 전부 저 섬에 섬이라고 저기 지금은 태인도
태인도 거그 크넌니가 거그가 사는디 그그예 식꾸대로 다 가 부리고	태인도거기 큰언니가 거기에 사는데 거기에 모든 식구가다 가 버리고
우리 할무니허고 하 인자 그 아네 우리 하라부지가 세상 베리고 울 할무니가 이써서 우럼 어무니 아부지는 몽 까고 이씀성 인자 다 가는디 날 가이내라고 여자라고 난주거도 된다여	우리 할머니하고 하 이제 그 안에 우리 할아버지가 세상 떠나고세상 버리다는 세상 떠나다의 뜻 우리 할머니가 있어서 우리 엄 어머니 아버지는 못 가고 있으면서 이제 다 가는데 날 계집애라고 여자라고 난 죽어도 된대
막띵이가 대농께 팔람메서 막띵인디 인자	막내가 돼  놓으니까 팔남매에서 막내인데 이제
점부 오빠드른 구니네고 재피 가부루고 오꼬 인자 우리 식꾸드리 인자 조 나믄사라믄 인자 우리 올케언니 우리 조카들 점분자 글쩨는 기믈 헝개 배가 이써요	전부 오빠들은 군인에 잡혀 가 버리고 없고 이제 우리 식구들이 이제 남은 사람은 이제 우리 올케언니 우리 조카들 전부 이제 김을 하니까 배가 있어요
배가 이꼬 그런디 인자 우리 헹부를 오라고 인자 해 가꼬 우르 헹헹부가 와서인자 싹 시꾸대로 막 양서그 싸고 머 미수까리 해서 싹 싸고 해가꼬 점부 실코 가고또 거그 살다가 또 양세기 모지래믄 인자 스 와 하나이나 와 가꼬 인자 또 양서글 가저가고 인자 그래	배가 있고 그런데 이제 우리 형부들 오라고 이제 해가지고 우리 형 형부가와서 이제 싹 모든 식구가 막 양식을 싸고 뭐 미숫가루 해서 싹싸고 해가지고 전부 싣고 가고 또 거기 살다가 또 양식이 모자라면 이제 하나나 와가지고이제 또 양식을 가져가고 이제 그래
우리는 인자 울 할무니남짜그로 어무니허고 우리 아부지허고는 인자 나허고 그리인자 이꼬 그 동네에 인자 또 노인드른 멛 썩 이꼬 절믄 사람드른 인자 싹 가 부리고	우리는 이제 우리 할머니 비롯해서 어머니하고 우리 아버지하고는 이제 나하고 그리 이제 있고 그 동네에 이제 또 노인들은 몇씩 있고 젊은 사람들은이제 싹 가 버리고
그양 비행기가 그양 머 제트깅가 머 저네는 그거이 우엥 허고 오믄 그냥 또스 스 막 암디라도 업찌서 숭꼬 난중에는 수므먼 더 싼다고 그래가꼬는 그냥 비행기가 오먼 무장 마당으로 나서써요	그냥 비행기가 그냥 뭐 제트기인지 뭐  전에는 그것이우엥 하고 오면 그냥 또 스 스 막 아무 곳이라도 엎드려서업지다는 엎드리다의 방언형숨고 나중에는 숨으면 더 쏜다고싸다는 쏘다의 방언형 그래가지고는 그냥 비행기가 오면 점점무장은 점점의 방언형 마당으로 나섰어요
그래서 저그 또 손 인자 인자 나문 사람드른 인자 막 비행기가 저 강에 저런 디막 저 한지레 저런디 막 포껴글 허고 그러머 또 사느로 싹 쩨께 올라가가꼬 솔나무 미테가 점부 저래가꼬 저 집껀석 저 집때로 도르레하이 이꼬 우리 건석 우리대로 도리하 이꼬 솔 큰 솔라무 미테가 그래가꼬 이따가 난장에는 인자 수무먼 더 싼다가꼬 점부 비행기만 오믄 또 나안자서 늘비허이 나안자꼬	그래서 저기 또 손 이제 이제 남은 사람들은 이제 막 비행기가 저 강에 저런 곳 막 저 한길에 저런 곳 막 폭격을하고 그러면 또 산으로 싹 쫓겨 올라가가지고 소나무솔나무는 소나무의 방언형 밑에  전부 저래가지고 저 집식구권속은 식구의 뜻 저 집대로 둥글게 도르레하다는 둥글게모여 있는 모양을 나타낸다있고 우리 식구 우리대로 둥글게 있고 솔 큰 소나무 밑에 그래가지고 있다가 나중에는 이제 숨으면 더 쏜다 해가지고 전부 비행기만 오면 또 나앉아서늘비하게 나앉았고
그러자 인자 발랑구니 생게 가꼬 인잗 점붇 인제 남자드른 숭꼬 남자드릳 발랑구니 내레오문 지믈 지고 가요	그러자 이제 반란군이 생겨가지고 이제 전부 이제 남자들은 숨고 남자들이 반란군이 내려오면 짐을 지고 가요
동네 꺼 점부 막 오시고 양서기고 싹 추리가꼬 주구 시니고 다 추리가꼬 거서허먼 인자 글때 인자 고무신 파뜩파뜯 나오고 그랜는디 고무신 한 커리 인 인나 인는 그렁거는 막 구더글 파 노코 거따가 싱키 노코 인자 지퍼 가꼬 인잗 집쎄기 소리 그렁 걸 사마가꼬 인자 늘비허니 인자 머 오 방무나페다 나뚜고 그거또 성헝 거는 다 가 가부리요	동네 것 전부 막 옷이고 양식이고 싹 추려가지고 자기 신이고 다 추려가지고 뭐하면 이제그때 이제 고무신 이제 막 나오고 그랬는데 고무신 한 켤레나커리는 켤레의 방언형있는 그런 것은 막 구덩이를구덕은 구덩이의 방언형 파 놓고 거기에다가 숨겨싱키다는 숨기다의 방언형 놓고 이제 짚을 가지고 이제 짚신집쎄기는 짚신의 방언형 소리소리는 상제가 초상 때부터 졸곡 때까지 신는 짚신 총을 드문드문 따고 흰 종이로 총 돌기를 감았다엄짚신이라고도한다 그런 것을 삼아가지고 이제 늘비하게 이제 뭐 오 방문앞에다 놔 두고 그것도 성한것은 다 가져가 버려요
거그 어디로어디에 발랑군 어디에서 사라요	거기 어디로어디에 반란군 어디에서 살아요
사네서 내러 와요 저녀기믄 지를 차자서	산에서 내려와요 저녁이면 길을 찾아서
내러오믄 인자 영감드리나 하나이나 인자 앵기문 인자 그 사라믄 거그 짐 실코저그 배운산 미테꺼지 저녕내 올라가 가따 줘야데요	내려오면 이제 영감들이나 하나나이제 잡히면 이제 그 사람은 거기 짐 싣고 저기 백운산 밑까지 저녁내 올라가서 가져다 줘야 돼요
가따 주고 내레오다가 혹씨 잘모뗀 사람드른 또 먿 그냥 해나 머 숭경이나 머이나 되능가이야 싸 뿌리가꼬 중는 사라믄 주꼬 글떼는 기양 목쑤믈 바치노코 사라찌요	가  져다 주고 내려오다가 혹시 잘못된 사람들은 또 뭐 그냥 행여나  뭐 순경이나 뭐나 되나 싶어가이는 관데의 방언형여기서는 보조형용사 싶다의뜻 쏴 버려가지고 죽는 사람은 죽고 그때는글때는 그때의 방언형 그냥 목숨을 바쳐놓고 살았지요
그러면	그러면
그래가꼬 인자 우리 아부지가 함 번 엥게가꼬 인자 지믈 지고 간는디 인자그러자 인자 울 하라부지 세상 베능 거이 그 때는 삼년상을 안 추린능가요	그래가지고 이제 우리 아버지가 한번 잡혀가지고 이제  짐을 지고 갔는데 이제 그러자 이제 우리할아버지 세상 떠난 것이 그때는 삼년상을 치렀잖아요
삼년상을 추리서 인자 울 하라부지 제사 모시고 인자 상복 그거를 아래빵에다 쌍나뚜고 인자 우리 어머니는 인자	삼년상을 치러서 이제 우리 할아버지 제사 모시고 이제상복 그것을 아랫방에다 싹 놔 두고 이제 우리 어머니는 이제
당신들 짐 지고 가다가 우리 영감 주거 뿌리가꼬 초상 치고 여 상보기 요래가 이씅깨 요거 보라고 우는 요로고도 산다고 그름 쪼깜 덜 해요	당신들 짐 지고 가다가 우리영감 죽어 버려가지고 초상 치르고 이 상복이 이래가지고 있으니까 이것 보라고 우리는 이러고도 산다고 그러면 조금 덜 해요
주구 따라가다 인제 죽어때노니 그러하고르아부지 하라부지는 나페 세상 비리고 할무니 세상 베리고 그랜능갑따 구래	저희들 따라가다 이제 죽었다고 해 놓으니 그리고 아버지 할아버지는 앞에 세상 떠나고 할머니 세상 떠나고 그랬나 보다 그래
그러 그걸 나뚜고 내창 그러고 쩌이 그냥 또 안 갈랑깨로 인자 양서글 멀리 인잗 딱 저그 어디다 싱키 뿌리고	그래 그것을 놔 두고 계속 그리하고 저 그냥 또 안 가려니까 이제 양식을 멀리 이제 딱 저기 어디에다 숨겨 버리고
인자 저네는 나무 함지 안 인능가요 나무함지에나 인자 먿 동우에나 그런디다 양서글 좀 다마노코 인자 쪼깐썩 동냥 주데끼	이제 전에는 나무함지 있잖아요 나무함지나이제 뭐 동이에나 그런 곳에다 양식을 좀 담아 놓고 이제 조금씩 동냥 주듯이
바가치에다 인잗 함 바가치썩 퍼 줌성 우리는 머 무꼬 사꺼이냐고 당신드리 자꼬막 지버 추먼우리는 머 무꼬 사꺼이냐고 그냥 요놈 가꼬 가라고	바가지에다 이제 한 바가지씩 퍼 주면서 우리는 뭐 먹고 살거냐고 당신들이 자꾸 막집어 챙기면우리는 뭐 먹고 살거냐고 그냥 이것 가지고 가라고
영감도 주거 뿌르고 나가 저거떨 어찌 미기 살리꺼이냐고 인자 그래노먼 인자 가요	영감도 죽어 버리고 내가 저것들 어찌 먹여 살리겠느냐고 이제 그래 놓으면 이제 가요
그르고 우리는 질까찌비 되농깨로 점부 처가꼬 올라오던 사람드리 똗 점부 우리지비서 시 갈락 허여	그리고 우리는 길갓집이 돼 놓으니까 전부 쳐가지고 올라오던 사람들이 꼭 전부 우리집에서 쉬어 가려고 해
시 갈라먼 막 하이고 망 욕 뽄다고 우러매가 막 우러무니가 막 욕 뽄다고 언능날 안 세서 쎄게 올라 가라고 막 막 그래쌈서 막 홀가노먼 조타게 울 어무니를	쉬어 가려면 막 아이고 막 고생한다고 우리 어머니가막 우리 어머니가 막 고생한다고 얼른 날이 새지 않을 때 빨리 올라가라고 막 막 그래 쌓으면서 막 속여홀기다는 속이다의 뜻 놓으면 좋다고 해 우리 어머니를
그래가 디야네다 구를 파 노코 구를 파 노코 그러먼 인자 막 숭경들허고 인자숭경드리 인자 여 아무동네 발랑군 와따는 자 저그 산몬당으다 또 봉화뿌를 써요 막 부를 놔요	그래가지고 뒤꼍에다 굴을 파 놓고 굴을 파 놓고 그러면 이제 막 순경들하고 이제 순경들이 이제 이 아무 동네 반란군 왔다는 이제 저 그 산꼭대기에다몬당은 꼭대기의 뜻 또 봉홧불을 켜요 막 불을 놔요
부를 놔 놈 인자 그 동네에 인자 발랑군 와따능 거를 아라가꼬는 겡찰드리 인자 막 요 아페 쩓 듣파네 와 가꼬 그냥 총을 막 다닥닥닥 다다다다 싸먼 막 쩨께 올라가고	불을 놔 놓으면 이제 그 동네에 이제 반란군 왔다는 것을 알아가지고는 경찰들이 이제막 이 앞에 저 들판에 와가지고 그냥 총을 막 다다다다 다다다다 쏘면 막 쫓겨 올라가고
그럼 막 저 염방 그그 겡찰 숭경 와따고 저넨 숭겡 와따고 언능 승겡드리 암 막오기 저네 얼릉 가라고 막 그랜 그가꼬 보내고 그랜	그럼 막 저 계속 그 그 경찰 순경 왔다고 전에는 순경 왔다고 얼른 순경들이 막 오기 전에 얼른 가라고막 그래 그래가지고 보내고 그랬는데
언자 올쭈를 몰라요 오늘 쩌녁 저 동네로 가꺼잉가 이 동네로 오꺼잉가 보독저 산믿 큰 산미치 되농깨로 하이 검나요	언제 올 줄을 몰라요 오늘 저녁 저 동네로 갈것인지 이 동네로 올 것인지  저 산 밑 큰 산밑이 돼 놓으니까 아이 겁나요
그럼 또 발랑군 도아 줘따고 숭경드리 또 머라 안함니까	그럼 또 반란군 도와 주었다고 순경들이 또 뭐라 안 합니까
도와 주자네 주구갇 돌라가따 그래야지 우리드리 줘딱 해서는 안 되지요	도와  주는 것이 아니라 저희들이 훔쳐갔다돌라가다는 훔쳐가다의 방언형
그래가 인자 배나 머이나 인잗 배 짜서 어째 농 거 이씨문 배트레서 그냥 싹짱그라가 가부리요	그래가지고 이제 베나 뭐나 이제 베 짜서 어찌해 놓은 것 있으면 베틀에서 그냥 싹 잘라가지고 가 버려요
막 주구 다리 요롱 거 가물라 끌텅바테 댕기무 막 쑤싱깨로	막 저희 다리 이런 것 감으려고 그루터기밭에끌텅은 그루터기의 방언형 다니면서 막 쑤시니까
사네 망 나무 그렁 걷 막 끌텅이 이씽깨 그렁게 쑤시고 그렁깨로 막 인드를 막칭칭 가마가꼬 댕게요	산에 막 나무 그런 것 막 그루터기가 있으니까 그런 것 쑤시고 그러니까 막 이런 곳을 막 칭칭 감아가지고 다녀요
거 인 날 보고 아풍 거멩이로 우르 인잗 어무니가 누씨라고 그러먼 가만 누씨먼 이 머이요 금서 막 그냥 신 시는차 발로 올러 와 가꼬 막 차부리요	그 이제 나보고 아픈 것처럼 우리 이제 어머니가 누워 있으라고 그러면 가만 누워 있으면 이 뭐요 그러면서 막 그냥 신 신은 채 발로 올라 와 가지고 막 차 버려요
차부리믄 아이고 거 우리 애기가 염병을 해 가꼬 시방 가통을 해 가꼬 저레 가꼬 올 주글찌 넬 주글지 모른디 그거는 건드리지 마라고 그떼 주꺼따고 그레 그레노믄 그방에 안 드러와요 염병 오린다고	차 버리면 아이고 그 우리 아이가 염병을 해가지고 지금 가통을 해가지고 저래가지고 오늘 죽을지 내일 죽을지 모르는데 그것은 건드리지 말라고그때 죽겠다고 그래 그래 놓으면 그 방에 안 들어와요 염병 옮는다고
그러믄 배 그노믈 나 오세다가 나 몸뗑이다가 창창 이릳 막 보둠꼬 배까래 그노믈 요래 보둠꼬 막 뭘가 가머가꼬 요래가꼬 우아기로 요론 먼 인잗 남자들 먼 오슬 항 개요래 둘러 씨고 막 거짐말로 우러요 엄마 아이고 아파 주꺼써 그럼스로 울고 이씨먼 조용히 해 그러거 엄마 엄마 그러고 이씨믄  저네는 어메라 그래끄등	그러면 베 그것을내 옷에다가 내 몸뚱이에다가 칭칭 이렇게 막 안고보둠다는안다의 방언형 베 가래 그것을 이렇게 안고 막 뭘 가지고 감아가지고 이래가지고 윗옷을우아기는 윗옷의 일본말 이런 무슨 이제 남자들 무슨 옷을 한 개 이렇게 둘러쓰고 막거짓말로 울어요 엄마 아이고 아파 죽겠어 그러면서 울고 있으면 조용히 해 그러고 엄마 엄마 그러고 있으면 웃음 전에는 어메라 그랬거든
응  어메 아이고 주껀네 머리가 아파 주껀네 배가 아퍼 주껀네 그래노먼 그 방에 드  로도 안 해요	엄마 아이고 죽겠네 아파 죽겠네 배가 아파 죽겠네 그래 놓으면 그 방에들어오지도 않아요
인자 막 도꼬 인자 먿 몬 또린 놈드른 인자 막 그래도 소양업씨 막 디비고 그래가	이제 막  이제 뭐 못 훔친 놈들은 이제 막 그래도 소용없이 막 뒤지고디비다는 뒤지다의 방언형 그렇게 가
그래가꼬 멀 처덥꼬 이래가꼬 막 이래가꼬 안자씨먼 그러고 가고 또 우리 이우자애기 몬 논는 아지메가 하나 이써서 또 우리 지비 그 아지메 인자 아재가 인자 사네로 인자발랑군 와따 허먼 인자 투막투막 새로 머쓴장 울타리 꾸녕도 해 노코 먿또 해 노코 막 뒤에 올라 가는 지를 맹그라노코 싹 남자드리 막 뉘 지베 하나 와따고 거시기나 헝개 잠도자도 모도 시우자믈 자고 그래요	그래가지고 뭘 마구 덮고이래가지고 막 이래가지고 앉아 있으면 그렇게 가고 또 우리 이웃에 아기 못 낳는 아주머니가 하나 있어서 또 우리 집이 그 아주머니아지메는 아주머니의 방언형 이제 아저씨아재는 아저씨의 방언형가 이제 산으로 이제 반란군 왔다 하면 이제 듬성듬성투막투막은 듬성듬성의 뜻 사이로 뭐 이제 울타리 구멍구녕은 구멍의 방언형도 해 놓고 뭐도해 놓고 막 뒤에 올라가는 길을 만들어 놓고 싹 남자들이 막 누구 집에 하나 왔다고 뭐나하니까 잠도 자지도 못하고 새우잠시우잠은 새우잠의 방언형을 자고 그래요
그래가꼬 발랑군남세 몬 사라서 그러다가 자 일녀니 너머가가꼬 이년 인자 새년 인자 사뭘때리 데서 모도 하꾜르 드리가고 그러는디 인자 긍근 업써가꼬 우리 크노빠르 그를 몬 겔차따네요 쩨깐헌 깔땀사리로 내창 줘서 인자 새겡을 바다무꼬 인자 음서가꼬 인자 그랜는디	그래가지고 반란군 때문에 못 살아서 그러다가이제 일년이 넘어가가지고 이년 이제 새해새년은 새해의 뜻 이제 삼월이 돼서 모두 학교를르는 를의 방언형 들어가고 그러는데 이제 근근이 없어가지고 우리 큰오빠를 글을못 가르쳤다네요 조그마한 꼴머슴깔담사리는 꼴머슴의 뜻으로 계속 줘서 이제 새경을받아 먹고 이제 없어가지고 이제 그랬는데
우리 언니드리 너인디 팔람맨디 우리 오빠드리 너이 언니 인자 우리 여여 여동우가니 너이 그랜 우리 언니가 가이네 따리 너이나 뎀서 하나도 조럽쌍 항 개도 엄따고인자 나를 하꾜를 가라고 인자 그랜 새로 드르가 새로 드르 간다고 핸는디 우로빠 가이네가 글 귿 빼워가 머허꺼이냐고 나도 글 모빼와따고 가지 마라 그래	우리 언니들이 넷인데팔남매인데 우리 오빠들이 넷 언니 이제 우리 여동기간이 넷 그랬는데 우리 언니가 계집애 딸이 넷이나 되면서 하나도 졸업장 한 개도 없다고 이제 나를 학교를 가라고 이제 그랬는데 새로 들어가 새로 들어간다고 했는데 우리 오빠가 계집애가 글 그것 배워서 뭐 할거냐고 나도 글 못 배웠다고 가지 말라 그래
그래가꼬 인자 하꾜를 몬 뜨러가 그냥 조캐들만 키우고 사라써	그래가지고 이제학교를 못 들어가 그냥 조카들만 키우고 살았어
여 유기오떼가 그믄 제일 힘들게 사션네요이	음 여 육이오 때가 그러면제일 힘들게 사셨네요
그래가 글 모빼웅 거 인자 동네 인자 청년드리 인잗 난중에 글 겔춘다고 허고또 임밍군드리 막 오그 거그에 또 여그 막 밀려가꼬 거세 해써요	그래가지고 글 못 배운것 이제 동네 이제 청년들이 이제 나중에 글 가르쳐 준다고 하고 또 인민군들이 막 오그거기에 또 여기 막 밀려가지고 거시기 했어요
또 임민군드리 처으메는 와 가꼬 유기오때 그 때는 임민군드리 우리를 글 겔춘다고	또 인민군들이 처음에는 와가지고 육이오 때 그때는 인민군들이 우리를 글 가르친다고
그레요	아 그래요
동청에다가 칠파늘 부치노코 그를 개우고 저네 머 한수발 눈 바라마 이야기하라그 일 저 이붕 노래	마을회관에다가 칠판을 붙여 놓고 글을 배우고개우고는 배우고의 잘못된 발음 전에 뭐 한수발 눈 바람아 이야기하라 그 일 저이북 노래
그런 노래를 겔차 주고 그래가꼬는 난주에는 엗 인잗 발랑구니 인자 쬐께 가고나서는 인자 또 청년드리 인자 겔춘다고 해 가꼬 거그서 좀 배우고 그래가꼬 그 이름짜라도알지요 글도 몰라요	그런 노래를 가르쳐 주고 그래가지고는 나중에는 에 이제 반란군이이제 쫓겨 가고 나서는 이제 또 청년들이 이제 가르친다고 해가지고 거기서 좀 배우고 그래가지고 그 이름자라도 알지요 글도 몰라요
인민군드리 갈처중 거슨 주로 노레가틍 거 갈처조써요	인민군들이 가르쳐 준것은 주로 노래 같은 것 가르쳐 줬어요
노래도 겔차주고 막 그래써요	노래도 가르쳐 주고 막 그랬어요
글짜도 알켜주고	글자도 가르쳐 주고
글도 겔차주고 노래도 겔차주	글도 가르쳐 주고  노래도 가르쳐 주
겔차주고 응 노레가 지금까지 또 기어기 나네요이	가르쳐 주고 응 노래가 지금까지 또 기억이 나네요
쩨깐빼끼는 몰라요	조금밖에는 몰라요
우 첨 아피 머 처으메가 머잉고 제목또 모르고	우 첨 앞에 뭐 처음이 뭐인지제목도 모르고
벨지슬 다 해찌요이	별짓을 다 했지요
그래가 저녀그로도 글 배우로 가허고 인자 에리서는 글 배우로 가고 그라핸넌디인자 좀 커서는 울 아부지가 구싱 영가미 되야가꼬 바람난다고 또 나가도 몯 허게 해요	그래가지고 저녁이면 글 배우러 가고 이제 어려서는 글 배우러 가고 그리했는데 이제 좀 커서는 우리 아버지가 구식 영감이 되어가지고 바람난다고 또 나가지도 못하게 해요
아버지랑은 주로 농사 지션나요	음 아버지랑는 주로 농사지으셨나요
인자 울 오빠들 싹 구니네 재피가고 인자 도피헌다고 인자 어디로 더그 서섬나라에 그런 디 가서 머 강원도 우리 세쩨 오빠는 강원도 머 무코당가 거그 가가꼬 또 오징에뺃 딷 타로 따라댕기다가	이제 우리 오빠들 싹 군인에 잡혀가지고 이제 도피한다고 이제 어디로 저기 서 섬나라에 그런 데 가서 뭐 강원도 우리 셋째 오빠는 강원도 뭐 묵호인지 거기 가가지고 또 오징어배 타러 따라다니다가
인자 함 번썩 호까다 함버썩 오믄 그냥 오징에 수류미 몰륭 거	이제 한 번씩 어쩌다 한 번씩 오면 그냥 오징어 오징어수류미는 오징어의 일본말 말린 것
그걸 그냐 한 춤썩 가오문 막 이이이가 아푸드륵 씨버무꼬 나문 막 설싸가 그거또 마니 무긍깨 설싸가 나데요	그걸 그냥 한 축씩 가져오면 막 이 이 이가 아프도록 씹어 먹고 나면 막 설사가 그것도 많이 먹으니까 설사가 나데요
막 설싸를 마니 하고 그래써요	막 설사를 많이 하고 그랬어요
그나 울 옵 울 아부지허고 나허고 인자 살리믈 산다고 살고 메느리 데꼬 드레몬 나가고 긍깨 맨마던 나만 인자 울 언니드른 다 시집 가뿌리고	그러나 우리 아버지하고나하고 이제 살림을 산다고 살고 며느리 데리고 들에 못 나가고 그러니까 만만한 나만 이제 우리 언니들은 다 시집가 버리고
만날 소 미기고 머 소 질드려 가꼬 포돕씨 인자 소 질 떠러지먼 세양치 섣 하동장으 가서 바까 큰 세 인자 포라 무거 뿌리고 소앙치 함 마리 몰고 오먼 또 우라부지 그거 질 드린다문 또 나가 아페 끄야 되요	만날 소 먹이고 뭐 소 길들여가지고 겨우 이제 소 길나면 질떨어지다는 길나다의 방언형 송아지세양치는 송아지의 방언형 하동장에 가서 바꿔 큰 소세는 소의 방언형 이제 팔아 먹어 버리고 송아지 한 마리 몰고 오면 또 우리 아버지 그것 길들인다면 또 내가 앞에 끌어야 돼요
끄꼬 댕김스롱 인자 이라 허문 인자 따라서 댕기다가 인자 지리 얼추 떨러질라허문	끌고 다니면서 이제 이랴 하면 이제 따라서 다니다가이제 길이 얼추 나려 하면
밀바테나 보리바테나 나가 수머뿌라 그래요 우리 아부지가	밀밭에나 보리밭에나 나가서 숨어 버려라 그래요
수머 뿌리라 해서 어디 수머 뿔먼 누늘 흘금허이 아페 오다가 채리보고는 울아부지를 막 훌쳉이차 꿀꼬 나헌티로 쪼차 오고  소가	숨어 버려라 해서 어디 숨어 버리면 눈을 흘금거리며 앞에 오다가 쳐다보고는 우리 아버지를 막 극젱이채훌쳉이는 극젱이의 방언형 끌고 나한테로 쫓아 오고 웃음소가
그르고 세상을 살고	그렇게 세상을 살고
그레 인제 부모님들 농사 진능 걸 도와 주시고	음 그래 이제 부모님들 농  사짓는 걸 도와 주시고
또 공출 일본 싸람들 인자 논	또 공출 일본 사람들 이제 논
그거 인자 어더 가고 지이 노으먼 저네 우라 인자 우리는 모르제마는 우리 언니드른 인자 우리는 나으 느께 나농깨 그르찌마는 일본 싸람들 노늘 인자 울 아부지가 일본싸람들 미테 가서 일도 해 주고 인자 그렁 거를 허고 사라노 가서 살다가 또 인자 너무집도 살다가 그래농깨 일본 싸람드리 노늘 줘서 그거를 인자 적싼지 노니라고 그러데요그걸 보고	그것 이제 얻어가지고 지어 놓으면 전에 우리 이제 우리는 모르지마는 우리언니들은 이제 우리는 늦게 낳아 놓으니까 그렇지마는 일본 사람들 논을 이제 우리 아버지가 일본 사람들 밑에 가서 일도 해 주고 이제 그런 것을 하고 살아 놓 가서 살다가 또 이제남의집도 살다가 그래 놓으니까 일본 사람들이 논을 줘서 그것을 이제 적산지논이라 그러데요 그걸 보고
일본싸람 노늘 줘서 인자 그노믈 공추를 가꼬 인자 농사를 지여가 공추를 해서 인잔 수를 가파요 논 노늘 논쑤를 가파요	일본 사람 논을 줘서 이제 그것을 공출을가지고 이제 농사를 지어가지고 공출을 해서 이제 수를 갚아요 논 논을 논 수를 갚아요
그르믄 인젇 또 가마니트를 해 노코 가마이 짜는디 울 아부지는 뚜드리고 인자요리 인자 지플 하날하날 요리 미기주믄 울인자 또 한쪼게서 우롤 인자 올케 올케더리나 언니가 인자 요리 자버댕기고 나느 요리 미기주고 그래가 가마니 짜 가꼬 인잗 근대 낼라고 사나쿠도 인자 토꼬게 까요	그러면 이제 또 가마니틀을 해 놓고 가마니 짜는데 우리아버지는 두드리고 이제 이리 이제 짚을 한 올 한 올 먹여 주면 울이제 또 한쪽에서 우리 올 이제 올케 올케들이나 언니가 이제 이리 잡아당기고 나는 이리 먹여 주고 그래가지고 가마니 짜가지고 이제 무게가 나가도록 새끼도사나쿠는 새끼의 방언형 이제 특특하게톡허다는 특특하다의 뜻 꽈요
그래가 가마니 뭉꺼 가 그걸 인자 여 지그믄 머 기게가 쌔씅깨 그러지만 저 몬당 찌빈디 여그 성그장써 한지락꺼지 또 저나야 되요	그래가지고 가마니 묶어가지고 그걸이제 여 지금은 뭐 기계가 쌨으니까 그렇지만 저 꼭대기집인데 여기 섬거장섬거는 지명에서 한지락까지 또 져 내야 돼요
공추를 헐라믄 그 일본싸람 논 수를 줄라믄 그걸 보고 적싼지 노니라 그럼서 그  수를 인자 줄라믄 어째뜽가네 우리 처자때꺼정 그 논 쑤를 가파써요	공출을 하려면 그일본 사람 논 수를 주려면 그걸보고 적산지논이라 그러면서 그 수를 이제 주려면 어쨌든우리 처녀 때까지 그 논 수를 갚았어요
그레요	그래요
그니깐 일본싸람 간 뒤에도	그러니까 일본 사람 간 뒤에도
그믄 그 그 노늘 인제 바드셔꾸마니요 인자이	그러면 그 그 논을 이제 받으셨구먼요 이제
그 노느리	아 그 논을
인자 쓰 농사를 지여 가 인자 해마동 인자 감능 거이라요 인자 말하자믄	이제농사를 지어가지고 이제 해마다 이제 갚는 거예요 이제 말하자면
긍께 소유는 인제 귿 가께 되찌요 그건	그러니까 소유는 이제 갖게 되지요그건
그러가 인자 인자 난중에 인자 해방 되고는 인자 우리 우리 아푸로 도라저찌요	예 그래가지고 이제 이제 나중에 이제 해방 되고는 이제 우리 우리 앞으로 되었지요
그거이 영거이 인자 그래가 열딴 마지기	그것이 영구히 이제 그래가지고 열닷마지기
열딴 마지기	열닷 마지기
노니 되꼬이	논이 됐고
그라농께 어찌 해뜽가네 그래도 인자 노니 논 썸지기가 데지요	그래 놓으니까어쨌든 그래도 이제 논이 논 섬지기가 되지요
또 다랑지논 좀 사고 그래가 논썸지가 사고 그렁깨 야 우라부지가 고상을 해 그러지 우리는 잘 무꼬 사라써요	또 다랑이 좀 사고 그래가지고 논 섬지기 사고 그러니까 우리 아버지가 고생을 해서 그렇지 우리는 잘 먹고 살았어요
열 딴 마지기면 마니 마난네요 노니	열닷 마지기면 많이 많았네요 논이
인자 다랑지논 사고 긍깨른 섬지기라문 스무점마지가 한섬지기 아님니까	이제다랑이 사고 그러니까 섬지기라면 스무 마지기가 한 섬지기 아닙니까
그래 울 아부지가 고상을 해 그러치 우리 무꼬 사능 거 저네는 쑥빱 해 무꼬 머송쿠밥 해 무꼬 모도 그러고 쑹 캐다가 모도 쌀마가꼬 해 무꼬 무시밥 해 무꼬 그래도 우리지비는 그럼 밥 암 무거써요	그래 우리 아버지가 고생을 해 그렇지 우리 먹고 사는 것전에는 쑥밥 해 먹고 뭐 송기밥 해 먹고 모두 그렇게 쑥 캐다가모두 삶아가지고 해 먹고 무밥무시는 무의 방언형 해 먹고 그래도 우리집은 그런 밥안 먹었어요
인제 벨미로 인자 쑥 캐 가꼬 인자 쪼깜썩 서꺼 가꼬 소금 간간허이 여 가꼬그래가꼬 해 해 무으믄 그거이 마시따 싸코 우리드른 그래고 사라찌	이제 별미로 이제쑥 캐가지고 이제 조금씩 섞어가지고 소금 간간하게 넣어가지고 그래가지고 해 해 먹으면그것이 맛있다 쌓고 우리들은 그렇게 살았지
농사가 마나가꼬 우리드른 인제 이리 좀 데서 그러치 그리 몸 무꼬 살고 그리는 안해써요	농사가 많아가지고 우리들은 이제 일이 좀 고돼서 그렇지 그리 못 먹고 살고 그렇지는 않았어요
그러네요그러믄 인자 어쩨뜬 겨로는 겨로는 어떠케 하셔써요	음 그러네요그러면 이제 어쨌든 결혼은 결혼은 어떻게 하셨어요
그냥 인자 늘거가꼬 인자 얼거 가꼬 인자인자 그리 양서기 그리 이씽깨 우리 저네 할무니가 우리 나 망 나서 울 할무니가 우리 지비는 좀 그래도 울 아부지가 애룯씨게버리서 일만 알고 밤만 알고 애씨게 버리서 시미 조아서 버리농께 머 무그꺼임 쪼깜 그래도 넘보덤 좀 나꼬 그렁깨 자꾸 우리 자그나부지들 찌비다 퍼다 주더라네요 곡썩 그렁거를	그냥 이제 늙어가지고 이제 얽어가지고 이제 이제 그리 양식이 그렇게 있으니까 우리 전에 할머니가 우리 나 막 낳아서 우리 할머니가 우리 집은 좀 그래도 우리 아버지가  애를 써서 벌어서 일만 알고 밭만 알고 애쓰게 벌어서 힘이 좋아서 벌어 놓으니까 뭐 먹을것이 조금 그래도 남보다 좀 낫고 그러니까 자꾸 우리 작은아버지들 집에다 퍼다 주더라네요 곡식 그런 것을
누가요	누가요
우리 할무니가	우리 할머니가
그래가 인자 나하고 우리 나 손미테 동생 인자 난 동생허고 손니믈 바다가꼬 인는디 그 저네는 그거이 먼 그리 쩝찔게르 찌믄 그거이 거선다고 싹 나가 우리 인자 애기그거는 인자 막 다미 달글다글 끄러 가꼬 인자 주거 뿌리고	그래가지고 이제 나하고 우리 내 밑에 동생 이제 낳은 동생하고 천연두를 앓고있는데 그 전에는 그것이 무슨 그리  끼면 그것이 뭐 한다고 싹 내가 우리 이제 아기그것은 이제 막 담이 다글다글 끓어가지고 이제 죽어 버리고
나는 인자 좀 커농깨 그걸 이기내고 사는디 인자 천지가 여 막 따까리가 안 안잔능가요 그거이 그거이 그걸 싹 뜨더서 자꼬 재드라네요 그거 쌀 퍼낸 숭 내니라고자꾸 씨러 모두더라네요 따까리 떼 가꼬 나가	나는 이제 좀 커 놓으니까 그걸 이겨 내고 살았는데 이제 사방이 이 막 딱지따까리는 딱지의 방언형가 앉잖습니까 그것이 그것이 그걸 싹 뜯어서 자꾸 쟁이더라네요 그거 쌀 퍼내는 흉내숭은 흉내의 방언형 내느라고 자꾸 쓸어 모으더라네요모두다는 모으다의 방언형딱지 떼어가지고 내가
그래가꼬 인자 인자 얼거농깨로 인자 곰보라고 그래 긍깨 시집 와서조창 그리곰보라고 인자 하대르 바꼬	그래가지고 이제 이제 얽어 놓으니까 이제 곰보라고 그래그러니까 시집와서조차 그렇게 곰보라고 이제 하대를 받고
그니까 그 증상이 이러케 어쩨뜬 곰보하면 얼 얼구리 얼케데지요이	그러니까그 증상이 이렇게 어쨌든 곰보하면 얼 얼굴이 얽게 되지요
손니믈 허게 데면	천연두를 앓게 되면
옌나레느니	옛날에는
그래가꼬 큼서롱도 너마페 얼굴 함번 몬 내노코 펭상 사래미 오먼 싱키고 숭꼬	그래가지고 크면서도 남 앞에 얼굴 한 번 못 내놓고 평생 사람이 오면 숨기고 숨고
지그믄 별로 그러지를 안는데 엔나레는	음 지금은 별로 그러지를 않는데옛날에는
인자 사리 빠징꼬 인자 늘긍깨로 사리 주르미 징깨 인자 그거이 음써 저써요 저네는 마니 그래써요	이제 살이 빠지고 이제 늙으니까 살이 주름이 지니까 이제 그것이없어졌어요 전에는 많이 그랬어요
그레 가지고 겨로는 그러믄 인제 어떠케 하셔써요 누가 중메를 하션나요	음 그래가지고 결혼은 그러면 이제 어떻게 하셨어요 누가 중매를 하셨나요
인자 우리 오빠가 인자 인자 해방이 되고 구니네를 인자 또 우리 오빠는 서울 조제처니라는 냥바니 우리 어무니 외사초니등거이다네요	이제 우리 오빠가 이제 이제 해방이 되고 군인을 이제 또 우리 오빠는 서울 조재천이라는 양반이 우리 어머니 외사촌이었던모양이에요
그때 머 구켕가 머 구케으워닝가 서울써 해쓸 거이요	그때 뭐 국회인가 뭐 국회의원인가 서울에서 했을 거예요
거래가꼬 우리 여 지눨며네 사라는디 거 우리 인자 아저씨가 거그야 인자 이씽깨로 우리 어무니가 인자 거그르 차자가서 우리 아들 좀 살리도라고 그리 가서 인자 사정을헝깨 인자 겡차레다가 여 줘써 인자 우리 크노빠는 인자 구니네르 앙 가고	그래가지고우리 이 진월면에 살았는데 그 우리 이제 아저씨가 거기에 이제 있으니까 우리 어머니가 이제 거기를 찾아가서 우리 아들 좀 살려달라고 그리 가서 이제 사정을 하니까 이제 경찰에다가 넣어 주었어 이제 우리 큰오빠는 이제 군인을 안 가고
인자 오빠드리 인제 두리 서이는 인자 구니네를 가따오고 그랜는디 그때는 인자구니네 우리 크노빠 갈 때는 구니네 가문 막 중는 파니라예	이제 오빠들이 이제 둘 셋은이제 군인을 갔다 오고 그랬는데 그때는 이제 군인에 우리 큰오빠 갈 때는 군인에 가면 막죽는 참이에요
그래 우르 오빠는 인자 구니네 가서 아저저 서울 가서 인자 겡찰로 이꼬 우리두째 오빠는 가가꼬 머머 포병잉가 머 보벵 보벵이라드냐 차 몰른 사람 차 몰코 댕기고 인자 거그다가 차에 부리 나가꼬 하상을 이버 가꼬 또 울 어무니 얼매나 또 세 키워노문긍깨 포라가꼬 또 거그에 멘헤 댕기고 벵워네 가서 거 뒫 수발허고	그래 우리 오빠는 이제 군인에 가서저 저 서울 가서 이제 경찰로 있고 우리 둘째 오빠는 가가지고 뭐 뭐포병인지 뭐 보병 보병이러더냐 차 모는 사람 차 몰고 다니고 이제 거기다가 차에 불이 나가지고 화상을 입어가지고 또 우리 어머니 얼마나 또 소 키워 놓으면 팔아가지고 또 거기에  면회 다니고 병원에 가서 거 뒷수발하고
그렁 거 험스롱 다 포라무꼬 또 서울 겡찰로 이씀성도 만날 용도늘 또 와서 가꼬 가제	그런 것 하면서 다 팔아 먹고 또 서울 경찰로 있으면서도 만날 용돈을 또 와서가지고 가지
월급또 바다쓸텐데	월급도 받았을 텐데
어찌 된 판 월그블 얼매나 바단능고 모지랭깨로 가서 도라지	어찌 된 판 월급을 얼마나 받았는지 모자라니까 가서 달라지
항 완날 와서 돈 도라고 그거 주고 저거 주고 자석뜰남사 우리 부모들 참 고상마니 해써요	만날 와서 돈 달라고 그것 주고 저것 주고 자식들 때문에 우리 부모들 참 고생 많이 했어요
응 그레끄망	응 그랬구먼
그래가 소 키워노문 긍깨 포라 뿌리고 또 세양치 묻 사가꼬 오문 또 그놈 질드려가꼬 또 그놈 좀 클만허먼 도니 아서부먼 또 포라 뿌리고	그래가지고 소 키워 놓으면그러니까 팔아 버리고 또 송아지  사가지고 오면 또 그놈길들여가지고 또 그놈 좀 클 만하면 돈이 아쉬우면아섭다는 아쉽다의 방언형 또 팔아버리고
만날 세나 미기고 또 거 울 아부지 혼차서 이를 그리 헝깨로 또 그 가마니 그렁거또 또 나도 저내고 아부지 혼차서 저냉깨로 노는 마니 되제 일본싸람들 노늘 마니 차질 해쩨	만날 소나 먹이고 또 그 우리 아버지 혼자서 일을 그리 하니까 또 그 가마니 그런 것도 또 나도 져 내고 아버지 혼자서 져 내니까 논은 많이 되지 일본 사람들 논을 많이차지를 했지
긍깨 그 논 수를 주자헝깨 자꼳 마니 공추를 해야 됭깨	그러니까 그 논 수를주려 하니까 자꾸 많이 공출을 해야 되니까
아부지가 짠해서 나도 저내곤 아부지도 저내고 그래노먼 동네 싸람드리   심 조코 막 씨열딸 둬딱 허싸코	아버지가 짠해서 나도 져 내고 아버지도 져 내고 그래 놓으면 동네 사람들이  힘 좋고 막 딸 두었다고 해 쌓고
먼 따리요 무슨 딸이오  씨열딸 졷둬따고	
씨열딸 졷둬따고	씨열딸 뒀다고
씨월따리 뭐에요	씨열딸이 뭐예요
인자 일 잘 허고 인자 그런 딸 둬따고 인자	이제 일 잘하고 이제그런 딸 뒀다고 이제
하 울 아부지허고 나허고 농사를 지무꼬 그라농깨 시지블 와도 이른 하나도 겁안나요	하 우리 아버지하고 나하고 농사를 지어 먹고 그래 놓으니까 시집을 와도 일은하나도 겁 안 나요
이른 하나도 거비 안 난디 뭉능 거이 조깜 이 지비도 무그 꺼는 마넌디 만날 그대로 괜찬트만 영감 먿 장사허고 그랜는디 인자 얼거때가꼬 인자 우리 씨어무니가 인자나를 쫌 몯 뽜서 그래	일은 하나도 겁이 안 나는데 먹는 것이 조금 이 집도 먹을 것은많은데 만날 그대로 괜찬더니 영감 뭐 장사하고 그랬는데 이제 얽었다 해가지고 이제 우리 시어머니가 이제 나를 좀 못 봐서 그래
그러면 그 결혼할 떼는 그럼 이 그거또 가튼 여기니까는 누가 아라서 중메를 헤꾸마뇨	그러면 그 결혼할 때는 그럼 이 그것도 같은 여기니까는 누가 알아서 중매를 했구먼요
가치 장사허다가 동넫뿌니 인자 장사허고	같이 장사하다가 동넷분이 이제 장사하고
울 오빠도 장사허고 인자 근디 울 엄니 인자 가치 인자 도와주로 장에 따라댕기고	우리 오빠도 장사하고 이제 그런데 우리 어머니 이제 같이 이제 도와 주러 장에 따라다니고
울 오빠 장사허는디 또 도와 주로 따라 댕기고 그러다가 동네 뿌니 인자 항께 이약 인자 우리 아저씨는 천지서 인자 중수를 해서 또 쩨께 온다고 얼거농깨 쩨께 온다고 인자 옹거이 째께 온다고 와도 그리 모뽀데요 그래가 상 거이 그냥 쯛 얄구지 그리 사라 가꼬	우리 오빠 장사하는 데 또 도와 주러 따라다니고 그러다가 동넷분이 이제 함께 이야기 이제 우리 아저씨는 사방에서 이제 중매를 해서 또 쫓겨온다고 얽어 놓으니까 쫓겨 온다고 이제 온 것이 쫓겨 온다고 와도 그렇게 못 보데요 그래가지고 산 것이 그냥 얄궂게 그렇게 살아가지고
헤헤결혼 헐 떼는 뭘 이러케 요새는 머 혼수도 망코 막 허자나요이	헤헤결혼할 때는 뭘 이렇게 요새는 뭐 혼수도 많고 막 하잖아요
머머 어디 뭐 헤 기여기 나심니까 머를 헤야 가꼬 고로코 머 이렁 거뜰 그떼는	뭐뭐 어디 뭐 헤 기억이 나십니까 뭐를 해가지고 그렇게 뭐 이런 것들 그때는
요 지비서 농이 오문	이 집에서 농이 오면
인자 지믈 인자 오깜허고 시지블 이꼬올 오깜허고 인자 돈 좀 허고 도니자네저네는 곡써글 줘요 싸를 항 가마니 준다든지 머 한 서믈 준다든지 그리주믄 주고 인자 또농허고 온 녀가꼬 오라고 농 해 주고 그러믄 인자 우리드른 인사옫 해 가꼬 오지요	이제짐을 이제 옷감하고 시집을 입고 올 옷감하고 이제 돈 좀 하고 돈이 아니라 전에는 곡식을 줘요 쌀을 한 가마니 준다든지 뭐 한 섬을 준다든지 그렇게 주면 이제 또 농하고 옷 넣어 가지고 오라고 농 해 주고 그러면 이제 우리들은 예단인사옷은 예단의 뜻 해가지고 오지요
인사오슨 친척드레게 주롣	음 예단은 친척들에게 줄 옷
인제 처채는 씨어메 씨아배 요 이부자리허고	이제 첫째는 시어머니 시아버지 요이부자리하고
인잗 또 옫 허고	이제 또 옷하고
또 인자 지바네 인자 지바니 마느문 자그나부지들 인자 자그너무니들 모도 저네우리들 시집올 때는 자그나부지드른 두루막 해 가꼬 오고	또 이제 집안에 이제 집안이 많으면 작은아버지들 이제 작은어머니들 모두 전에 우리들 시집올 때는 작은아버지들은 두루마기 해가지고 오고
자그너무니드른 인자 저구리 시방 저고리라 그러지만 저네는 저구리 인자 그거해 가꼬 오고	작은어머니들은 이제 저구리 시방 저고리라 그러지만 전에는 저구리 이제 그것 해 가지고 오고
우리 엄니가 인자 질싸믈 잘 헝께 밍기 밍기저구리 인자 점부 자으너무니드른 해다 해주고 해오고 또 자그나부지드른 두루막 해오고 인자 어런들 인자 또 먿 당숭모 인자저런 분드른 인자 보신 항 커리썩	우리 어머니가 이제 길쌈을 잘 하니까 명주 명주저고리 이제 전부 작은어머니들은 해다 해 주고 해 오고 또 작은아버지들은 두루마기 해 오고 이제 어른들 이제 또 뭐 당숙모 이제 저런 분들은 이제 버선 한 켤레씩커리는 켤레의 방언형 웃음
그러치요이	그렇지요
보신 항 커리썩 점부 해가꼬 오고 그래찌요	예 버선 한 켤레씩 전부 해가지고 오고 그랬지요
그래 인자 고상을 해 농깨로 지금도 여 농 아네 옫 시지본 옫 이써요 아까와서나뚜고 거 채리 봐요	그래 이제 고생을 해 놓으니까 지금도 이 농 안에 옷 시집온옷 있어요 아까와서 놔두고 그것 쳐다봐요
멩배 즉 멩배 적쌈도 열 깨믄 한 죽	무명 즉 무명 적삼도 열 개면 한 죽
멩배 적쌈도 한 죽 저구리도 한 죽 치매도 한 죽 채로 그 때 배카레로 가꼬 와씨무니나 나뚜고 짤라서 쓰 써 씨먼 허꺼인디 먿헌다고 싹 싹 짱그라서 가이로 짤라서오슬 맨 맨드라 가꼬 한 죽썩 땅 양쪼글 딱딱 끼매서 그러가 농을 여 다뿍 두 농을 해주데	무명 적삼도 한 죽 저고리도 한 죽 치마도 한 죽 차라리 그  때 베 가래로 가지고 왔으면 놔두고 잘라서 썼으면 할 것인데 뭐한다고 싹싹 잘라서짱글다는 자르다의 방언형 가위로 잘라서 옷을 만들어가지고 한 죽씩 딱 양쪽을 딱딱 꿰매서그렇게 해가지고 농을 넣어 가득 두 농을 해 주데
아이고 마닌네여	아이고 많이 있네요
게양 우리 소누에 언니가 나는 얄구께 쩨까이 해 가꼬 주더마는 저거는 오슬 죽쭈기 해서 준다고 또 와서 띵깡을 노라서 또 우런니가 똗 똗 좀 돌라가가고	그냥 우리 손위 언니가 나는 얄궂게 조금 해가지고 주더니만 저것은 옷을 죽으로 해서 준다고 또 와서떼를 써서 또 우리 언니가 또 좀 훔쳐가고
나느 얄구께 해주 해 가꼬 시집보내드마느 저거는 그 마니 해 준다 그렁깨 우르아부지가 누구 거치 그러자네 이 우리 서내기는 고상도 마니 허고 해 그리 해 줘야 된다세도 사 주꺼인디 세도 함 마리 준다 핸는디 몬 쭈는디 오시나 젤 마니 해 줘야지 글드만여그 옹깨 오시 마나 농깨 씨어메가 심녀늘 사라도 옫 항가지도 안 해 주데요	나는 얄궂게 해 주 해가지고 시집 보내더니 저것은 그 많이 해 준다 그러니까 우리 아버지가 누구같이 그런 것이 아니라 이 우리 선악이는 고생도 많이 하고 해 그렇게 해 줘야 된다 소도 사 줄 텐데 소도 한 마리 준다 했는데 못 주는데 옷이나 제일 많이해 줘야지 그러더구먼 여기 오니까 옷이 많아 놓으니까 시어머니가 십 년을 살아도 옷 한가지도 안 해 주데요
그렁거이 이꼬도 시방 인자 나마가꼬 저저그 시방 멩배옫 그렁 거는 저딴 나 농쏘게다 여노코 채리 봐요 인자 나 주금 때 되문 인자 가따 내삐리등가 어쩌등가	그런것이 입고도 시방 이제 남아가지고 저 저기 시방 무명 그런 것은  내 농 속에다 넣어 놓고 쳐다봐요 이제 나 죽으면 때 되면 이제 가져다 내버리든지 어쩌든지
중가네 중가네 그걸 스 아줌마드리 사로 댕기데요 사러 댕김성 포라근디 싸디 싸게 멩옫 그렁 거를 싸디 싸게 사 가꼬 가능나는 안 폰데써요	중간에 중간에 그걸 아주머니들이 사러 다니데요 사러 다니면서 팔라 그런데 싸게 싸게 무명옷 그런 것을 싸디 싸게 사가지고 가는나는 안 판댔어요
그거를 인자 어디 수이 가틍 걸로 팔라나	그것을 이제 어디 수의 같은 것으로팔려나
몰라요 먿 헐라고 그렁고 그 땓 한중 사러 댕기드만 나 폴도 안 허고 나는	몰  라요 뭐 하려고 그런지 그때 한창 사러 다니더니 나 팔지도 않고 나는
아니 여런데 거 사람 주그면 그렁 거 입짜나요	아니 이런 데 그 사람 죽으면그런 것 입잖아요
지그믄 수이는 새로 맨드리는데요 몰라 그 때는 인자 글로 폴라 그랜능가 어짼능가인자 수이는 난자가 얼매 안 되지 안쏘	지금은 수의는 새로 만드는데요 몰라 그때는 이제 그것으로 팔려고 그랬는지 어쨌는지이제 수의는 나온 지가 얼마 안 되잖소
겨론 헤 가지고 오 여 오니까 시데게 누가 어떤 데가 시꾸드리 이뜽가요 누구누구 이뜽가요	결혼 해가지고 오 여기 오니까 시댁에 누가 어떤 데가 식구들이 있던가요누구 누구 있던가요
인자 오 남맨디 오 남맨디 인자 씨누는 여어 부리고 씨누는 여어 뿌리고 인자 씨아재들 미테 세 개 나허고 인자 우리 영감허고 인자 그래치요	이제 오남매인데 이제 시누이는 여의어 버리고 시누이는 여의어 버리고 이제 시동생들밑에 셋 나하고 이제 우리 영감하고 이제 그랬지요
긍깨 너히 인자 일곡 권세기 사라찌요	그러니까 넷이 이제 일곱 식구가 살았지요
씨어무니 씨아부지 나 일고 권세기 살고	시어머니 시아버지 나 일곱 식구가살고
그 한 지베서 다 삼니까	그 한 집에서 다 삽니까
지비 쫌 커떤 모양이네요	집이 좀 컸던 모양이네요
요짜게 요 지비	이 쪽에 이 집이
그 어찌게 그러케	아 그 어떻게 그렇게
여여 여그에는 인자 아래차	이 이 여기에는 이제 아래채
아하	아하
아래차아 지플 가꼬 이농깨 게 들고 계 나고 그렁개 그 미찐 보돕씨 쩨까만  노푸게 해농깨 미치 캉캄해요 쩌귿 동네 노인드른 모도 와서 우리 아래빵에 모도 자고 그러데 먿	아래채 짚을 가지고 이어 놓으니까 기어 들고 기어 나고 그러니까 그 밑은 겨우 조그만 높게 해 놓으니까 밑이 캄캄해요 저기 동네 노인들은 모두와서 우리 아랫방에 모두 자고 그러데 뭐
사랑방처럼	사랑방처럼
덕썽녕가미라 그럼서러 영가미 올 띠도 갈 띠도 엄는 영가미 인자 집찜마동 인자 지플 가꼬 덕썩 그검 맨드라 주고 그냥 입 어더무꼬	멍석영감이라 그러면서 영감이올 데도 갈 데도 없는 영감이 이제 집집마다 이제 짚을 가지고 멍석 그것 만들어 주고 그냥 입 얻어먹고
그르고 산다고 우리 아래빵에 와서 살고	그렇게 산다고 우리 아랫방에 와서살고
저녀그로 자고 인자 또 나주로는 너무지비 가 먿 덕썩또 맨 맨드르고	저녁으로자고 이제 또 낮으로는 남의 집에 가 뭐 멍석도 만 만들고
방석도 맨드리고 그렁 거 인자 영끔서로 인자 너무지비 나주로는 가고 잘 띠가엄써 우리지비 잔다고 자고 그러데	도래방석도 만들고 그런 것이제 엮으면서영끄다는 엮다의 방언형 이제 남의 집에 낮으로는 가고 잘 데가 없어 우리집에 잔다고 자고 그러데
거 우리드리 시집와 가서도 또 뒨날 첟 쌔보게 인자 이러나서 똗 어르니라고점부 문녀러노고 바가테서 절허고	그 우리들이 시집와서도 또 뒷날 첫 새벽에 이제 일어나서 또 어른이라고 전부 문 열어놓고 밖에서 절하고
새봉마동 머리 비꼬 첟쌔보게 이러나서 머리 비꼬 또 오 까라 입꼬	새벽마다머리 빗고 첫 새벽에 일어나서 머리 빗고 또 옷 갈아입고
엔나레 그레찌요	음 옛날에 그랬지요
절허고 그래써요	절하고 그랬어요
거 인자 씨아바이 델로 와서 아부지 절 바드시이다 그러먼 인자 또 큼방으로 오문 난자느 기찬타 허지마라	그 이제 시아버지 데리러 와서 아버지 절 받으십시오 그러면 이제 또 큰방으로 오면 나중에는 귀찮다 하지 마라웃음
네가 기찬차나 나가 기찬타 오지 마라	네가 귀찮지 않고 내가 귀찮다 오지 마라
그러지요 그 엔날 구식 껴론 헤쓸 꺼시고요	그러지요 웃음 그 옛날 구식 결혼했을 것이고요
지비서	예 집에서
지비서이 어떤 인제 절차로 순서가 어뜨케 되고 어뜬 시그로 결호늘 함니까	집에서 어떤 이제 절차로 순서가 어떻게 되고 어떤 식으로 결혼을 합니까
인제 장개 온다고 인자 가매 타고 오고	이제 장가온다고 이제 가마 타고 오고
처메는 지미 오고 젤로 처메 인자 중시내비가 언자 서로 영겨를 해 주문 인자양쪽 허라글 마트문 인자 사싱이라고 와요	처음에는 짐이 오고 제일 처음에 이제 중신아비가 이제 서로 연결을 해 주면 이제 양쪽 허락을 맡으면 이제 사성이라고 와요
인자 그를 써 가꼬 인자 사싱을 인잗 펜지봉투를 하나 가따 주문 우리 지비로인자 실랑찌비서 가꼬 오먼 인자 그놈 바다 노코 이씨문 인자 또 메친 날 인자 또 지몬다그래요	이제 글을 써가지고 이제 사성을 이제 편지 봉투를 하나 가져다 주면 우리 집으로이제 신랑집에서 가지고 오면 이제 그것 받아 놓고 있으면 이제 또 몇 일 이제 또 집 온다그래요
금 인잗 저 하동자 여그서는 하동장으 가서 장농 사고	그러면 이제 저 하동장여기서는 하동장에 가서 장롱 사고
또 우껄리미라고 인자 또 우돋 세 벌썩 세 벌썩 허고 인자 그놈 지고 농 지고그래가꼬 둘썩 둘썩 인잗 징꾸니 두리 인자 지고 와요 농 한짝썩 지고 혼차서 한 항 커리를 다 몬 징깨	또 웃걸림이라고 이제 또 윗옷 세 벌씩 세 벌씩 하고 이제 그것 지고농 지고 그래가지고 둘씩 둘씩 이제 장꾼이 둘이 이제 지고 와요 농 한짝씩 지고 혼자서한 한 채를 다 못 지니까
거 따 인자 짐 그놈 지고 여코 인잗 갈라서 여코 그래가꼬 오므 오든 거스글 인자 우리는 그냥 도느로 주데요 양서깝쓸	거기에다 이제 짐 그것 지고 넣고 이제 갈라서넣고 그래가지고 오면 오던 거시기를 이제 우리는 그냥 돈으로 주데요 양식값을
인자 상구 저네 엄는 지비는 쌀로 주고	이제 사뭇 전에 없는 집은 쌀로 주고
음음	음음
근디 우리 집은 우리 농사가 망코 그렁깨 도늘 얼매가 완능구 인자 모르제 나는 인자 인자 도늘 이로 주고	그런데 우리집은 우리 농사가 많고 그러니까 돈을 얼마가왔는지 이제 모르지 나는 이제 이제 돈으로 주고
낭깐 이쪽 시데게서 도늘	그러니까 이제 시댁에서 돈을
그럼니까	그럽니까
그거 가지고 머 하라고	그것 가지고 뭐 하라고
인작 인작 머 장만헐 인자 그럼 우껄리만 허먼 인자 우리 지비서 인잗 소곧 거틍 거	이제 이제 뭐 장만할 이제 그러면 웃걸림만 하면 이제 우리 집에서 이제 속옷 같은 것
신 그렁 걸 점부 인자 우리 지비서 사거등 그렁걸 사고 인자 그러라고 인자 주  는디 인잗 우리잗 또 우리지비서는 인자 우 그 씨대게 인자 또 절꺼슥 헌다 절깝씨라고 인자 똗 자그나부지차 자그너무니들 그리 또 오슬 해 가꼬 오고	신 그런 것을 전부 이제 우리집에서 사거든 그런 걸 사고 이제 그러라고 이제 주는데 이제 우리집 또 우리집에서는이제 우 그 시댁에 이제 또 절 거시기한다 절값이라고 이제 또 작은아버지 작은어머니들 그리 또 옷을 해 가지고 오고
절깝씨랑 거슨	음 절값이란 것은
지그믄 도느로 안 주능가요	지금은 돈으로 주잖아요
절 바드믄 예식짱에서 절 바드믄 도니 긍깨 그그 인자 그 갑씨지 인자 옫 해다주능 거는 저네는 저네는 오슬 해다 줜넌 지그믄 인자 도느로 안 주능가요	절 받으면예식장에서 잘 받으면 돈이 그러니까 그그 이제 그 값이지 이제 옷 해다 주는 것은 전에는전에는 옷을 해다 주었는데 지금은 이제 돈으로 주잖아요
그믄 오슬 헤다 준다는 마른 자그너머니가 오슬 헤헤서 주셔따고요	그러면옷을 해다 준다는 말은 작은어머니가 옷을 해 해서 주셨다고요
이 인자 우리 시시 친정에서 자나부지드른 두루막 허고	아 이제 우리 시시 친정에서 작은아버지들은 두루마기 하고
아아아	아아아
자너머니드른 저고리허고	작은어머니들은 저고리 하고
인사 옫 인사오슬	예단 예단을
인사오슬 그리 해 가꼬 시방은 점부 도느로 안 주능가요 절 바드믄	예단을 그리 해가지고 지금은 전부 돈으로 주잖아요 절 받으면
예예예 그러치요	예예예 그렇지요
그르니까 절깝씨라 인자 옫 해다주능	그러니까 절값이라 이제 옷 해 다주는
응응	응응
그래가꼬 인자 시지비라고 가매 타고 인자 또 나를 바다가꼬 게론나를 바다가꼬실랑은 가매 타고	그래가지고 이제 시집이라고 가마 타고 이제 또 날을 받아가지고 결혼날을 받아가지고 신랑은 가마 타고
인제 또 상각 아부지는 상각 딸코	이제 또 위요 아버지는 위요 따르고
또 칭구들 우인들허고	또 친구들 우인들하고
우인드리 인자 함 지고 또 따라와 하고	우인들이 이제 함 지고 또 따라와서하고
그래 인제 음음 이읻 먿 예를 지내지요	그래 이제음 뭐 예를 지내지요
에 에를	예 예를
지내고 인자 날라게 해서 인자 하리빰 자고 오는 사람	예 지내고 이제 빨리 해서 이제 하룻밤 자고 오는 사람
으흠	으흠
또 이틀빰 자고 오는 사람	또 이틀 밤 자고 오는 사람
나를 바드문	날을 받으면
시글 인제 심부지베서 하자나요	식을 이제 신부집에서 하잖아요
식 하고 하루빰 자고	식 하고 하룻밤 자고
인자읻	이제
하루나 이틀빰 자고 오고	하루나 이틀 밤 자고 오고
인자 실랑이 인자 장개 와서 하리 시여 오는 사람	이제 신랑이 이제 장가와서하루 쉬어 오는 사람
으흠	으흠
뒨날 인자 날라게 해써요 뒨날 바로 오는 사람	뒷날 이제 빨리 했어요 뒷날바로 오는 사람
인자 뒨날 올 싸라믄 인자 오늘 연방 한저리 또 치닌허고 한저리는 또 떡 허고 한쪼가리는 떠그 지그믄 방애씨리 이쩨마넌 그때는 방애씰도 엄꼬	음 이제 뒷날 올사람은 이제 오늘 계속 한쪽에서 또 사람 접대하고친인은 사람들을 접대하다의 뜻으로 추정됨 한 쪽은쪼가리는 쪽의 뜻 또 떡하고 한 쪽은 떡 지금은 방앗간이방앳실은 방앗간의 방언형 있지마는 그때는 방앗간도없고
동구리 국썩 그렁 거 다 인자 친지 친정아서 사 가꼬	동고리  그런 것 다 이제 친지 친정에서 사가지고
동구리예다가 또 찰떡 항 거 메떡 항 거	동고리에다가 또 찰떡 힌 것 메떡한 것
연방 치닌 허고 나머 인자 또 동네싸람들 한저네 인자 그 가리를 뽀서가야데요 안쩌게는	계속 대접하고 나면 이제 또 동네 사람들  그 가루를 빻아야 돼요 안쪽에서는
읻읻 그래고 또 하하리빰 자는 나른 인자 시는 날 이틀빰 자는 나른 인자 시는날 인자 허고 그러허믄 인잗 또 시는 나른 인자 아척빱 해 노믄 친척뜰 먿 지바네 머 오빠들 먿 동생들 머이 해 가꼬	이이 그리고 또 하 하룻밤 자는 날은 이제 쉬는 날 이틀밤 자는 날은 이제 쉬는 날 이제 하고 그리하면 이제 또 쉬는 날은 이제 아침밥 해 놓으면친척들 뭐 집안의 뭐 오빠들 뭐 동생들 뭐 해가지고
실랑 심부 또 바블 한 상에 노코 또 떼 미기고 서로 떼 미이라 자바서 시시기고해우 해우싸믈 싸가꼬 또 거따가 꼬막 껍떼기 머 게기 뻬따우 그렁 걸 여 가꼬 실랑을 무그라  싸 여주고	신랑 신부 또 밥을 한 상에 놓고 또 떼어 먹이고 서로 떼어 먹여라 잡아서 시 시키고 김 김을 싸가지고 또 거기에다가고막 껍질 뭐 고기 뼈뻬따우는 뼙따귀의 뜻 그런 것을 넣어가지고 신랑을 먹으라 웃음싸서 넣어 주고
웨 놀릴려고 그렁가요	아 왜 놀리려고 그러나요
인자 거 인자 암 무거믄 인자 또 인자 꺼꾸루 다라 매 노코 인자 뚜드리고	아 이제 그 이제 안 먹으면 이제 또 이제 거꾸로 매달아 놓고이제 두들기고
그런 세상을 살다가 인자 금	그런 세상을 살다가 이제
그 인제	그 이제
지그믄 조은 세상 아잉가요	지금은 좋은 세상이잖아요
실랑은 그러케 다라이러케 다루능 거슨 어디나 다 이찌요 거니까 머	신랑은 그렇게 매달아 이렇게 다루는 것은 어디나 다 있지요 그러니까 뭐
실랑 다라 매능 거는 인자 천날 저녁 그르케 해도 그러 인자 낼 갈꺼 거틈 천날 저녀 다라매고	아 신랑 매다는 것은 이제 첫날 저녁 그렇게 해도 그러 이제 내일 갈것 같으면 첫날 저녁 매달고
그라너문 재인꺼름 오먼 사을마네 또 재인꺼르믈 가요	그렇지 않으면 장인걸음 오면 사흘만에 또 장인걸음 가요
제인꺼르미 뭐에요	장인걸음이 뭐예요
사을마네 또 인자 처가찌비 인자 또 인사허러 가요	사흘만에 또 이제 처갓집에이제 또 인사하러 가요
사을마네 시덱 지브로 가따가 다시 또 처처가에 가요	사흘만에 시댁으로 갔다가 다시 또 처 처가에 가요
아문 인자 시 오늘 시집 요지브로 또 시집 와쓰믄 하리 시 가꼬 사을마네 또똗	아무렴 이제 시 오늘 시집 이 집으로 또 시집왔으면 하루 쉬어가지고 사흘만에 또
또 처가찌비 인자	또 처갓집에 이제
어그는 지비 가까우니까 얼릉 가따 올 쑤 인는데 먼 데는 그러케 안데자나요	여기는 집이 가까우니까 얼른 갔다 올 수 있는데 먼 곳은 그렇게 안 되잖아요
인자 어짼능고 모르지요 인자 우리드른 인자 긍깨 저네는 보통 개즉헌 디로 마니 안 와능가요	이제 어땠는지 모르지요 이제 우리들은 이제 그러니까 전에는 보통 가까운 데로 많이 오잖아요
서르 이 동네 저넫 똥네 중시내비가 댕김스로 중시늘 양쪼그로 해 가꼬	서로 이동네 저 동네 중신아비가 다니면서 중신을 양쪽으로 해가지고
인자 선도 베기고 인자 그러장깨 개직헌 디로 저네는 마니 해찌요	이제 선도보이고 이제 그러려니까 가까운 데로 전에는 많이 했지요
그 사연마	아 그 사연만
지그믄 머 외국써도 오고 머 서울써도 오고 그래찌마는	지금은 뭐 외국에서도오고 뭐 서울에서도 오고 그랬지마는
저네는 서르 이 동네 저 동네 서륵 그래가꼬 마니 해찌요	전에는 서로 이 동네저 동네 서로 그래가지고 많이 했지요
거 처가에도 사을마네 함 번 가서 또 인사 드리고	음 그 처가에도 사흘만에 한 번 가서 또 인사 드리고
무슨 노무 떠근 하수핀상 떡 쏙 눈는 떡꾹써근 이고 댕기고 사을마네 오믄 인자 또또 떡 해가꼬 또 줘요	무슨 놈의 떡은 항상 떡속 넣는떡바구니는 이고 다니고 사흘만에 오면 이제 또 또 떡 해가지고 또 줘요
엔나레는 헐 꺼시 업씅께 따로 그냥 떠기 제일 저기	아 옛날에는 할 것이없으니까 따로 그냥 떡이 제일 저기
떠기 제리라 사을마네 오먼 또 그냥 모뽀낸다오 또 그 떠글 해서 또 또 이 보내고	떡이 제일이야 사흘만에 오면 또 그냥 못 보낸다고 또 그 떡을 해서 또 또 이어 보내고
떡또 잘 헌디 배 고푼 세상이 데농께 그냥 저네는 떡또 그리	떡도 잘 하는데배고픈 세상이 돼 놓으니까 그냥 전에는 떡도 그렇게
그러지요	그렇지요웃음
마니 해찌예	많이 했지요
귀항 거시지요	귀한 것이지요
시방 머 해나도 떡 묵또 아너고	예 지금 뭐 해 놔도 떡 먹지도 않고
망구에 조은 세상 아이요	만고에 좋은 세상 아니요
그러케 그럳 그런 데 옌날 그 호년식 떼는 어떤 음식뜨를 주로 줌비하등가요떡 말고 그바께 장만항 거뜨리	그렇게 그런 그런 곳 옛날 그 혼인식 때는 어떤 음식들을주로 준비하던가요 떡 말고 그밖에 장만한 것들이
전 부치고 데지 잡꼬 머 내나 그렁 거이지요 뭐	전 부치고 돼지 잡고 뭐 내나그런 것이지요 뭐
유개허고	유과 하고
유게허고	유과 하고
인제 지그믄 까자가 인제 저네는 유과	이제 지금은 과자가 이제 전에는 유과
유개를 해 가꼬 봉 에	유과를 해가지고 봉 예
겔혼식 날자버 노먼 메칠 저네부터 술 해 여코 그냥 그 머스 머이라니 저네 술치로 댕기는 사람들 아이고	결혼식 날 잡아 놓으면 며칠 전부터 술 해 넣고 그냥 그 뭐뭐냐 전에 술 단속하러 다니는 사람들 아이고
저네는 살링게 찌권도 나무해 노먼 살링게 찌궈니 와서 야다이고	전에는 산림계 직원도 나무해 놓으면 산림계 직원이 와서 야단이고
세무서에서 와서	아 세무서에서 와서
세무서애서 또 술 치로 댕기고	세무서에서 또 술 단속하러 다니고
수리 막 복짝뽁짝 끈능 거시 저 세무서애서 낼 모레 인자 겔혼헐 때 이자걸러 가꼬 무글 쑤를 큰 도가지에다가 인자 지반 만헌 사람든 큰 도가지에다 막 싸를여나무 되썩 꼬두바블 쩌서 수를 해 여 노코 복짝뽁짝 끄르믄 세무서 찌궈니 오먼 그냥거짐말로 금뚜주를 치고 애기 나 나따고	술이 막 보글보글 끓는 것이 저 세무서에서 웃음 내일 모레 이제 결혼할 때 이제 걸러가지고 먹을 술을 큰 독에다가 이제 집안 넓은 사람들은 큰 독에다 막 쌀을 여남은 되씩 고두밥을 쪄서 술을 해 넣어 놓고 보글보글 끓으면 세무서 직원이 오면 그냥 거짓말로 금줄을치고 아기 낳 낳았다고
부정 인는다고 몬 뜨로게	부정 탄다고 못 들어오게
금뚜주를 연방 치고 야다니 노먼 그거또 난중에는 소양도 엄씨 치로 드로고 벌그블 물고 막 그래써요 쩌	금줄을 계속 치고 야단을 하면 그것도나중에는 소용도 없이 단속하러 들어오고 벌금을 물고 막 그랬어요 저
엉 그레찌요 그 다메 겨로늘 헤 가지고 그럼 인자 신혼 살리믄 어어디에서 이러케 그냥 한한데서 사라씀니까	엉 그랬지요 그 다음에 결혼을 해가지고 그럼 이제 신혼 살림은어디에서 이렇게 그냥 한 한 곳에서 살았습니까
저네는 인자 큰메느리는 큰지베 한테 어른들허고 살고 자근메느린 인자 저그믈내 노코 그래찌요	전에는 이제 큰며느리는 큰집에 한데 어른들하고 살고 작은며느리는이제 분가를 내어 놓고 그랬지요
그 큰메느리세요	음 그 큰며느리세요
큰며느리니까 그러믄 한데서 사션네	아 큰며느리니까 그러면 한데서 사셨네
아이 따로 사라써요 그렁깨	아이 따로 살았어요 그러니까
아 한참 이따가 나중에 따로 사라찌요	음한참 있다가 나중에 따로 살았지요
구년 넉딸마네	구 년 넉 달만에
가치 산 지 구년 넉딸마네	아 같이 산 지 구 년 넉 달만에
꼭 살라고	꼭 살려고
멍쳉이 시늉을 허고 그리 박때를 해도 그냥 우리 친정어무니가 뻴따구마 나마도거그 사라야 억찌 써야 된다고	멍청이 시늉을 하고 그렇게 박대를 해도 그냥 우리 친정어머니가 뼈만 남아도 거기 살아야 억지 써야 된다고
또 우리 오빠는 남자는 구니네 가서 중능 거이고	또 우리 오빠는 남자는 군인에가서 죽는 것이고
여자는 그 사리팓 드러가무 그 자리에서 뻽따구가 나마도 그 지비서 사능 거인디나오기만 나오먼 우리 지비는 발 몯 뗄꺼잉께 몬 나오라제 암 디도 가본 디는 업쩨	여자는 그 사립문 들어가면 그 자리에서 뼈가 남아도 그 집에서 사는 것인데 나오기만 나오면우리 집에는 발 못 댈 것이니까 나오지 말라고 하지 아무 데도 가본 곳은 없지
갈 떼가 엄네	갈 곳이 없네
갈 띠가 엄서 그냥 주그나 사나 살고 울 엄니 핑상 친정 어무니는 뻴따우만 나마도 사라라 뻴따우만 나마도 사라라	갈 곳이 없어 그냥 죽으나 사나 살고 우리 어머니평생 친정어머니는 뼈만 남아도 살아라 뼈만 남아도 살아라
그래가 그냥 멍청이 시늉으로 상깨 긍깨 날보고 멍체이라고	그래가지고 그냥멍청이 시늉으로 사니까 그러니까 나보고 멍청이라고
동네 싸람도 멍체이라고 그러고 나를	동네 사람도 멍청이라고 그러고 나를
지바네서도 점부 멍체이라고 그냥 멍청허이 밤만 무꼬 패먼 마꼬	집안에서도전부 멍청이라고 그냥 멍청하게 밥만 먹고 패면 맞고
그냥 그르고 사라써요	그냥 그렇게 살았어요
그래가 인자 구년 넉딸마네 인잗 구년 살고는 인자 하도 몯 쌀거태서 나가 인자 눈치도 생기고 인자 꾀도 쪼깜 나고 그래서 실랑을 보고 인자 애기 두 개 세 개로 나노코 나 어디 인자 그러자 인자인자 우리 여 너메 똥네 나허고 가치 시지본 사립 도망을간는디	그래가지고 이제 구 년 넉 달만에 이제 구 년 살고는 이제 하도 못 살 것 같아서내가 이제 눈치도 생기고 이제 꾀도 조금 나고 그래서 신랑보고 이제 아이 둘 셋 낳아 놓고 나 어디 이제 그러자 이제 이제 우리 이 너머 동네 나하고 같이 시집온 사람이 도망을갔는데
진주여게 가뜨라네요	진주역에 갔더라네요
진주여게 가가꼬 이씅깨로 누가  할메가 하나 와서 날 따라 갈라냐 그래따라 간당깨 주그 딸레 지비 식땅허는 디다 마를 해 주르떠다네요	진주역에 가가지고 있으니까 누가  할멈이 하나 와서 날 따라 가겠느냐고 그래서 따라간다니까 자기 딸네집에 식당하는 데다 말을 해 주더라네요
그래 따라 간는디 성거가 끈나 가꼬성거 때가 데야 가꼬 성거 헌다고 가치항께 머 할메 하나허고 두리 인는디 식땅에 거그 두리 인는디 그 할메가 성거허러 간다가는디 일씨를 모니거뜨라네요	그래서 따라갔는데 선거가 끝나가지고선거 때가 되어가지고 선거한다고 같이 하니까 뭐 할멈 하나하고 둘이 있는데 식당에 거기 둘이 있는데그 할멈이 선거하러 간다 가는데 하루도 못 있겠더라네요
그래서 또 쫃 도로 와 뿌리가꼬 그 인잗 욷 그 우리 칭구가 인자 가치 시지블 와농깨 그 칭구가 나도 몬 쌀거따고 그렁깨로 사능 거는 망구에 배 부르게 무꼬 살 건는디그 할메가 무다니 메치른 이썬는디 그 할메가 칟 거 성거허러 간다고 가뿌링깨로 일씨로  그 막 애기드리 보고 자와 몬 니꺼뜨라고	그래서 또 도로 와 버리고 그 이제 그 우리 친구가 이제 같이 시집을 와 놓으니까 그 친구가 나도 못 살겠다고 그러니까 사는 것은 만고에 배부르게 먹고 살겠는데 그 할멈이 괜히 며칠은 있었는데 그 할멈이 그 선거하러 간다고가 버리니까 하루도 그 막 아이들이 보고 싶어 못 있게더라고
그 지비도 애기를 두 개로 나 노코 간는디	그 집도 아이를 둘 낳아 놓고 갔는데
일씨로 모니꺼 해서 그냥 와따고 그리왇	하루도 못 있겠어서 그냥 왔다고 그래서 왔
그래 그리 이야글 해 주글 나도 가볼라고	그래서 그렇게 이야기를 해 주길 나도 가 보려고 웃음
나도 가 볼라고 인자 우리 지비 인자 울큰 오빠가 나올 쩨는 마를 허고 나와야지 멀리 나오먼 우리 살림 모 쌍깨 그래 아라고 저네는 멀리 도망을 가먼 막 장개 드리도라고 처가찌비 울러 가고 날리가 나고 그래써요 저네는	나도 가 보려고 이제 우리집 이제 우리큰오빠가 나올 적에는 말을 하고 나와야지 멀리 나오면 우리 살림 못 사니까 그리 알라고 전에는 멀리 도망을 가면 막 장가 들여 달라고 처가에 올라가고 난리가 나고 그랬어요 전에는
그레요	아 그래요
그래농깨 우리 살림 모 싼다고 그러글 지서에 가서 말허고 그로라는 뽀느로 지서에 나가 그럴쩨는 숭경이 무수바서 어리 기는디 어찌 지서를 가꺼잉가요	그래 놓으니까우리 살림 못 산다고 그러길래 지서에 가서 말하고 그러라는  지서에 내가 그럴 적에는순경이 무서워서  기는데 어찌 지서를 갈 것인가요
그래서 인자 스 실랑이라고 보고 인자 나가 주거도 몬 살 거틍깨	그래서 이제신랑보고 이제 내가 죽어도 못 살 것 같으니까
나 갈란다고 당신도 날 배르 배 차아서 뚜드라 패고 씨어메는 씨어메대로 그르고 씨아제드른 씨아제들대로 날 멍체이라 허고 나 몬 쌀 거틍깨 나 가꺼잉깨 가서 싱모사라가꼬 도는 보내 줄 꺼잉깨 우리 애기들 하꾜는 당신돋 글 몯 빼와가꼬 그렁깨 나도우리 애기들 개출 거잉깨 난 어디 가서 어디 정해가 살기는 안 허꺼잉깯 싱모 사라가 돈보내 줄 꺼잉깨 그러라 허드만	나 가겠다고 당신도 날 배를 배 차서 두드려 패고 시어머니는 시어머니대로 그러고 시동생들은 시동생대로 날 멍청이라고 하고 나 못 살 것 같으니까 나 갈 테니 가서 식모 살아가지고 돈은 보내 줄 테니까우리 아이들 학교는 당신도 글 못 배워가지고 그러니까 나도 우리 아이들 가르칠 테니까 난어디 가서 어디 정해가지고 살지는 안 할 테니까 식모 살아가지고 돈 보내 줄 테니까 그러라 하더구먼
실랑이 댕김서 방을 어더 가꼬	신랑이 다니면서 방을 얻어가지고
내라치메 지믈 실로 오꺼인디 나는 그 그렁 중도 모리고 저녀게 싹 요렁 거를싹 싸라데요	내일 아침에 짐을 실러 올 것인데 나는 그 그런 줄도 모르고 저녁에 싹 이런 것을 싹 싸라데요
싸라 싹 거더가 싸라 그러글렌 싸 노코 나는 우리 지비는 이렁 거 안 가 가꺼이라 그렁깨 수를 항 치해드륵 무꼬 와가꼬는 만땅고 무꼬 와서 걸 싹 싸라글레 나 이거 싸노키는 싸 나도 우리 지비는 나는 안 가 가꺼이다 나가 나는 옴만 가 가제 안 가가꺼이라그래뜽만	싸라 싹 걷어가지고 싸라 그러길래 싸 놓고 나는 우리집에는 이런 것 안 가지고 갈거야 그러니까 술을 아주 취하도록 먹고 와가지고는 만취하도록의 일본식 발음 먹고 와서 그걸 싹 싸라길래 나 이것 싸 놓기는 싸 놔도 우리집에는 나는 안 가 가겠다 내가 나는 옷만 가지 안 갈거야 그랬더니만
수를 얼매나 무거뜬지 복짭해농깨 고 얼매나 무거뜬지 쎄가 안 도라가데요	술을 얼마나 먹었던지 복잡해 놓으니까 그 얼마나 먹었던지 혀가 안 돌아가데요
그래서 그냥 싸 노코 인자 싸라 싸서 인자 해나 때리까 시퍼서 싸라 싸아서 인자싸 노코 인자 술찌메 누 자부루글레 나도 인자 따라 자찌요이	그래서 그냥 싸 놓고 이제 싸라 싸서 이제 행여나 때릴까 싶어서 싸라 싸서 이제 싸 놓고 이제 술김에 누워 졸기에 나도 이제 따라 잤지요
귿 따라서 인잗 애기들 인자 큼 방에 인잗 자고	그 따라서 이제 아이들 이제 큰방에 이제 자고
나 나한테 인자 점 뭉능 걷 항 개 허고 자근 모이마하고 인자 가이나 저저 장애자 됭 가이네 저걷허고 인자 데꼬 인자 자째 그 뒨날 아치메 자고 일라서 막 사올 떠린디 아치메 보리 방애 찌 가꼬 밥 밥 허는디 여 너메 동네 남자고 여자고 그냥 느르러니 그냥 우리 시라빵으로 그냥 쑥허니 막 나라비로 서서 드로와요	나 나한테 이제 젖 먹는 것하나하고 작은 사내애하고 이제 계집애가이나는 계집애의방언형 저 저 장애자 된 계집애 저것하고 이제 데리고 이제 잤지 그 뒷날 아침에 자고 일어나서 막 사월인데 아침에 보리방아 찧어가지고 밥 밥 하는데 이 너머 동네 남자고 여자고그냥 줄지어서느르러니는 줄지어의 뜻 그냥 우리 으로 그냥 쑥하고 막 줄지어나라비는 줄지어의 일본말 서서 들어와요
그랟 먼 니링고 해뜨마느 그 싸 농 그걸 인자 막 동네 싸람들 점부 드러가서드러내데요	그래 무슨 일인고 했더니마는 그 싸 놓은 그걸 이제 막 동네 사람들 전부 들어가서 들어내데요
그리 드러냉깨 우리 씨어메란 사라믄 농 착 어퍼노코 아들 옫 싹 빼뜨라 뿌루고 안 주데요	그리 들어내니까 우리 시어매란 사람은 농 착 엎어 놓고 아들 옷 싹 빼앗아버리고 안 주데요
나간다고 미와서	나간다고 미워서
부모 마다 나간다고	부모 마다하고 나간다고
아이고 머 다 헐라먼 이야글 다 헐라먼 머	아이고 뭐 다 하려면 이야기를 다하려면 뭐
씨아 시아버지는 그럼 뭐 암 말씀도 안 하션나요 그럼	시아 시아버지는 그럼뭐 아무 말씀도 안 하셨나요 그럼
씨아부지는 영 조아요	시아버지는 아주 좋아요
엉 조은데 어쩨 이러케 고셍	아주 좋은데 왜 이렇게 고생
네 고부라 그런다 이거이 고부다 고붕깨 쪼깜만 더 살먼 괜차느꺼이다 만날드레 날보고 가가자고	네 고비라 그런다 이것이 고비다 고비이니까 조금만 더 살면 괜찮을 것이다 만날 들에 나보고 가 가자고
그래가 드레 가먼 나를 만날 홀가요	그래가지고 들에 가면 나를 만날 홀려요
씨아바이는 인자 그만 합씨다 그렁 거는	시아버지는 이제 그만 합시다 그런것은
다 헐라믄 뭐 연소끄글 하나 뀌미도 나가 뭐	다 하려면 뭐 연속극을 하나 꾸며도 내가 뭐
묻 모따허 꺼이고	못 다 못 할 것이고
그렁 거이 다 채게 나가믄 또 꼴부꼬	그런 것이 다 책에 나가면 또 꼴불견이고
에 아이 에기 가저쓸 떼 머 어려워떤 이리나 기어게 남는 이리 이써요 에기 에이 아이들 가저쓸 떼	예 아기 아기 가졌을 때 뭐 어려웠던 일이나 기억에 남는 일이 있어요 아기 아기 아기들 가졌을 때
뭐 에이 그리 사는 세상에 뭐 뭐 애기 선다고 어쩌고 뭐 허도 몯 허고 바블 몬무거찌요 인자	뭐 에이 그렇게 사는 세상에 뭐 뭐 아기 선다고 어쩌고 뭐 하지도 못하고밥을 못 먹었지요 이제
에 입더시 심헤서	예 입덧이 심해서
앙거또 몸 무꼬 배를 짜고 인는디 만날 게우고 뭘 몬 무꼬 누니 캉캄해 가꼬난장에는 인자 배 짜다가 인자 아야어 막 몬 껀저이 눕 드러누워 뿌리써요	아무 것도 못먹고 베를 짜고 있는데 만날 게우고 뭘 못 먹고 눈이 캄캄해가지고 나중에는 이제 베 짜다가 이제 아야 막 못 견디고 눕 드러누워 버렸어요
그래선 존 니레 나르 우리 지비나 좀 보내 도라고 우리 지비나 날 좀 보내 도라고	그래서 좋은 일에 나를 우리 집에나 좀 보내 달라고 우리 집에나 날 좀 보내 달라고
친정 찌베	음 친정 집에
그래농깨 인잗 실랑이란 사라미 인자 중매한테다 이야글 핸능가 인자 인자 묵또 몯 허고 만날 게우기만 게우고 데자 뭐 그냥 거러가다도 턱 자빠저 부루고 꺼꾸라저 뿌리고 긍깨 인자 보내 주데요	아 그래 놓으니까 이제 신랑이란 사람이 이제 중매장이한테다 이야기를 했는지 이제 이제 먹지도 못하고 만날 게우기만 게우고 과연 뭐 그냥 걸아가다가도 턱 넘어져 버리고 거꾸러져 버리고 그러니까 이제 보내 주데요
보내 줘서 인자 우리 지비 강깨 우리 어메 인자 장사 허든 거시기 이씽깨 뭘막 인능 걷 엄능 걷 가꼬 와서 해 주고 모린 밍테도 탕탕 뚜드려 가꼬 막 미여꾹또 끼레주고	보내 줘서 이제 우리집에 가니까 우리 엄마 이제 장사하던거시기 있으니까 뭘 막 있는 것 없는 것 가지고 와서 해 주고 마른 명태도 탕탕 두드려가지고 막 미역국도 끓여 주고
또 무꼬 잔 음석또 머 중 무꼬 자먼 죽 해 주고 밤 무꼬 머 밤 무꼬 잠 밥 해주고 그러고 우리 크놀케가 나 네 살 무거서 와따네요	또 먹고 싶은 음식도 뭐 죽 먹고싶으면 죽 해 주고 밥 먹고 뭐 밥 먹고 싶으면 밥 해 주고 그러고 우리 큰 올케가 나 네살 먹어서 왔다네요
아하	아하
근디 인자 우리 어머니란 사람믄 인자 울 아부지 일만 알고 밤만 앙깨 울 어무니가 인자 살리믈 인자 두랑을 해요	그런데 이제 우리 어머니란 사람은 이제 우리 아버지 일만 알고 밭만 아니까 우리 어머니가 이제 살림을 이제 두량을 해요
울 어무니 인자 머 도니 엄쓰믄 비즐 내로 가도 우러무니가 가고 장을 보러 가도 우러무니가 가고 그렁 그렁깨 먿 아들레를 구니네 가고 저렁 걷 먿 수발하능 거또 울 어무니가 댕임서 허고 그렁깨 울 아부지는 일만 알고 밤만 알고 긍깨 지비 암부터 이써요살림 인자 검바께 돌고 글믄 울 올케가 어메메니로 나를 거처늘 해요 울 올 올케도 설리 커따네요 부모가 에리서 주거 뿌루고	우리 어머니 이제 뭐 돈이 없으면 빚을 내러 가도 우리 어머니가 가고 장을 보러 가도 우리 어머니가 가고 그러 그러니까 뭐 아들네를 군인에 가고 저런 것 뭐 수발하는 것도 우리 어머니가 다니면서 하고 그러니까 우리 아버지  는 일만 알고 밭만 알고 그러니까 집에 안 붙어 있어요 살림 이제 금밖에 돌고 그러면 우리 올케가 엄마처럼 나를 돌봐 줘요 우리 우리 올케도 서럽게 컸다네요 부모가 어려서 죽어 버리고
그래 사람 마는 디 시지블 가고 잡따 해서 우리 지비로 와따고우리 씨 씨아재들 데꼬 장난도 치고 씨아재들도 성수가 아이고어메는 방박 바까트로 동깨로	그래서 사람 많은 곳에 시집을 가고 싶다고 해서 우리집으로 왔다고우리 시 시동생들데리고 장난도 치고 시동생들도 형수가 아이고엄마는 방 밖 밖으로 도니까
성수를 부모거치 생각허고	형수를 부모같이 생각하고
엔 인자 나를 애기 인자 당시니 농 거멩이로 펭상 저네는 업꼬 댕기고 그래따네요 네 살 무꼬 그럴 쩌에는 그라고 우리 올케가 그리 부모멩이로 평상 바로 부모로 사마써요	이제 나를 아기 이제 당신이 낳은 것처럼 평생 전에는 업고 다니고 그랬다네요 네 살 먹고 그럴 적에는 그리고 우리 올케가 그렇게 부모처럼 평생바로 부모를 삼았어요
글글 올케가 그래가꼬 옹깨로 뭘몸 무꼬 그래 몰라가꼬 옹깨로 오만 걸 다해 주고	아 글 글 올케가 그래가지고 오니까 뭘 못 먹고 그래 말라가지고 오니까 오만것을 다 해 주고
이 애기를 나아가꼬 가도 그냥 우리 올케한테다 내비리고 그냥 나는 나대로 그냥칭구들허고 놀로 댕기고 그래요	이 아기를 낳아가지고 가도 그냥 우리 올케한테다 내버리고 그냥 나는 나대로 그냥 친구들하고 놀러 다니고 그래요
하룬네 언데로 댕김서 놀다가 가라고	하룻내 어느 곳으로 다니면서 놀다가가라고
울 올케가	우리 올케가
올케가 저지 마나 가꼬 인자 난중에는 인자 끄터리에는 인자 우리 크나들허고우리 올케 인자 망내이 아들허고 가치 나써요 한 동가비라예	이 올케가 젖이 많아가지고이제 나중에는 이제 끝에는 이제 우리 큰아들하고 우리 올케 이제 막내아들하고 같이 낳았어요 한 동갑이에요
나농깨 저지 마나 가꼬	낳아 놓으니까 젖이 많아가지고
그 저즐 머꼬	그 젖을 먹고
그냥 전 미기서 델꼬 이꼬 나는 놀로 댕기고 그래써요 친정에 가먼	그냥 젖 먹여서 데리고 있고 나는 놀러 다니고 그랬어요 친정에 가면
올케가 조으신 부니네	올케가 좋으신 분이네
그래 오 오래 몬 살고 거엳 고만 중가네 그냥 주거 부리고	그래 오 오래 못 살고 그 그만 중간에 그냥 죽어 버리고
똑 부모 주긍 거멩이로	꼭 부모 죽은 것처럼
그래요 시방도 생각하문 우리 올케가 그리 불쌍헤 주커테요	그래요 지금도 생각하면 우리 올케가 그렇게 불쌍해 죽겠데요
에기들 키우고  무슨 베기리나 돌 잔치 가틍 거또 막 세고 그려셔씀니까	예 아이들 키우고  무슨 백일이나 돌잔치 같은 것도 막 쇠고 그러셨습니까
머 잔치 허도 안 해써요	뭐 잔치 하지도 않았어요
별 거 안허고요이산후 에 나코 조리는 그러므는 주로 친정에서 하션네요	음 별 것 안 하고산후에 나중에 조리는 그러면은 주로 친정에서 하셨네요
아니요 애나 애기들 그 귿 친정어 가도 애기들 해나 거그서 노으먼 여 씨어머니가 먼 트꺼리 잠는다고	아니오 행여나 아이들 그 그 친정에 가도 아기들 행여나 거기서낳으면 시어머니가 무슨 트집이나 잡는다고
우로빠가 절떼 누구집 까 노으라고 몬 노게 해	우리 오빠가 절대 너희집 가 낳으라고 못 낳게 해
거 여그서 나찌요	그 여기서 낳았지요
그러믄 머 산후에 먿 시어머니한테 별로 데접또 몯 바드셔껜네	예 그러면뭐 산후에 뭐 시어머니한테 별로 대접도 못 받으셨겠네요
올 저녁 똑 세 개는 바므로 나써요	올 저녁 꼭 셋은 밤으로 낳았어요
바므로 나가 오늘쩌녀게 노으먼 인자 낼 하리 인젣 누 씨믄 뒨날 아치메도 오늘나아 노크먼 인자 뒨날 아치메 인자 하리 밥 어더 무음 뒨날 아침 밥 어더 무으먼 하리 눙꼬 인자 사흘마네 쌈 피운다 그래꺼등뇨 저네는	밤으로 내가 오늘 저녁에 낳으면 이제내일 하루 이제 누워 있으면 뒷날 아침에도 오늘 낳아 놓으면 이제 뒷날 아침에 이제 하루밥 얻어 먹으면 뒷날 아침 밥 얻어 먹으면 하루 눕고 이제 사흘만에 쌈 피운다 그랬거든요 전에는
쌈 피운다	쌈 피운다
쌈 피운다 그럼스롱 인자 그 애기 그 미역 항 가닥허고 쌀허고 저리 채리 노커등뇨 애기를 노으먼 저네는	쌈 피운다 그러면서 이제 그 아기 그 미역 한 가닥하고 쌀하고 저쪽에 차려 놓거든요 아기를 낳으면 전에는
애기를 움모게다가 인잗 쌀 한되나 허고 인자 인자 그 인자 봉 마 복 빠드라고  그른다고 마른 인젇 그래섣 쌀 좀 허고 인자 미역 항 가닥허고 요리 물 떠 가꼬 상에다저리 나 노코 나먼 인자 사헐마네 인자 인자 오어찌녀아 나씅깨 오늘 하리 이따가 내라치메 인자	아기를 윗목에다 이제 쌀 한되나 하고 이제 이제 그 이제 복 복 받으라고 그런다고 말은 이제 그랬어 쌀 좀 하고 이제 미역 한 가닥하고 이리 물 떠가지고 상에다 저쪽에 놔 놓고 나면 이제 사흘만에 이제 이제 엊저녁에 낳았으니까 오늘 하루 있다가 내일 아침에 이제
그걷 그거 그거 미역 그놈 가꼬 쌀허고 가꼬 나와가꼬 그놈 가 밥 해 가꼬 그 상에다 채리 노래요	그것 그것 그것 미역 그놈 쌀하고 가지고 나와가지고 그놈 가지고 밥해가지고 그 상에다 차려 놓으래요
그먼 사헐마네 글믄 나와서 밥 채리 노문 머 귿 어찌 드러가꺼잉가요	그러면사흘만에 그러면 나와서 밥 차려 놓으면 뭐 그 어찌 들어갈 것인가요
그레서 이를 시작하능 거에요 인제	그래서 일을 시작하는 거예요 이제 일 시작허지요일 시작하지요
물 여다 밥또 해 무꼬 그애가 인자 사헐 사헐 너머 가고 낭깨로 그 세도 오짐마니 안 누능가요이	물 여다가 밥도 해 먹고 그래가지고 이제 사흘 사흘 넘어가지고 낳으니까 그 사이에도 오줌 많이 누잖아요
한 함 번 누문 한 동우라요	한 한 번 누으면 한 동이예요
예에	예 예
한 동우제	한 동이지
또 데지 그 데지막 아페다 또 구더글 요리 파 나 가꼬는 그따가 그 또 오짐 그논는디 내로믄 데지도 그 꾸정물만 뭉는디 머 오짐 마니 누지요이	또 돼지 그 돼지우리앞에다 또 구덩이를 이렇게 파 놔가지고는 거기다가 그 또 오줌 그놓는 데 내려오면 돼지도 그 구정물만 먹는데 뭐 오줌 많이 누지요
예에	예 예
하리 데지 오짐 한 한 동우 똗 시꾸가 마능깨 사람 오짐 한 동우	하루 돼지오줌 한 한 동이 또 식구가 많으니까 사람 오줌 한 동이
똗 세 오짐 그거 싸 노문 세 오짐 한 동우	또 소 오줌 그것 싸 놓으면 소 오줌한 동이
요 이 건네 요 요거이 우리 큰 집 바친디 인젣 나가 인잗 나와 뿌 상깨 그서한디 인자 시방 씨아재가 데꼳 씨어메를 데꼬 이씽깨로 인자 씨 씨아재가 시방 해 뭉는디 요요 아페 요 감나무 받 저 저거이 인자 씨어메 바친디 아침마둥 저걷 여내야 되요	이 이건너 이 이것이 우리 큰집 밭인데 이제 내가 이제 나와 사니까 뭐한데 이제 지금 시동생이데리고 시어머니를 데리고 있으니까 이제 시동생이 지금 해 먹는데 이 이 앞에 이 감나무밭 저것이 이제 시어머니 밭인데 아침마다 저것 여내야 돼요
세 오짐 함 본 데지 오짐 함 본 사라모짐 함 본	예 소 오줌 한 번 돼지오줌 한 번 사람 오줌 한 번
그거 여내 노코느 또 나먼 또 애기 머 똥 싸고 오짐 싼 똗 빨래 씨꺼야제	그것이어서 내어 놓고는 또 나면 또 아기 뭐 똥 싸고 오줌 싼 또 빨래 씻어야지
그러장깨 인제 또 어른 빨래도 똔 씨꺼야되고 응깨	그러려니까 이제 또 어른 빨래도 또 씻어야 되고 그러니까
애기 그 배서 그리 이를 그리 나락 훌쩨 애기 배 가꼬 모 숭구제 나락 훌쩨	아기 그 배어서 그렇게 일을 그렇게 벼 타작하지 아기 배어가지고 모 심지 벼 타작하지
논 매제 점부 다 그렁 걸 다 애기 배 가꼬도 헝깨로	논 매지 전부 다 그런것 다 아기 배어가지고도 하니까
애기를 나 노먼 날라가꺼멩이라요 모미 개버와서	아기를 낳아 놓으면 날아갈것 같아요 몸이 가벼워서
긍깨 머 애기야 머 울먼 머 내나 드러가서 저 쭈는 거이제 머 암디 아푼 디도읍써요	그러니까 뭐 아기야 뭐 울면 뭐 내나 들어가서 젖 주는 것이지 뭐 아무 곳 아픈곳도 없어요
근디 일 저무나 사나 이를 해도 머	그런데 일 젊으나 마나 일을 해도 뭐
건강하셔서 그레요	건강하셔서 그래요
그러고 시상을 사라찌요 시방 싸람들 뭐 조리허니 뭐 어쩌니 해도 조리허꺼이어디가 이써요	그렇게 세상을 살았지요 지금 사람들 뭐 조리하느니 뭐 어쩌니 해도 조리할 것이 어디 있어요
자 자식 키우면서 제일 기어게 남는 일 하나만 이야기를 헤 달라 그러는데자식들 가운데서 머 그 따 따 따님 그 장에가 인는 따니메 우리 마으메 늘 걸리셔께써요이	예 자 자식 키우면서 제일 기억에 남는 일 하나만 이야기를 해 달라 그러는데 자식들가운데서 뭐 그 따 따 따님 그 장애가 있는 따님에 우리 마음에 늘 걸리셨겠어요
그걷남세 저금나찌요이	그것 때문에 분가했지요
그레써요 그 딸 떼무네 또	아 그랬어요 그 딸 때문에 또
아드른 머이마만 두 개 나 농깨로 조아서 우리 씨아바이는 수리 마니 잡싸요	아들은 사내아이만 둘 낳아 놓으니까 좋아서 우리 시아버지는 술을 많이 잡숴요
정때 여 해거름판 되문 아적빱 잡쑤꼬 나가시문 해 너머갈 때 되문 인잗 지비인자 인자 모도 가튼 이랭드리 모도 인자 제꼉 찌블 차자강깨 혼차 그 주마게 몬니꼬	점심때 이 해거름판 되면 아침밥 잡수고 나가시면 해 넘어갈 때 되면 이제 집에 이제 이제 모두같은 일행들이 모두 이제 제각기 집을 찾아가니까 혼자 그 주막에 못 있고
가치 나오먼 온 동네를 댕임서롱 아글 써요	같이 나오면 온 동네를 다니면서악을 써요
아글 써	악을 써
술 잡쑤먼	술 잡수면
온 동네를 댕임서 아글 씨문 우리 지븐 손지 그 걷	예 온 동네를 다니면  서 악을 쓰면 우리 집은 손주 그것
으흥	으흠
우리 애기가 그리 예삐데요 저네 예삐 가꼬 요래 가꼬 자꼬 아글 씨고 댕기믄 애기가 곧 너러치꺼멩이라요 고노문 하나씨가 깍 요래 자꼬 요래가 댕이먼 시방도 동네 아그 할메드리 숭을 봐	우리 아기가 그리 예쁘데요 전에 예뻐가지고 이래가지고 잡고악을 쓰고 다니면 아기가 곧 떨어질 것 같아요 그놈의 할아버지가 꽉 이렇게 잡고 이래가지고 다니면 지금도 동네 아이 할머니들이 흉을 봐
아부지 애기 날 주씨요 그러먼 놔라 놔라 그런다고  그래가 댕임서 아글씨고 그냥 동네가 어그너그니 아글 씨고 야다니고 글드만 가이네 그거는 나 농깨로 가이네 나따 체리도 안 봐요	아버지 아기 날 주세요 그러면 놔라 놔라 그런다고  그래가지고 다니면서 악을 쓰고 그냥 동네가 떠들썩하게어긋너근이는 떠들썩하게의뜻 악을 쓰고 야단이고 그러더니만 계집애 그것은 낳아 놓으니까 계집애 낳았다고 쳐다도안 봐요
아하	아하
체리도 안 보고 나는 나무 댕기고 나무허로 댕기고 인자 씨어무니는 인자 들게댕기지요 인자이	쳐다도 안 보고 나는 나무 다니고 나무하러 다니고 이제 시어머니는이제 들에 다니지요 이제
여르메는 삼뿔겡 삼동에는 멩 잔능 거 멩 잔는 물레에 멩 잔능 거 그거 허로가먼 애기를 말리에다가 내 놔요	여름에는 삼뿔겡 겨울에는 무명 잣는 것 무명 잣는물레에 무명 잣는 것 그것 하러 가면 아기를 마루에다가 내어 놓아요
근디 여여가 시방은 우리가 인자 요릳 점부 무 내농깨 그러지 여가 점부 대바치라요	그런데 여기가 지금은 우리가 이제 이리 전부 묵혀 놓으니까 그렇지 여기가 전부대밭이에요
아하 그레꾸나	아하 그랬구나
여 말리엗 저짝 말리에 해도 안 드로와요 대 처 가꼬 또 대 포라 무글라고	이마루에 저쪽 마루에 해도 안 들어와요 대 쳐가지고 또 대 팔아 먹으려고
대 처서 폴먼 돈 버릴라고날 샌 중얼 몰라요 저저 저네 시집 쌀 때	대 쳐서 팔면 돈 벌려고날 새는 줄을 몰라요 저 저 전에 시집 살 때
대바 쏘기 되야가꼬 캉캄 해 가꼬 날 샌 중도 모르거꼬 그랜는디 그 대받 소게다가 시상에 애기를 그리 한 디다가 오짐 싼다고 방에 냄새 난다고	대밭 속이 되어가지고 캄캄해가지고 날 새는 줄도 모르겠고 그랬는데 그 대밭 속에다가 세상에 아이를 그렇게 한데다가 오줌 싼다고 방에 냄새 난다고
으흠	으흠
바가테다 내 노코 멩 떨기 하로 가고 나는 나무허로 가고 그러고 나먼 아가 떨다가 떨다가 지지리 함 본 치고 떨다가 떨다가 지지리 함 본 치고	밖에다 내어 놓고 목화 떨기 하러 가고 나는 나무하러 가고 그러고 나면 아이가 떨다가 떨다가 진저리 한 번 치고 떨다가 떨다가 진저리지지리은 진저리의 방언형 한 번치고
그러나 나무를 안 하무 또 날리가 나 꺼이고 그렁 걸 나뚜고 나갈라문 나도 울고제도 울고 그래가꼬 인자 가서 나무 해 가꼬 저그 이심니나 되꺼이요	그러나 나무를 안하면 또 난리가 날 것이고 그런 걸 놔두고 나가려면 나도 울고 저도 울고 그래가지고 이제 가서 나무해가지고 그 이십리나 될 거요
그런디서 나무 그걸 고개에다 해 가꼬 이고 오고 나먼 캉캄 어두부꼬 그래 다서싸를 무거도 귿 서도 몯 해써요	그런 곳에서 나무 그것을 고개에다 해가지고 이고 오고나면 캄캄 어둡고 그래서 다섯 살을 먹어도 그 서지도 못했어요
만나리 그 궁뎅이만 끄꼬 댕이제 설 쭈를 몯 해써	만날 그 궁둥이만 끌고 다니지 설 줄을 몰랐어
그래 인자 삼동에 그거이 쩌쩌 소아마비가 와뜽갑써요	그래 이제 겨울에 그것이 저 저 소아마비가 왔던가 봐요
어러 가꼬 소아마비가 와서 인자 우리지비 양바는 인자 장을 장을 보고 인자 그  러다가 인자 무신 날로는 애기들도 키우고 그러장깨 돈도 마니 들고 그러등깨 유리빵을하나 채리써요 저 멘 소지에다가	얼어가지고 소아마비가 와서 이제 우리집 양반은 이제 장을 장을 보고 이제 그러다가 이제 무싯날로는 아이들도 키우고 그러려니 돈도 많이들고 그러니까 유리 가게를 하나 차렸어요 저 면 소재지에다
유리빵을 하나 채리 놘는디 저 우리 친정 똥네 싸라미 장작 짱수를 여수로 댕기써요	우리 가게를 하나 차려 놓았는데 저 우리 친정 동네 사람이 장작 장사를 여수로 다녔어요
장 나무를 함 배 실코 여수 가서 폴고 또 오고 그랜는디 자 거따가 열라글 해가꼬 여수 유리빵에 가서 인자 그 인자 열뚜 무를 끼우 물 마니 드는 날 장자글 함배 실코 가는디 금 그 실코 감서롱 가는디 인자 따라감서 인자 짐때 인자 저금 배가 걸고 그러먼 인자 막 짐때 내릴 거석 짐때 그노믈 인자 살때 질러주고 그렁 걷 헌깨로 자기도 조코 운는 가선 거따가 인자 거울 거틍 거 그렁 거 인저 실코 옹깨 조코	장 나무를 한 배싣고 여수 가서 팔고 또 오고 그랬는데 이제 거기다가 연락을 해가지고 여수 유리 가게에가서 이제 그 이제 열두물을  물 많이 드는 날 장작을 한 배 싣고 가는데 지금 그 싣고가면서 가는데 이제 따라가면서 이제 삿대 이제 저기 배가 걸고 그러면 이제 막 삿대살대는 삿대의 방언형 내릴 뭐 삿대 그것을 이제 삿대 질러주고 그런것 하니까는 자기도 좋고 우리는 가서 거기다가 이제 거울 같은 것 그런 것 이제 싣고 오니까 좋고
차를 불러 가꼬 실코 오먼 도니 망코 그렁개 인자 거그 따라가서 지짐때 저살때 질러주고 그렁 걷 허고 인자 그 배에다 옴서는 실코 오고 근는디 아가 풍 불 잉그라근 이만저마니고 해 가꼬 숨도 몬 씨고 아가 영 주께 데써 인자 아파서 인자	차를 불러가지고 싣고 오면 돈이 많고 그러니까 이제 거기 따라가서 삿대 저 삿대 질러주고그런 것 하고 이제 그 배에다 오면서는 싣고 오고 그러는데 아이가 불잉걸은 이만저만이고 해가지고 숨도 못 쉬고 아이가 영 죽게 됐어 이제 아파서 이제
여리 나따고요	열이 났다고요
그래 인자 저그 장터 인자 약빵에 이사 그때는 진니사라 그래써요	그래 이제저기 장터 이제 약방에 의사 그때는 진의사라 그랬어요
그 약빵도 허고 이사도 허고 그랜는디 거그 가서	그 약방도 하고 의사도 하고그랬는데 거기 가서
저녀게 인자 오 저녁빱 무꼬 아무래도 아놔서 인자 열 씨나 되서 인자 물때꺼를 알고 할메가 서메서 와농깨 물때꺼를 알고 인자 날보고 아를 어부라 그러데요	저녁에 이제 오 저녁밥 먹고 아무래도 안 와서 이제 열시나 돼서 이제 물때를 알고 할머니가 섬에서 와 놓으니까 물때를 알고 이제 나보고 아이를 업으라 그러데요
아를 어버라 그러글레 인자 업꼬 인젣 나랑 두리 인자 걷 약빵아페가서 선는디이 지믈 실코 오능 거이 되농깨 무리 다드러야 인자 다 든다거는 마니 드러야 배가 올로오꺼이라요	아이를 업으라 그러길래 이제 업고 이제 나랑 둘이 이제 거기 약방 앞에 가서서 있는데 이 짐을 싣고 오는 것이 돼 놓으니까 물이 다 들어야 이제 다 든다는 것은 많이들어야 배가 올라올 거예요
이 꼬랑꺼지 올라오장깨 무리 다드러서 오장깨로 열 뚜시가 너머요 그란 그 이야글 헐라먼 참 가슴 아파요	이 도랑까지 올라오려니 물이 다 들어서오려니까 열두시가 넘어요 그런 그 이야기를 하려면 참 가슴 아파요
그래 인제 거 약빵아페 가서 인자 씨어메도 이꼬 나도 이꼬 인젣 떨고 인잗 두리서 인잗 애기는 업꼬 애기는 등거리가 뜨겁 쩡도로 불 염 막 여여리 올라 뿌리꼬	그래이제 그 약방 앞에 가서 이제 시어머니도 있고 나도 있고 이제 떨고 이제 둘이서 이제 아이는 업고 아이는 등이 뜨거울 정도로 불 영 막 열 열이 올라 버리고
그래가 인는디 오데요 그래 인자 그래 인자 가게 아페 거그 그게 가게 무늘 열고 가게에서 인자 가게가 바로 뵈기요 이 약빵허고	그래가지고 있는데 오데요 그래 이제 그래 이제 가게 앞에 거기 그게 가게 문을 열고 가게에서 이제 가게가 바로 보여요 이약방하고
그랟 가게 무늘 열글라깡 인잗 그러고 이야글 몯 허게 해요	그래 가게 문을열려니까 이제 그렇게 이야기를 못 하게 해요
서방 각씨 이야글 몯 허게 만나질 몯 허게 해요	서방 각시 이야기를 못 하게만나지를 못 하게 해요
씨씨어머니가	아 시 시어머니가
그래 나는 가마니 서씽깨로 가드마는 아가 아퍼가 와따 그래요	예 그래서나는 가만히 서 있으니까 가더니마는 아이가 아파가지고 왔다 그래요
인제 거그 인잗 근처야 상께로 인자 그 지니사도 이무롭찌요이 쪼깐	이제거기 이제 근처 사니까는 이제 그 진의사도 임의롭지요
그래 인 따라 오라그러글레 저 안찌비 이떠마요 그래 안찌비로 데꼬 감스롱 인자 약빵은 장가 나꼬 안찌브로 안찝 시 세림무늘 알고 인자 그렁께 가드마는 뚜드리드만	그래서 따라오라 그러길래 저 안집이 있더구먼요 그래서 안집으로 데리고 가면서 이제 약방은 잠궈 놓고 안집으로 안집 사립문을 알고 그러니까 가더니마는 두드리더구먼
밤쭝에 누가 그래 주꺼잉가요이 모린 사람 거트먼 그랜 인자 호탠디 인자 나가 호태요 호태요 그렁깨 뭔 니링가 그럼시로 나오데요 나오더마는 애기가 아파서 나가물겐 허로 가따 와뜨마는 애기가 너무 마니 아프네요 그래 그렁께 좀 데꼬 드로라고 글드만 인자 그때 인제 베니싱 베니싱 그 주사를 한 대 주데요	밤중에 누가 그래 줄 것인가요 모르는 사람 같으면 그래서 이제 호탠데 이제 내가 호태요 호태요 그러니까 무슨 일인가 그러면서 나오데요 나오더니마는 아이가 아파서 내가 물 하러 갔다가 왔더니마는 아이가 너무 많이 아프네요 그래 그러니까 좀 데리고 들어오라고 그러더구먼 이제 그때 이제 페니실린 페니실린 그 주사를 한 대 주데요
베니싱 그 주사를 한 대 주드마는 그거 인자 저냥 인자 마처가꼬 옹깨 여리 내링깨로 그이 아푸먼 자꾸 여러 날 병워느로 가야 허껃 아잉가요	페니실린 그 주사를 한 대주더니마는 그것 이제 그냥 이제 맞혀가지고 오니까 열이 내리니까 그것이 아프면 자꾸 여러 날 병원으로 가야 할 것 아닌가요
몽까게 해요 그래가 방꾸서다 인자 처바가 놔도 농깨 저거이 그만 뇌가	못 가게 해요 그래가지고 방구석에다 이제 쳐박아 놔 놓으니까 저것이 그만 뇌가
쯔쯛	쯧쯧
모지래고 그만 아가 저릳	모자라가지고 그만 아이가 저리
열 떼무네 그레요 여리 노픈 열 떼무네 뇌가 상헤요	열 때문에 그래요 열이높은 열 때문에 뇌가 상해요
그 어째뜽가네 그래가꼬 그날 쩌녁 베니싱 주사 한 대 마치고 우리 집따 데리다농 거이 저래가 저리 벵시니 되야 가꼬 다쌀 묵또로꺼지 거또 몯 해요	그 어쨌든지 그래가지고 그날 저녁 페니실린 주사 한 대 맞히고 우리집에다 데려다 놓은 것이 저래가지고저리 병신이 돼가지고 다섯 살 먹도록까지 걷지도 못해요
그르능 글 천지서 인자 장사르 댕깅깨 자네가 그리 말고 데꼬 나오게	그러는걸 사방에 이제 장사를 다니니까 자네가 그리 말고 데리고 나오게
그른 부모 미테서 사라봐짜 벨 거석또 엄네 그 제집또 그레 노치 마고 데꼬나오게	그런 부모 밑에서 살아 봤자 별 뭐도 없네 그 제 집도 그래 놓지 말고 데리고 나오게
그래싸서 인자 데꼬 인잗 나도 모리게 긍깨 방을 그리 어더 노코 어더 노코 데꼬나와 가꼬 인자 자기가 버려 가꼬 인자 노늘 동간들 겔추고 인자 무꼬 살고 그러고 쪼깜썩남능 걸 저추글 헝 거이 인자 저네는 그 머이냐 치게또니라고	그래 쌓아서 이제 데리고이제 나도 모르게 그러니까 방을 그리 얻어 놓고 얻어 놓고 데리고 나와가지고 이제 자기가벌어가지고 이제 논을 동기간들 가르치고 이제 먹고 살고 그리고 조금씩 남는 걸 저축을 한것이 이제 전에는 그 뭐냐 장체계라고
안 이썬능가요	있었잖아요
그 인자 체게또늘 인자 노코 인자 그래가꼰 인자 그걸 가꼬 노늘 서 마제기 두마제기 까뻬낀 안돼 우리 씨자으나부지가 인자 여 여 미테 또 여그 살다가 저그 꺼치로인자 이사를 감성 그 노늘 폴고 갈라 항 깨	그 이제 장체계를 이제 놓고 이제 그래가지고 이제 그걸 가지고 논을 서 마지기 두 마지기 값밖에 안 돼 우리 시작은아버지가 이제이 이 밑에 또 여기 살다가 저기 꺼치로 이사를 가면서 그 논을 팔고 가려하니까
자그나부지 그 그를 그리 말고 그 도늘 나를 주시요 그리 노늘 주시요 도니모지래서 함 마지는 그냥 서 마지기를 자붐서롱 함 마지기는 도니 모질항깨 나가그냥 갈라무끼로 지꼬 두 마지기 깝쓴 나가 도느로 드리꺼잉께 밍녀네 나가 도니 되건네요	작은아버지 그 그를 그리 말고 그 논을 나를 주시오 그리 논을 주시오 돈이 모자라서  한 마지기는 그냥 서 마지기를 잡으면서 한 마지기는 돈이 모자라니까 내가 그냥 병작을갈라묵기는 병작의 뜻 짓고 두 마지기 값은 내가 돈으로 드릴 거니까 내년에내가 돈이 되겠네요
체게또늘 또 바꼬 그러먼 밍녀네는 함 마지기깝쓸 되건는디 그리 모 이 노늘 그리 몯 허문 이 노늘 모 짭꼬 함 마지기 두마지기는 어디 살 띠도 업꼬 그렁깨 이 노늘나를 주시요 그러먼 나 올해 함 마지기는 나 갈라무끼를 해 가꼬 쌀로 디리고 명녀네 나가 함 마지기깝쓴 자그나부지를 디리께요 긍깨 그러라 그러드라네요	장체계를 또 받고그러면 내년에는 한 마지기 값이 되겠는데 그리 뭐 이 논을 그리 못하면 이 논을 못 잡고한 마지기 두 마지기는 어디 살 데도 없고 그러니까 이 논을 나를 주시오 그러면 나 올해  한 마지기는 나 병작을 해가지고 쌀로 드리고 내년에 내가 한 마지기 값은 작은아버지를드릴게요
그래 가꼬 나 시집 옹깨 노늘 서 마지기 사 놔떼요 그래 이 그 농 그 서 마지기 그 노믈 인자 가꼬 나간는디 가꼬 나가고 인자 근 제그믈 나가꼬 너무 인자 저빵으로 나가꼬 저빵에서 또 나가래서 그렁 걸 데꼬 나가 가꼬 저그 어디야 먼 논 지비 폴고 간다는지브 비즐 내 가꼬 그걸 사라 삼간 지블 참 뻬다도 조코 저 모까 마으레 산는디	그래가지고 나 시집오니까 논을 서 마지기 사 놨데요 그래 이 그 논 그 서 마지기 그것을 이제가지고 나갔는데 가지고 나가고 이제 그 분가를 해가지고 남의 이제셋방으로 나아가지고 셋방에서 또 나가라고 해서 그런 것을 데리고 나가가지고 저기 어디야 무슨 논 집이 팔고 간다는 집을 빚을 내가지고 그걸 살아 삼간 집을 참 뼈대도 좋고 저못 가 마을에 샀는데
피지 키를 너머 가요 논도 다 때려 여도 안 되거테요 그 비지	빚이 키를 넘어가요 논도 다 때려 넣어도 안 되겠데요
그래서 인잔 그냥 집 그노믈 도로 내 나써요	그래서 이제 그냥 집 그것을 도로 내놨어요
뉘 저빵이라도 그냥 헐란다게 몬자 저빵 줘떤 집또 메느리허고 하비 안 되서 따로 사는디 그 할메가 우리 아래차에 와서 사라라 그르데요	누구 셋방이라도 그냥 하겠다고 해 먼저 셋방 줬던 집도 며느리하고 합이 안 돼서 따로 사는데 그할머니가 우리 아래채에 와서 살아라 그러데요
그러자 인자 저저 정지나무 몬자 지지따 안 허등가요	그러자 이제 저 저 정지나무 먼저 지었다 하잖던가요
그 다라미 저귿 저 운녀그로 인자 시 이새로 간다고 그 지비 나딱 혼디 다 오오 게들고 게나는 지비 한 차 나서 그냥 너무 저빵 사느이 빈 비지 쪼깜 지나따나 인자큰 비즌 인자 짐 몬자 찌 인자 새롣 잡 사가꼬 간 지블 포라 가꼬 큰 비즌 갑꼬 에 자근비즌 쪼깐만 해 가꼬 누가 그냥 요 지블 사라 너무 저빵 가능 거뽀동 나따	그 사람이 저기 저 웃녁으로 이제 시 이사를 간다고 그 집이 났다고 하는데 다 오오 기어 들고 기어 나가는 집이 한 채 나서 그냥 남의 셋방 사느니 빈 빚이 조금 지더라도 이제 큰 빚은 이제 집 먼저 이제 새로 잡 사가지고 간 집을 팔아가지고 큰 빚은 갚고 에 작은 빚은 조금만 해가지고 누가 그냥 이 집을 사라 남의 셋방 가는 것보다 났다
그래서 인젇 그 지블 그럴찌 알무 인자 나 욱째피 가꼬 머이 머인 종도 모르 나는 인잗 따라만 댕이는 거이라요	그래서 이제 그 집을 그럴 줄 알면 이제 나 붙잡혀가지고 뭐가 뭔 줄도 모르고 나느 이제 따라만 다니는 거예요
그래 인잗 서방이라고 인자 댕김서 그렁 걸 해 가꼬 그 지블 자버 가꼬 인자 게들고 게나나따나 노니 안 너머 강깨 살거떼요 또 배가 고파 어찌 사꼬 시퍼서	그래 이제 서방이라고 이제 다니면서 그런 걸 해가지고 그 집을 잡아가지고 이제 기어 들고 기어나가더라도 논이 안 넘어 가니까 살겠데요 또 배가 고파 어찌 살꼬 싶어서
가뜬 그녀네 인잗 이사는 오기는 인자 오두막 찌비로 이노멛 똥네로 오기는 완는디 금녀네 농사 징 걸 가꼬 점붇 매상을 하고 인잗 북떼기 인자 홀테로 그때 훌터 농깨인자 가장가리 그렁 거 인자 북떼기가 인는디 그거 뜽게로 한 서미 곧 싹 인잗 나무치는매상을 해 삐리고 인자 빋 까파 뿌리고 그 항 가마이를 한 서믈 찌이가꼬 무꼬 낭깨롬 머얼매나 뭉능가	하여튼 그해에 이제 이사는 오기는 이제 오두막집으로 이놈의 동네로 오기는 왔는데 금년에 농사 지은 걸 가지고 전부 매상을 하고 이제 북데기 이제 탈곡기로 그때 타작해 놓으니까 이제 가장가리타작할 때 나오는 북데기 그런 것이제 북데기가 있는데 그것 뜨니까 한 섬이 곧 싹 이제 나머지는 매상을 해버리고 이제 빚갚아버리고 그 한 가마니를 한 섬을 찧어가지고 먹고 나니까 뭐 얼마나 먹는지
우리 친정 어무니가 장에 가먼 올때 드로니라 그러먼 또 아들 몰리 또 바께쓰 가꼬 오니라 그러먼 바께쓰로 하나 가꼬 댕임서 주문 그 노믈 이고 요 강 건네서 이고 건네와 가꼬 또 해 무꼬	우리 친정어머니가 장에 가면 올 때 들어오너라 그러면 또 아들 몰래 또 양동이 가지고 오너라 그러면 양동이를 하나 가지고 다니면서 주면 그것을 이고 이강 건너서 이고 건너와가지고 또 해 먹고
참 우리 어메 아부지 나 골벵드린네요	참 우리 어머니 아버지 나 골병 들였네요
그래 인자 오두막 거 삼성 인자 비지 인자 쪼깜 인자 참 키우는 안 거서그고또 그래도 인자 오두마글 사라도 인자 비즌 비지라	그래 이제 오두막 그 살면서 이제빚이 이제 조금 이제 참 키우는 뭐 안 하고 또 그래도 이제 오두막을 살아도 이제 빚은빚이라
얼쭈 가꼬 낭 요미테 요 하라씨안데 여 하라쓰가 하나 하나 사라는디 하라씨가서딸 그믐나리 됭깨 우리 시라빠 호태 어쩌가 항상 어쩌까 그래가 인잗 어쩨간 인자 또  그 비즐 가꼬 나 장사 허등 거또 싹 포라 냉기 삐리고	얼추 갚고 나 이 밑에 이 할아버지한테 이 할아버지가 하나 하나 살았는데 할아버지가 섣달 그믐이 되니까 우리집 양반 호태 어찌 할까 그래가지고 이제 어쨌든지 이제 또 그 빚을갚고 나 장사하던 것도 싹 팔아 넘겨 버리고
인자 그러고 이따항께 장사허다 그러고 이따항깨로 인자 상인드리 인자 돌봐줘요	이제 그러고 있다 하니까 장사하다가 그러고 있다 하니까는 이제 상인들이 이제 돌봐줘요
미원 메 뽕다리 주고 비누 메 짱 주고 성냥 메 뽕 주고 그래가꼬 포라 가꼬 가프께 폴먼 그날 그 나리 가꼬	미원 몇 봉지 주고 비누 몇 장 주고 성냥 몇 봉 주고 그래가지고 팔아가지고 갚으니까 팔면 그날 그 날에 갚고
또 나무치기 남능 거는 자네 또 먿 용 개양똔 씨고 그러고 나 장으로 나오게 그래서 인자 나가서 인자 장사를 허는디 인잗 가이네 저걸 모도 다 저래 노치 말고 벵워느로좀 데꼬 가보게 그래싸서 그래서 인잔 논 저걸 가꼬 인자 그 오두막 찌비 그 아래찌비 인자 대문찌비라고 이써요	또 나머지 남는 것은 자네 또 뭐용돈 가용돈 쓰고 그러고 나 장으로 나오게 그래서 이제 나가서 이제 장사를 하는데 이제 계집애 저걸 모두 다 저렇게 놓지 말고 병원으로 좀 데리고 가 보게 그래 쌓아서 그래서 이제 논 저걸 가지고 이제 그 오두막 집이 그 아랫집이 이제 대문집이라고 있어요
대문찌비 가서 인자 인자 우리 할무이허고 친처기라 아재라 그래요	대문집에 가서 이제 이제 우리 할머니하고 친척이라 아저씨라 그래요
아재아그 저그 논 여 놈 자꼬 나가 저 가이네르 데꼬 벵워늘 좀 가봐야거쏘 모도 다 벵워늘 가믄 나수꺼이라 싼는디 저걸 안 제 펭상 안잔는 거뽀동 해나 거러나 모 모씨나따나 거러나 댕기믄 오짐 똥이나 안 개림 개리믄 안 살거쏘 그래가꼬	아저씨  저기 논 이것 잡고 내가 저 계집애를 데리고 병원을 좀 가 봐야겠소 모두 다 병원을 가면 나을 거라 쌓는데 저걸 언 제 평생 앉아 있는 것보다 행여나 걸어나 못쓰나마나 걸어나 다니면 오줌 똥이나 안 가리 가리면 살잖겠소 그래가지고
그래서 인자 귿 논 등끼르 가꼬 강깨 등끼로 가꼬 강깨 인잗 그러치마는 나가 자네 노늘 잡꺼능가 버른 대로 갑쏘	그래서 이제 그 논 등기를 가지고 가니까 등기를 가지고 가니까 이제 그렇지마는 내가 자네 논을 잡겠는가 버는 대로 갑소
그럼성 도늘 주데요	그러면서 돈을 주데요
그애 여수 애야워네 인자 드러댕기는 사라믈 어찌 아라가꼬 인자 장사하러 댕깅깨 인자 순천 싸람 머 어디 싸람 모이서 허능 거이 되농깨 장사를 모이는 디가 되농깨 순천 인자 아저씨드리 인자 장 가튼 장사허는 아저씨드리 여수 애야워네 그리 잘 본다네	그해 여수 애야원에 이제 들어다니는 사람을 어찌 알아가지고 이제 장사하러 다니니까 이제 순천 사람 뭐 어디 사람 모여서 하는 것이 돼 놓으니까 장사를 모이는 데가 돼 놓으니까순천 이제 아저씨들이 이제 장 같은 장사하는 아저씨들이 여수 애야원애 그리 잘 본다네
거그 댕기는 아무거 씨를 차자 가소 금서 인자 그 인자 주소를 저거 줘서 그 주소를 가꼬 인자 나허고 두리 업꼬 나는 자기가 애기를 몬 너꺼뜽깨 인자 다서쌀 뭉는 걸업꼬 참 삼사워레 해는 질고 그걸 업꼬 그그 애야워네 드는 드나드는 인자 이사가 야글주구 지비다 인자 좀 가따 논능갑떼 인자 마리레쯤 인자	거기 다니는 아무개 씨를 찾아가소 그러면서 이제 그 이제 주소를 적어 줘서 그 주소를 가지고 이제 나하고 둘이 업고나는 자기가 아이를 못 업겠으니까 이제 다섯 살 먹는 걸 업고 참 삼사월에 해는 길고 그걸업고 그 그 애야원에 드는 드나드는 이제 의사가 약을 자기 집에다 이제 좀 가져다 놓나 보데 이제 말일쯤 이제
인자 쌔벼다 논는 거이지요이 가따 놛능가 한재로 미기라 그러데요	이제 훔쳐다 놓는 것이지요 가져다 놨는지 한 재를 먹이라 그러데요
근디 그때 또느로 육처넌 마니처너닌디 그때 또느로 돈 육처너늘 인자 가꼬 인자간는디 야기 반재깝빼끼는 안 되데요	그런데 그때 돈으로 육천원 만이천원인데 그때 돈으로 돈 육천원을 이제 가지고 이제 갔는데 약이 반 재 값밖에는 안 되데요
그래 도니 요러타 그렁깨로 한재르 미기씨믄 똑 씨건는디 할 쑤 음따고 금성 그냥 반재라도 미기야 야가 건는다 그르데요	그래 돈이 이렇다 그러니까는 한 재를 먹였으면 꼭 좋겠는데 할 수 없다고 그러면서 그냥 반 재라도 먹여야 아기가 걷는다 그러데요
아이 그걸 미기 농깨로 요론 디를 자꼬 서드란 마리요	아이 그걸 먹여 놓으니까이런 데를 잡고 서더란 말이오
베름빠글 잡꼬 서서 인자 자꼬 세우라데요 그래 인자 세우고 그러 인자 자꼬세우고 다리를 주물라 주고 그렁깨 인자 자꼬 요리 인자 베름빠글 자꼬 섣 인저간냐 서따서따 험서 인자 조탕깨 제도 조와서 그냥 이꼬 그래선 그러드마느 인제 거르믄 건는디	벽을 잡고 서서 이제 자꾸 세우라데요 그래 이제 세우고 그러이제 자꾸 세우고 다리를 주물러 주고 그러니까 이제 잡고 이리 이제 벽을 잡고 서 이제 섰다섰다 하면서 이제 좋다 하니까 저도 좋아서 그냥 웃고잇다는 웃다의 방언형 그래서그러더마는 이제 걸음은 걷는데
한 쪽 다리를 인잗 평상 말리에다가 끄네 노믄 여래 가꼬 뽈고 요래가꼬 인는디 여그 요 걷 말리에 이나 단 디는 겐차나요	한쪽 다리를 이제 평생 마루에다가 꺼내놓으면 이래가지고 빨고 이래가지고 있는데 여기 이것 마루에 내나 닿는 데는 괜찮아요
연 통 요런 디는 바가테 요요 바람 씬 디는 똑 어러 도링 걷멩키라요	이 통이런 데는 밖에 이 이 바람 센 데는 꼭 얼어서 도린 것 같아요
어릉어릉어릉이 그 노믄 인자 에리서 인자 좀 거러댕기고 인자 여나 여나무 살무글 때 요릳 여르멛 반 반중우 요렁 걸 이피서 내 노먼 좀 싹싹 날보고 씨끼라 그래요안 씨끼서 그러타고 사람드리 흑바테 궁그러등 걸 더러 씨끼지 아를 저래 논는다고 지비를 데리다 좀 씨끼 봐	어룽어룽해 그것은 이제 어려서 이제 좀 걸어다니고 이제 여나 여남은 살 먹을 때 이러 여름에 반 반바지반중우는 반바지의 뜻 이런 걸 입혀서 내 놓으면 좀 싹싹 나보고 씻겨라 그래요 안 씻겨서 그렇다고 사람들이 흙 위에훍밭은 흙으로 덮힌 땅 위의 뜻 굴렀던 걸 더러 씻기지 애를 저렇게 놓는다고 댁들 데려다 좀 씻겨 봐
그 그 사를 똑떼기 디리다 봐 그거이 땡가 머잉가 그러믄	그 그 살을 똑똑히들여다 봐 그것이 때인지 뭐인지 그러면
잊젣 인자 킁깨로 인자 근 제가 오슬 감충개 저러치 통 어를오도릉 건메이라요 사리 땅에 이나 땅에 말리에 단디는 겐차나요	이제 이제 크니까 이제 그 제가 옷을감추니까 저렇지 통 옻이 오른 것 같아요 살이 땅에 오히려 땅에 마루에 닿는 데는 괜찮아요
그라가꼬 또 오다가 소아꽈에 순천 소아꽈에 들리 가꼬 또 약 쫌 타고 그래저래 인자 저걷한테만 최서늘 다 인자 해 가꼬 완농깨 인자 거러댕기리기는 인자 짜욷땅짜울땅 저리 다리 절고 거러 댕이는디 다름도 몬 치고	그래가지고 또 오다가소아과에 순천 소아과에 들려가지고 또 약 좀 타고 그래저래 이제 저것한테만 최선을 다 이제 해가지고 와 놓으니까 이제 걸어다니기는 이제 기우뚱기우뚱짜우땅짜울땅은 기우뚱기우뚱의 방언형 저렇게 다리 절고 걸어 다니는데 달음박질도다름은 달음질의 방언형 못치고
뇌도 좀 시기먼 허고 안 시기먼 안 허고 그래요	뇌도 좀 시키면 하고 안 시키면안 하고 그래요
아이고	아이고
그러 나 하도 괴씸해 나 씨어메 나 차또 안허요	그래 나 하도 괘씸해서 나 시어머니 나 찾지도 않아요
그러시	그러시
가보도 안 허요	가 보지도 안 하오
그러시건네요	그러시겠네요
그래가꼬 시방 구십 여서 쌀 무거	그래가지고 지금 구십여섯 살 먹어
으응	으응
근는디 날보고 머 그지께도 씨어메는 주 씨어메 주글 때는 가야지 그러 나가거그 먿허러 가꺼이요	그랬는데 나보고 뭐 그제도 시어머니는주 시어머니 죽을 때는 가야지 그래 내가 거기 뭐 하러 갈거요
이적찌 안 차즌 씨어메 인자 낟 씨어메 차즈꺼요 나 앙 가꺼이요	여지껏 안 찾은 시어머니 이제와서 시어머니 찾을 것이오 나 안 갈것이오
거서 동네 싸람드리 욕 안허건능가 너미 욕 헌다고 나가 사그 그 요게 검나서나 거그 가꺼이요	거기서 동네 사람들이 욕 안 하겠는가 남이 욕한다고 내가 그 욕에 겁나서 나 거기 갈 것이오
앙가 꺼이요 나 하 하다 몸써리가 나서 나 앙가요	안 갈 것이오 나 하 하도 몸서리가 나서 나 안 가요
할무니 떼무네 손녀가 그러케 되야 부러꾸만	음 할머니 때문에 손녀가 그렇게 돼 버렸구먼
결구그니	결국은
나 하나 지헝 거는 갠차나요	나 하나 제한 것은 괜찮아요
어찌그나 시방거치 딸세상에야고 딸세상에 요러는디 저거 하나를 뉘피 노코 저녀기믄 이 에미 엄는 자석 두 개 뉘피 노코 저거 저러고 눈능 거 채리보믄 나가 저녀게 자믈 몬 짜요	어쨌거나 지금처럼 딸세상이라고 딸세상에 이러는데 저것 하나를 눕혀 놓고저녁이면 이 어미 없는 자식 둘 눕혀 놓고 저것 저러고 누워 있는 것 쳐다보면 내가 저녁에 잠을 못 자요
아놔요 자미 초저녀게 한 심 자고 나믄 잠 안 자요	안 와요 잠이 초저녁에한 숨 자고 나면 잠 안 와요
아이고	아이고
나 산 세상을 다 마를 헐라문 참 비극 연소끄글 한남 끼미도 모따 끼미꺼요 나무 꺼요	내가 산 세상을 다 말을 하려면 참 비극 연속극을 한편 꾸며도 한 편 꾸며도 다 못 꾸밀 것이오 남을 것이오
시어머니를 어떤 고야칸 시어머니를 보셔가꼬 그러케 되네요	시어머니를 어떤고약한 시어머니를 보셔가지고 그렇게 되네요
오직 나가 오직허먼 나가 사라므로 태가 너무 지비 와 가꼬 너무 큰메느리로안진 나가 부모를 안 찬는 나가 오직 허먼 그러거쏘	오죽 내가오죽하면 내가 사람으로 태어나 남의 집에 와가지고 남의 큰며느리로 앉은 내가 부모를 안찾는 내가 오죽하면 그러겠소
나도 부모 되꺼인디 나도 메느리한테 나도 씨어메라 나도 너무 멘 딸한테 씨어무이요	나도 부모 될 것인데 나도 며느리한테 나도 시어머니야 나도 남의 딸한테 시어머니요
그런디 오직허먼 나가 씨어무이를 안 차꺼쏘	그런데 오죽하면 내가 시어머니를안 찾겠소
에이고 참 어쩨서 그러케 말도 몯 허게 허까이	아이고 참 어째서 그렇게 말도 못하게 할까
말도 몯 허능 거이 아이라 이 머리가 자기 먼 거서기라요 그냥	말도 못 하는것이 아니라 이 머리가 자기 뭐 뭐예요 그냥
아하 막 멀크뎅이를 자꼬 그냥	아하 막 머리끄덩이를 잡고 그냥
쩨깜만 멈 자기한테 마땅차늠 막 뜨더데요 그냥	조금만 뭐 자기한테 마땅찮으면막 뜯어대요 그냥
아하	아하
그래가꼬 씨아제들또 그 처럼는 거뜨를 뚜드 패라고 저 저녀늘 벋 저녀니 제 사리 아파야 저녀니 마를 드르꺼이라고 나가 마란든능 거이 머 이써 시기는 대로 허고 허는디	그래가지고 시동생들도 그 철없는 것들을 두들겨 패라고 저 저 년을 벋 저 년이 제살이 아파야 저 년이 말을 들을 것이라고 내가 말 안 듣는 것이 뭐 있어 시키는 대로 하고하는데
하여튼 미워 미와꾸만 하여튼 이유 업씨 미워서	하여튼 미워 미웠구먼 하여튼이유없이 미워서
그러니 씨아제들또 그 어메가 그러멍 나이 그래도 중하꾜 고등하꾜를 댕기씨믄	그러니 시동생들도 그 어머니가 그러면 나이 그래도 중학교 고등학교 다녔으면
알 텐데이	알 텐데
그런 사례를꺼인디 주메가 패란다고 패거쏘	그런 사리를 알 것인데 저희어머니가 패란다고 패겠소
쯛쯛 아이고 형수를	쯧쯧 아이고 형수를
태꿘도 선상을 저그 어치가서 고등하꾜 조럽허고 태꿘도를 배우고 어치서 선상을  해써요	태권도 선생을 저기 어치 가서 고등학교 졸업하고 태권도를 배우고어치에서 선생을 했어요
정제 언젣 우리지비 영감 인자 장사가먼 인자 어메야 새보그로 전피주고 머 헌다고 또 따라가요 따라가고 아무도 엄꼬 나 혼자 이써요	부엌언제 우리집 영감 이제 장사 가면 이제 시어미니야 새벽으로 전표 주고 뭐 한다고 또 따라가요 따라가고 아무도 없고 나 혼자 있어요
그러믄 무다니 지비 와따가 그냥 정지 빠당 안 주글 띠만 팽깨 꿈지길 띠도 몬꿈디기고 한나잘내 울고 이따가	그러면 괜히 집에 왔다가 그냥부엌 바닥 안 죽을 데만 패니까 꿈적일 데도 못 꿈적이고 한나절한나잘은 한나절의 방언형 내내 울고 있다가
귿 그 시동셍이 그냥 괴니 그레요	그 그 시동생이 그냥 괜히 그래요
하무요	아무렴요
참 고 노미 이상하네 허 지금 보니까 모시고 사는 시동셍	참 그놈이 이상하네 하 지금 보니까 모시고 사는 시동생
그러가꼬 그 아들한테로 기여이 따라 가써요 그러고 나서 인자 요 집터를지블 지라데요	예 그래가지고 그 아들한테로 기어이 따라갔어요 그리고 나서 이제 이집터를 집을 지으라데요
인자 장개 가고 주구도 각씨들 데꼬 살고 흥깨 인저 좀 어쩡가 우리가 그 지비 긍깨 뒤에서 이런 바우가 너머 와가꼳 지둥 나무를 하나 뚜드리 삐농깨 미러뿌농깨로 지비 반파가 된논디 인자	이제 장가 가고 저희도 각시들 데리고살고 하니까 이제 좀 어쩐가 우리가 그 집이 그러니까 뒤에서 이런 바위거 넘어와가지고기둥 나무를 하나 때려 버려 놓으니까 밀어 버려 놓으니까 집이 반파가 됐는데 이제
천지다 인자 터를 인자 지블 살라고 비즐 또 지나따나 어디 빈 지비 이씨먼 하나 살라고 천지에도 지비 업떼요 그때는 시방은 모도 내비리고 주꼬 어쩌고 해농깨 지비 이써도	천지에다 이제 터를 이제 집을 사려고 빚을 또 지더라도 어디 빈 집이 있으면하나 사려고 천지에도 집이 없데요 그때는 지금은 모두 내버리고 죽고 어쩌고 해 놓으니까 집이 있어요
으으음	으으음
빈 지비 업써서  지블 질라고 봉깨 도는 옹꼬	빈집이 없어서  집  을 지으려고 보니까 돈은 없고
그래서 인자 어디 오두마이나 또 또 어디 오두마이나 항 개 인능가야 아무리 차자도 엄꼬 그랜는디 인자 주구 마미 내도능가 어째능가 인자 인자 셍이라고 차자 댕기고인자 그랜는디 도늘 인자 망냉이 씨아제 그걸 그거 인자 참 돈 번대로 주구를 다 갤차그를 갤찬는디	그래서 이제 어디 오두막이나 또 또 어디 오두막이나 하나 있는지 아무리찾아도 없고 그랬는데 이제 저희 마음이 돌았는지 어쨌는지 이제 이제 형이라고 찾아다니고 이제 그랬는데 돈을 이제 막내 시동생 그걸 그거 이제 참돈 버는 대로 저희를 다 가르쳐 글을 가르쳤는데
주구도 요랑 이꺼찌이다이 그래가 도늘 첨마나늘 빌리 주꺼잉깨 이자 엄씨 주꺼잉깨 지블 지라데요	저희도 요량 있겠지요 그래가지고 돈을 천만 원을 빌려 줄 것이니까 이자 없이 줄 것이니까 집을 지으라데요
그래 여그따가 지라 그래서 나 여 안 진는데써요 나가 그 세상을 또 가서 어찌사 꺼이요 난 앙 가꺼이요	그래 여기다가 지으라 그래서 나 여 안 짓는댔어요 내가 이세상을 또 가서 어찌 살 것이오 나 안 갈 것이오
나 어그라지나따나 여그 살라요 여그 살제 앙 가꺼이요 그래 또 저놔로 험스롱그따가 지블 지라고 인자 글 안 허허그 안 헌다고 그래 어찌 그 성지리 어디로 가고 안허꺼이요 나 안 허꺼이요 그렁깨 난중엔 주구가 데꼬 간다 그르데요	나 허물어지나마나 여기 살겠소 여기 살지 안 갈 것이오 그래 또 전화를하면서 거기다가 집을 지으라고 이제 안 그런다고 그래 어찌 그 성질이 어디로 가고 안할 것이오 나 안 할 것이오 그러니까 나중에 저희가 데리고 간다 그러데요
그러드만 대자 인자 그른다고 인자 주구감 인자 정 그러먼 우리가 모시고 가꺼잉깨 여그 따 지블 지라 그렁깨는 우리 아들허고 영감허고 기여이 여따 집띠다 그래서여와 사는디 여그 옹깨 또 그래요	그러더니 과연 이제 그런다고 이제 저희가 이제 정 그러면 우리가 모시고 갈 것이니까 여기다 집을 지으라 그러니까는 우리 아들하고 영감하고 기어이 여기다 짓습디다 그래서 여기 와서 사는데 여기 오니까 또그래요
요짜게 삼서롱 도로 그래요	이쪽에 살면서 도로 그래요
도로 그러고 하수핑상 집 뜨더내라고 바작떼기르 작떼기르 가꼬 와서 이녀나 집뜯 영감 인자 그러자 여그 와가꼬 인자 한 사 녀닝가 오 녀닝가 살다가 여그 집 찌 노코 주거써요	도로 그러고 계속 집 뜯어 내라고 지겟작대기를 작대기를 가지고 와서 이년아 집 뜯 영감 이제 그러자 여기 와가지고 이제 한 사년인지 오 년인지 살다가 여기 집 지어 놓고 죽었어요
날마다 여그에다가 집 뜨더내라고 날보 이녀나 집 찌더내라니 어찌 사꺼이요	날마다 여기에다가 집 뜯어 내라고 나보고 이년아 집 뜯어 내라니 어찌 살 것이오
인자 그래이 인자 나가 도매에 오능 게기요 응 나가 인자 멀 차무꺼이요 그래 인자 인잗 두리 싸와 대찌	이제 그래 이제 내가 도마에 오른 고기요 응 내가 이제뭘 참을 것이오 그래 이제 이제 둘이 싸워 댔지
두리 싸와 대써요 인자	둘이 싸워 댔어요 이제
니 모 쌀먼 나 모 쌀고 인자 그래 인자 대게 인자 그리 싸와댕깨 인자 아드리데꼬 가데	네 못 살면 나 못 살고 이제 그래 이제 되게 이제 그렇게 싸워 대니까 이제아들이 데리고 가데
그랜는디 나가 그 찯 부모라 차꺼쏘 안 차자요 그런 세상을 사라써 응	아 그랬는데 내가 그 찾 부모라 찾겠소 안 찾아요 그런 세상을 살았어 응
아조	응 아주
긍깨 그 이 딸 요거이 첼롬 모게 걸리서 나가	그러니까 그 이 딸 이것이 제일목에 걸려서 내가
그러건네이 아느 궨차늘 쑤 이썬는데	그러겠네요괜찮을 수 있었는데
야글 제데로 모 쓰고	약을 제대로 못 쓰고
딸만 너무 딸거치 잘 가 살고 요로문 나 나가 이해해요 저네 세상이라 시집 사는 세상이다 허고 나가 살 건는디	딸만 남의 딸처럼 잘 가 살고 이러면 나 내가 이해해요 전에 세상이라 시집 사는 세상이다 하고 내가 살겠는데
딸꺼정 저래농 글 보문 나가 몬 몬 차꺼떼요	딸까지 저렇게 해 놓은 걸 보면내가 못 못 찾겠데요
너미 천만 마를 허고 만 마를 해도 나 귀에 안 드러와요	남이 천만 말을 하고 만 말을 해도 내 귀에 안 들어와요
그러 노미야 사정을 알 거써요	예 그러 남이야 사정을 알겠어요
마으믈	마음을
그래서 자석 키웅거이 젤로 그거이 자석 키움서로	그래서 자식 키우는 것이 제일 그것이 자식 키우면서
아이고 아이고	예 아이고 아이고
그만하세요 너무 그냥 감정에 복바치셔서 웃음	그만하세요 너무 그냥 감정에 복받치셔서
응 참말로 나가	응 참말로 내가
자 그러먼 인제 오늘 제가 여쭤보능거슨 침을 다시며 엔나레 사시던생활 이야김니다	자 그러면 이제 오늘 제가 여쭤 보는 것은 침을 다시며 옛날에사시던 생활 이야기입니다
엔나레느뇨이 지베 집 지베 지반 고꼬세가 구시니 드러가따고 헤가지고	옛날에는요 집에 집 집에 집안 곳곳에 귀신이 들어갔다고 해가지고
그 막 밥 체레노코	그 막 밥 차려 놓고
그레짜나요	그랬잖아요
에를 드러서 워디	예를 들어서 어디
소 솜비비고 막	소 손 비비고 막
예 솜비비고	예 손 비비고
워디 어디에다가 주로 마니헫 지반 어디	어디 어디에다가 주로 많이 했 집안 어디
쩌 움모게	저 윗목에
움모게다가요	윗목에다가요
움모게다가 누구한테 빔니까 어떤신 어떤 신한테요 머	아 윗목에다가 누구한테 빕니까 어떤 신 어떤 신한테요 뭐
인자 조항님네	이제 조왕님네
인자 우릳 우예 선조들 인자	이제 우리 위 선조들 이제
근눔 빌고	그것 빌고
인자 개꾸는 쪼차 내고	이제 객귀는 쫓아내고
으음음  조항 조항신	조왕 조왕신
조항니믄 먼시니데요 머떤 시그로 어떤	조왕님은 무슨 신이대요 어떤 식으로 어떤
조항이 내나 우리 애기들 씨 배다중 그렁거이 인자 조항이고	조왕이 내나 우리아기들 씨 배게 해 주는 그런 것이 이제 조왕이고
조항이	조왕이
부떠게 조황들	부뚜막에 조왕들
부떡	부뚜막
어아저 인제 지금 가트믄 부어게 인는 시는	아아 저 이제 지금 같으면 부엌에 있는 신은
조항가틍거	조왕 같은것 예
또 머 셈 가튼데도 머 이러케 헤씀니까 엔나레 우무리나 이런데도	또 뭐샘 같은 데도 뭐 이렇게 했습니까 옛날에 우물이나 이런 데도
지금도 허는 사라믄 해요	지금도 하는 사람은 해요
그레요	아 그래요
바가치에다가	예 바가지에다가
자 앙가란즈라고 바가치에다가 인자 싸를 다마가꼬	이제 가라앉지 말라고 바가지에다가 이제 쌀을 담아가지고
거 인자 싸레다가 인자 초뿌를 꼬자가꼬 저녕내 서떨 그믐날 저녁 부를 써나요	그 이제쌀에다가 이제 촛불을 꽂아가지고 저녁내 섣달 그믐날 저녁 불을 켜 놔요
그럼 인자 저녕내 인자 그래 다마 노으먼 저녕내 인자 부리 부터 내레가요	그럼 이제 저녁내 이제 그렇게 담아 놓으면 저녁내 이제 불이 붙어 내려가요
그럼 저기 고 무쏙 무리 무뤼에 둥둥 떠이껜네요	음 그럼 저기 고 물 속물이 물 위에 둥둥 떠 있겠네요
오 웨 그렁거에요	오 왜 그런 거예요
인자 공디리능 거이제 그거는	이제 공 들이는 것이지 그것은
공디리능거	아 공 들이는 것
자기 지바니나 자식뜰 잘 되라고	자기 집안이나 자식들 잘 되라고
인자 저네는 인자 그리 인자 밥 따마노코	이제 전에는 이제 그리 이제 밥 담아놓고
인자 개꾸 쪼차 낸다고 네 구석찌에다가	이제 객귀 쫓아 낸다고 네 구석에다가
쑥뿌를 피워요 나가라고	쑥불을 피워요 나가라고
오  잡씬들 나가라고	잡신들 나가라고
쑥뿌를 피우먼 뜨구와서 나강가요	쑥불을 피우면 뜨거워서 나가나요
몰라요 뭐 행이 구저서 나가능 거잉가 어쩌능가	몰라요 뭐 향이궂어서 나가는 것인지 어쩌는지
쑥뿌를 그리 피우데요	쑥불을 그리 피우데요
그다메 움모게다가 상 체레노코	그 다음에 윗목에다가 상 차려 놓고
손 비비구요	손 비비고요
그다메 거 아가 아까그 세마구 세마구 거 거그도 함니까 소인는데	그 다음에그 아까 그 외양간 외양간 거 거기도 합니까 소 있는데
인자 소늘 비비무 막 인자 짓 점쟁이가 와서	이제 손을 비비면 막 이제 점쟁이가 와서
천지를 막 댕김서롱 막 물러나라고 막 카를 가꼬 댕임서 막 이러고 대끋 트러가꼬 댕임서 뚜드리고 그래가 싹 쪼차내노코 가 그래쪼	사방을 막 다니면서 막물러나라고 막 칼을 가지고 다니면서 막 이렇게 대나무 끝 틀어가지고 다니면서 두드리고그래가지고 싹 쫓아내 놓고 가 그랬지요
저네머 아푼 사라미 이꺼나	전에 뭐 아픈 사람이 있거나
그러면	아 그러면
머이 좀 지바네 머 좀 쩍찌그이 찌고 머 구진 거세기 이쓰믄	뭐가 좀 집안에 뭐좀 찝찝한 것이 끼고 뭐 궂은 뭐가 있으면
그래 소늘 비비요이 그래	그렇게 손을 비벼요 그래
고건 인제 천제 뭐 그런 인제 무당이나 이런 사람 불러다가 항 거시고	그건이제 순전히 뭐 그런 이제 무당이나 이런 사람 불러다가 하는 것이고
인자 안그러치 앙코 그냥 지반 어러니	이제 안 그렇지 않고 그냥 집안 어른이
거 인제 머 이러케 에 지반 머 마당에다가도 머 헌다등가 막	그 이제 뭐 이렇게집안 뭐 마당에다가도 뭐 한다든지 막
저이 이유제 또 머 그리 인자 잘주생기는 사라미 이씨믄	저희 이웃에 또 뭐그리 이제 잘 주워 삼키는 사람이 있으면
인자 그사라미 인자 불러다가 인자 바블 해서 채리 노코 마당까에나 저런디다 채리 노코	이제 그 사람이 이제 불러다가 이제밥을 해서 차려 놓고 마당 가에나 저런 곳에다 차려 놓고
으음  인자 대꾸 트러가손때를 자바요	이제 대나무 끝 틀어가지고 손대를 잡아요
그래가꼬 막 주생김성 막 두리고 어쩌고 해가꼬 막 모 바비랑 거 상에 채리 나떵거 막 바가치에다 물 좀 해가꼬 가꼬 나가서 막 부정을 치고 그러믄 인자 시락빠게다 지펄까라노코 그노믈 부어 노믄 짐성더르 와서 무꼬 개도 무꼬 고양이도 무꼬 또 새도 와서무꼬 그래요	그래가지고 막 주워 삼키면서 막 속이고 어쩌고 해가지고 막 뭐 밥이랑 그 상에 차려 놨던 것 막 바가지에다 물 좀 해가지고 가지고 나가서막 부정을 치고 그러면 이제 쪽박에다시락박은 쪽박의 뜻 짚을 깔아 놓고 그것을 부어놓으면 짐승들이 와서 먹고 개도 먹고 고양이도 먹고 또 새도 와서 먹고 그래요
그러믄 머 거기에 귀시니 잡뀌가 거가 부터인능가 거 다무거부런능가 그런뜨시	음 그러면 뭐 거기에 귀신이 잡귀가 거기에 붙어 있는 것 다 먹어 버렸는지 그런뜻이
인자 구시니 웅가 무고 간찐 인자	이제 귀신이 오는지 먹고 갔는지 이제
어  강거이지요 인자	간 것이지요 이제
고 그흐 그사라믄 무당도 아닌데도 그냥 참 잘 쓰	그 그 그 사람은 무당도 아닌데도 그냥 참 잘 쓰
우리 여여 아래찌비 여그 아지매가 참 자래요	우리 여 여 아랫집 여기 아주머니가 참 잘해요
오호  우리 지뇌가에 아지매빨 되는디	우리 진외가의 아주머니벌 되는데
그 아지매가 영 잘드 그렁걸 자래요	그 아주머니가 아주 잘 드 그런 것을 잘해요
그레요이	그래요
저네는 여 어깨 요런디가 아푸고 그러머 또 싸를 요리 삽 저 바끄르게다 요리다마가꼬 째까넌 수거늘 요리 끄 둘러 씨가꼬 잡꼬 그노믈 가꼬 또 막 훔처 세움성 요리운짜고	전에는 여 어깨 이런 데가 아프고 그러면 또 쌀을 이리 삽 저 밥그릇에다 이리 담아가지고 조그만 수건을 이리 둘러씌워가지고 잡고 그것을 가지고 또 막 움켜 세우면서 이리 문지르고운짜다는 문지르다의 뜻
거머 고걸 머락함니까 그렁거슬	그러면 그걸 뭐라 합니까 그런 것을
그걸보고 머라 하데예	그걸보고 뭐라 하더라
고걸 다른데선 잠밤메긴다고	그걸 다른 곳에서는 잠밥 먹인다고
아이 잠밤 메긴다	아이 잠밥 먹인다
잠밤 미긴다고	잠밥 먹인다고
그러조이	그러지요
잠밤 미긴다고 그러초이	잠밥 먹인다고 그러지요
요이 여 우리 아지매가 참 자래써요 그런디 지금 서울가 사라요	이이 여 우리아주머니가 참 잘했어요 그런데 지금 서울에 살아요
잠밤 미거머는 인자 아픈데가 좀 나아 시원헤지고 막 이런다하고	잠밥먹이면은 이제 아픈 데가 좀 나아 시원해지고 막 이런다 하고
그거이 마메 공시니지	그것이 마음에 구신이지
마메 구신 지그믄그렁거 안해도 머	마음에 귀신 지금은 그런 것 안 해도 뭐
지그믄 인자 점부 물리치로로 가능거이제 어디가 아푸문	지금은 이제 전부 물리치료를가는 것이지 어디가 아프면
그러치요  엔나렌 그렁거 모를 떼는 그러케 다	그렇지요  옛날엔 그런 것 모를 때에는 그렇게 다
또 이월 바람 올린다고	음 또 이월 바람 올린다고
이월 바람올린다고	이월 바람 올린다고
그게 무슴 마림니까	그게 무슨 말입니까
저저저 이워레 바람 올린다고 그럼서롱 떡허고 해가꼬	저 저 저 이월에 바람올린다고 그러면서 떡하고 해가지고
시방 나 그 날도 이저뿐네 메친날 메친날 나를 바다가꼬	지금 나 그 날도 잊어버렸네 몇 일 몇 일 날을 받아가지고
거 대나무르 끄너다 세워 노고 거따 헝겁떼기	그 대나무를 끊어다가 세워 놓고 거기에다 헝겊
색새까지로 헝거플 짤막짤막 요망썩허이 해가꼬 거 대에다 다락 시리랑 다라노코 그미테다가 또 지펄가꼬 따바르요리 영꺼가꼬	색색으로 헝겊을 짤막짤막 이만큼씩하게 해가지고 그 대에다 달아 실이랑달아 놓고 그 밑에다가 또 짚을 가지고 똬리 이렇게 엮어가지고
거따 물쭝바를 떠 떠다노코 또 아침마동 거따 무를 가라요	거기에다 물 중발을 떠 떠다 놓고 또 아침마다 거기에다 물을 갈아요
이월따레	음 이월에
그거또 그거또 뭐	그것도 그것도 뭐
그 인자 바람 큰 바람 올라가는 나른 여라그랜 나린디	그 이제 바람 큰 바람올라가는 날은 열아흐렌데
그 아네 메틴날 메틴나른 줄 잘 모리건네 이저 뿌리고	그 안에 몇 일 몇 일인 줄 잘 모르겠네
그거이 바람 올린다고	그것이 바람 올린다고
바람 올린	바람 올린
이월때리 바라미 젤로 세거등요	이월이 바람이 제일 세거든요
헝깨 바람 올린다고 인자	그러니까 바람올린다고 이제
바람 올린다는 마른 거 바람 따라서 누가 올라가능가	바람 올린다는 말은 그바람 따라서 누가 올라가나
그러게요	그러게요
으음 그레요이	음 그래요
자 그 엔나레 보믄 노인드리 어떨떼는 먿허지 마라 이런 머머 허지 마라는 이리 마나요	자 그 옛날에 보면 노인들이 어떤 때는 뭘 하지 마라 이런 뭐 뭐 하지 말라는 일이 많아요
정월 초하루 나른 너무 머 여자드리 너무지비 머 어떠게 갇 드러가지 마라	정월 초하루는 남의 뭐 여자들이 남의 집에 뭐 어떻게 들어가지 마라
가지마라	가지마라 예
그런거뜰 마니짜나요	예 그런 것들 많이 있잖아요
언제나 초하린 나른 너무 지비 드러가지 마라고	언제나 초하루는 남의 집에 들어가지 말라고
여자드른 너무 지비 드러가믄 재수가 엄따고	여자들은 남의 집에 들어가면 재수가 없다고
저네 우리 친정 아부지도	전에 우리 친정아버지도
또 남자드리 지내문 여자가 뽀르르이 건네가지 마고	또 남자들이 지나가면 여자가 뽀르르 건너가지 말고
언제나 남자들 지내가고 나문 가고	언제나 남자들지나가고 나면 가고
뭐 지금도 차가 저그 오먼 그 차 보내노코 건네 가지 저그 차 오는디 아페 뽀르르이 건내가고 그거이는 여자드른 그런 이를 안허능 거이고	뭐 지금도 차가 저기 오면 그차 보내 놓고 건너가지 저기 차 오는데 앞에 뽀르르 건너가고 그것은 여자들은 그런 일을안 하는 것이고
특히 여자들헌테이	음 특히 여자들한테
하꾸요이	하고요
그런다구요 울 아부지도 저네 시집올 때 그렁걸 싹 안치노코 시키요	그런다고요 우리 아버지도 전에 시집올 때 그런 그런 걸 싹 앉혀 놓고 시켜요
이 이전 노이니 데야가꼬	이전 노인이 되어가지고
구싱만 탕탕해가꼬	구식만 탕탕 해가지고
또 겨론할 떼 인자 겨론 허 허 할 떼는 또 먿허지 마라 그렁거 이쓸까요 겨론식 나두고는 머 어쩌르	또 결혼할 때 이제 결혼 하 하 할 때는 또 뭘 하지 마라 그런 것있을까요 결혼식 놔 두고는 뭐 어째
게론헐 때 가 가매타고 가먼 가매 타고 가는디	결혼할 때 가 가마 타고 가면가마 타고 가는데
그 동네 머 애기를 나아떵가	그 동네 뭐 아기를 낳았든지
그렁거러먼 애기 논 지비 이꼬 그러먼	그런 것이면 아기 낳은 집이 있고 그러면
그 아페다가 호바글 큰 호바글 하나 앙꼬 가요	그 앞에다가 호박을 큰 호박을하나 안고 가요
그 집 지나갈 떼는	그 집 지나갈 때는
그 동네 가문	그 동네 가면
그 동네 애기 논 지비 이씨문	그 동네 아기 낳은 집이 있으면
게론허고 감스록 게론해가꼬 가매를 타와가먹 가매여페다가 무나페다가 호바글 요리 나노코 뒤에 안자 호박 뛰에 안자가꼬	결혼하고 가면서 결혼해가지고 가마를 타고 가며 가마 옆에다가 문 앞에다가 호박을 이리 놔 놓고 뒤에앉아 호박 뒤에 앉아가지고
그이 머 구신 쫀능거이다여	그것이 뭐 귀신 쫓는것이대
호바기	호박이
오  헝깨 제사문 제사때 다릉거는 다 나도 호방너무른 안노커등요	하니까 제사면제사 때 다른 것은 다 놔도 호박나물은 안 놓거든요
아하 호바기 귀신 쫀는 나무린게요	아하 호박이 귀신 쫓는 나물이니까요
예 흥미롬네요	음 흥미롭네요
에 겨론 떼 그런 제미인는 저기 인네요 또 다릉거는 혹씨 겨론헐 떼는 머	예결혼 때 그런 재미있는 것이 있네요 또 다른 것은 혹시 결혼할 때는 뭐
몰라 그렁 거는 인자 다릉 거는 몰라요	몰라 그런 것은 이제 다른 것은 몰라요
그레요	음 그래요
또 사라미 주거서 초상칠 떼는 또 머머 하먼 안된다	또 사람이 죽어서 초상치를 때에는 또 뭐 뭐 하면 안 된다
거그도 또 요 요어지 애기 논디허고 초상허고는 또 서로 저기데야가꼬 초상을 인자 개구니 데야가꼬 할 쑤 엄써서 인자 가문 인젣 저녀게 드로먼 막 부정을 처야지요	거기도 또 요 요 아기 낳는 곳하고 초상하고는 또 서로 적이 되어가지고 초상을 이제 계원이 되어가지고 할 수 없어서 이제 가면 이제 저녁에 들어오면 막 부정을쳐야지요
머 어떠케 침니까 부정을 어떠케	뭐 어떻게 칩니까 부정을 어떻게
막 소그물 헏 뿌리고	막 소금을 뿌리고
인자 깨끄시 인자 거석허고 거그서 머 오또 가라입꼬 드로라 인자	이제 깨끗이 이제 뭐하고 거기서 뭐 옷도 갈아입고 들어오너라 이제
더럽따고	더럽다고
그러지요	그러지요
그러조이	그러지요
초상친디 가따오문 저네는 애기가 그리 울먼 초상친디 가따와서 저지러서 그런다고 그리 마리때요	초상 치르는 데 갔다 오면 전에는 아기가 울면 초상 치르는 데 갔다와서 저질러서 그런다고 그렇게 말이 있데요
초상지베 가따오며는 그게 모미 더러와지고 좀 그런다고요이	아 초상집에 갔다오면은 그게 몸이 더러워지고 좀 그런다고요
또 이 떼에 따라서 머 정초에는 너무지베 바늘 빌리러 가지 마라라 머 그럼말도이씀니까	또 이 때에 따라서 뭐 정초에는 남의 집에 바늘 빌리러 가지 마라 뭐 그런 말도 있습니까
굴도 싸로 가지 마라	불도 따러 가지 마라
불도 따러 가지 말	불도 따러 가지 마
저네는 이 성낭 거틍거이 귀허고 그렁깨	전에는 이 성냥 같은 것이 귀하고 그러니까
이우찝써 부를 마니 싸가꼬 와써요	이웃집에서 불을 많이 싸가지고 왔어요
불쌀게에다가 그지비 잉그라글	불쏘시개에다가그 집 잉걸불을잉그락은 잉걸불의 방언형
다머가꼬 그냥 쪼차와가꼬	담아가지고 그냥 쫓아와 가지고
인자 부를 부먼 거서고 막 오다가 그냥 바라메 그냥 부리 이러나가꼬 막 중가네다가 막 널쭈고 그래써요 저네는	이제 불을 불면 뭐하고막 오다가 그냥 바람에 그냥 불이 일어나가지고 막 중간에다가 막 떨어뜨리고 그랬어요 전에는
그런 다른 정워레는 그걸 하지 마라고요	음  그런 다른 정월에는 그걸 하지 마라고요
웨 그럴까요	음 왜 그럴까요
인자 해러븡깨 어른드리 그러지요	이제 해로우니까 어른들이 그러지요
그레요이 아라씀니다	음 그래요 알았습니다
그다으메 그다으메는 인제 엔나레 지금도 병이 만치만 엔나레도 병이 만치 아나씀니까 근데 야기 별로 업쓰니까	그 다음에 그 다음에는 이제 옛날에 지금도 병이 많지만 옛날에도 병이 많지 않았습니까 그런데 약이 별로 없으니까
사람드리 인자 그 민간 요뻐비라 헤가지고 엔나레는 인제 저기를 헤써요 어떤 치료를 헌다고 막 여러가지로	사람들이 이제 그 민간요법이라 해가지고 옛날에는 이제 저기를 했어요 어떤치료를 한다고 막 여러가지로
헨는데	했는데
에를 드러서 막 버즈미 마니 셍게따 피부뼝 얼구리 베즘 버즈미 마니 셍겨따그러먼 엔옌나레는 먼 어트케 치료를 헤씀니까 버지미	예를 들어서 막 버짐이 많이 생겼다 피부병 얼굴이 버짐 버짐이 많이 생겼다 그러면 옛 옛날에는 무슨 어떻게 치료를 했습니까 버짐이
이예 약뿌렝이 거틍거 조타는 약뿌렝이 머 그렁걸 캐다가 인자 막 찌서도 보리고글거서도 보리고	이제 약초 뿌리 같은 것 좋다는 약초뿌리 뭐 그런 걸 캐다가 이제 막 찧어서도 바르고긁어서도 바르고
약뿌렝이를	음 약초 뿌리를  우리 웃음 우리 시방 세째 아드리 또 기 띠예 여그에가 도래버지미 생기가꼬우리 웃음 우리 지금 셋째 아들이 또 귀 뒤에 여기에 도래버짐이도래버짐은 둥그렇게생긴 버짐 생겨가지고
망우이 야글 해도 안데고 해서 똥을 보르먼 난는대서똥을 볼라농깨 주거도 안볼릴라고 울고 야다니서	아무리 약을해도 안 되고 해서 똥을 바르면 낫는대서 똥을 발라 놓으니까 죽어도 안 바르려고 울고 야단이어서
또 마느를 찌부치가꼬 헤글트리먼 그가꼬 야글 보리먼 난는다고	또 마늘을 찧어 붙여가지고 헤어지게 만들면 그래가지고 약을 바르면 낳는다고
어떤 머	어떤 뭐
마늘	마늘
헤글트니 머에요	헤글튼이 뭐예요
인자 그걸 볼라노먼 사리 막 뜨거워서 그냥 헤지지 안나요	이제 그걸 발라 놓으면 살이 막 뜨거워서 그냥 헤어지잖아요
어어응  그래가가꼬 헤글트린다 그래가꼬	그래가지고 헤어지게 만든다 그래가지고
그걸 좀 찌 볼라뜨만 아이고 아가 그양 네바를 띠데요 뜨그 막 아파서	그걸좀 찧어 발랐더니 아이고 아이가 그냥 네 발을 뛰데요 뜨거 막 아파서
그 그래  도 난는 그래 안 나싱깨 그래가꼬 나순다고 인자 그래	그래도 낫는 그래 안 나으니까 그래가지고 낫게 한다고 이제 그래
인자 나끼는 나산는디 거가 머리가 두문 두문해이 항개썩 이꼬 머리가 엄써요	이제 낫기는 나았는데 거기가 머리가 드문드문하게 한 개씩 있고 머리가 없어요
오  지금도요	오 지금도요
지금도 좀 자가요 함범 뿌리가 안낭깨	지금도 좀 작아요 한번 뿌리가 안 나니까
아아  근디 인자 지그믄 인자 쪼깜 요리 지룽깨로	그런데 지금은 이제 조금 이리 기르니까
지룽깨 우에 머리가 와서 요리 더퍼가꼬요런디	기르니까 위의 머리가 와서 이리 덮어가지고 이런 데
저네는 인자 나가 머리로 까까조요 우리 애기더른	전에는 이제 내가 머리를깎아 줘요
수뽀찌로	스포츠 머리로
나가 머리르 까꾸문 여기 한쪼게는 여가 머리가 두문두문해니 나고 얄구께 나농깨로 제갇 나를 원망을 해	내가머리를 깎으면 여기 한 쪽에는 여기에 머리가 드문드문하게 나고 얄궂게 나니까 제가 나를원망을 해
엄마는 먿헌다고 날 여따가 이래허이 멀 도쿤걸 볼라가 이 머리도 안나게 해난냐	엄마는 뭐 한다고 날 여기에다 이렇게 뭘 독한 걸 발라가지고 이 머리도 안 나게 해놨느냐
긍게 엔나레는 똥을 보르먼 버지미 난는다	그러니까 옛날에는똥을 바르면 버짐이 낫는다
마늘 도캉걸 하먼 난는다	마늘 독한 걸 하면 낫는다
똥을 보리믄 그거이 머 뽀라 올리서 난는다고 또 똥을 보리라 고 모도 그래싸터마는  주거도 애기가 데농깨 더럽따고 그걸 암보릴래	똥을 바르면 그것이 뭐 빨아 올려서 낫는다고 또 똥을 바르라고 모두 그래 쌓더니마는  죽어도 아이가 되어놓으니까 더럽다고 그걸 안 바르려고 해
마느리 찌 부치써요	마늘을 찧어붙였어요
그다으메 머 땀 땀떼나 이렁거 땀띠가틍거 나먼 어뜨게 엔나레는 어뜨게 치료할찌 땀띠는	그 다음에 뭐 땀 땀띠나 이런 것 땀띠 같은 것 나면 어떻게 옛날에는 어떻게 치료할지 땀띠는
땀뗑이 나모 마 애기드른 부늘 볼라주고 저네	땀띠나면 마 아이들은 분을 발라주고 전에
아아 부늘 볼라주고 그래써요	분을 발라주고 그랬어요
으음    지금도 그러지요 뭐 이러케 좀 피부가 이제카믄	지금도 그러지요 뭐 이렇게좀 피부가 이러면
분볼라주고	분 발라 주고
지금도 애기들 막 물고 그러먼	지금도 아이들 막 무르고 그러면
사치 물고 그러먼 볼라주고 그래	샅이 무르고 그러면 발라 주고 그래
또 머 부스 부스르미나 이렁거 이렁거 나면 어떠케 어떠케 치료 하시나요 부시럼 가틍거 나면	또 뭐 부스 부스럼이나 이런 것 이런 것 나면 어떻게 어떻게 치료하시나요 부시럼 같은 것 나면
찰밤나무	찰밥나무
찰밤나무	찰밥나무
그거를 인자 저네는 그런 나무가 쌔써꺼등요	그것을 이제 전에는 그런 나무가 쌨었거든요
시방은 막 거이 조태가꼬 다 파가가고 어쩌고 막 한창 그거 조타고 그냥 모도 그냥 탄 칻음 톱 낟가꼬 댕임서 그냥 꾕이 가꼬 댕임서 모도 막 남자드리 파가가고 날리를 천는디글쩨는 그렁거이 쌔야씅깨	시방은 막 그것이 좋다고 해가지고 다 파가지고 가고 어쩌고막 한창 그것 좋다고 그냥 모두 그냥 탄칼 톱 낫 가지고 다니면서 그냥 괭이 가지고 다니면서 모두 막 남자들이 파가지고 가고 난리를 쳤는데 그때는 그런 것이 쌨으니까
찰밤나무 미테 뿌리를 캐먼 캐가꼬 와서 그걷 인자 캉깡 찌먼 찰지디 찰저요	찰밥나무 밑에 뿌리를 캐면 캐가지고 와서 그것 이제 쾅쾅 찧으면 차지디 차져요
그걸 인자 요리 막해를 빼낸다고 그렁걸 보리고 그래써요	그걸 이제 이리막 해를 빼낸다고 그런 걸 바르고 그랬어요
그럼 부스러미 넘 난나요	아 그럼 부스럼이 났나요
그럼 일쫑에 약초네요이	어 그럼 일종의 약초네요
기게똑 가틍거 올라오먼 어떠나요 기게똑 오르먼 머리에	기계총 같은 것 올라오면 어떠나요 기계총 오르면 머리에
긍깨 그렁걸 마니 해요	그러니까 그런 걸 많이 해요
그런 시그로	그런 식으로
저 질겡이	저 질경이
질겡이 그거또	질경이 그것도
뻬뿌젱이	뻬뿌젱이
빼뿌제미	빼뿌제미
저넨 우이들뜨른 빼뿌제미라헌디 여채게는 질겡이데요	전에는 우리들은 빼부제미라 하는데 여 책에는 질경이데요
그거또 캐가꼬 막 뿌리차	그것도 캐가지고 막 뿌리채
찌가꼬 볼라주고	찧어가지고 발라 주고
또 제비꼳	또 제비꽃
네  제비꼳 그거또 찌가꼬 볼라주고 머 푸른 장  댕이 앙꼬 그런디는 또 그렁걸 또 볼라주고	제비꽃 그것도 찧어가지고 발라 주고 뭐 푸른 멍이 앉고 그런 데는 또 그런 걸 발라 주고
푸 푸렁장뎅이	푸 푸렁장뎅이
장댕이 나불고지고 그런디는	멍이 들어 나불거지고 그런 데는
멍들고 이런데	아 멍들고 이런 데
그렁걸 또 찌가꼬 볼라도 주고	그런 걸 또 찧어가지고 발라도 주고
저네는 그라지만 뉘가 요새는 그렁거 아무도 아내요	전에는 그러지만 누가 요새는 그런것 아무도 안 해요
무조껀 벵워느로 가지	무조건 병원으로 가지
누네 병이 날 수도 이짜나요 머 눙꼬비 낀다등가이	눈에 병이 날 수도 있잖아요 뭐 눈곱이 낀다든지
저넨 소금무를 막 점부 씨꺼요	전에는 소금물을 막 전부 씻어요
소금물로	소금물로
에 머 다라 다레끼 나고 이레도 막 다랃	예뭐 다래끼 다래끼 나고 이래도 막 다래끼
다레께 낭 그렁거능 인자 그 짜먼 나꼬	아 다래끼 난 그런 것은 이제 그짜면 낫고
짜먼 나꼬 소그므로 하고이 또 머에 이 엔나레는 누네피라 헤가지고 누네병이 셍기자나요	짜면 낫고 소금으로 하고 또 뭐야 이 옛날에는 눈병이라 해가지고 눈에 병이 생기잖아요
긍깨 눈뼁이 와서 그냥 그또 오리거등요	그러니까 그게 눈병이 와서 그냥 그것도 옮거든요
네  하나이 아푸먼 그냥 시꾸대로 다 그러고 그러먼 긍개 소그무르 강가느이 해아꼬만날 씨꼬	하나가 아프면 그냥 식구 모두 다 그러고 그러면 그러니까 소금으로 간간하게해가지고 만날 씻고
그래찌요	그랬지요
그다으메 여기 옌나레 무좀 이렁거쏜 이 손 사이에 무좀가틍거 이짜나요 발 사이에	그 다음에 여기 옛날에 무좀 이런 것은 이 손 사이에 무좀 같은 것 있잖아요 발 사이에
가렵꼬 그렁거뜨른 어떠케 치료 헤쓸까요	가렵고 그런 것들은 어떻게치료했을까요
그렁거또 어째튼 씨코 거그를 안다코로	그런 것도 어떻든 씻고 거기를 닿지 않게
머 감도 쪼개가꼬 보리고	뭐 감도 쪼개가지고 바르고
가믈 쪼게요	감을쪼개요
쎙감 생	생감 생
감 쌩감	감 생감
엉  쌩가물 쪼개가꼬 또 새에다가 여코 또 머이냐	생감을 쪼개가지고 또 사이에다 넣고 또 뭐냐
무화가	무화과
요새 무화가	요새 무화과
그걸보고 다래라 하거등요 저네 우리더른	그걸보고 다래라 하거든요 전에 우리들은
무화과를 다레라고 그레써요	무화과를 보고 다래라 그랬어요
오호  다래 그걸르 인자 해놈 막 그 찌니 영 그거이	다래 그것을 이제 해 놓으면 막그 진이 영 그것이
하얀 찜	하얀 진
영 그거이 도캐요	영 그것이 독해요
에 하얀 찌니 나오조	예 하얀 진이 나오지요
그걸 보리고 막 그래써요	그걸바르고 막 그랬어요
으음 그레써요이	음 그랬어요
야기 업써서	약이 없어서
감기 감기는 주로 어떠케 치료를 헤쓸까요 야겁쓸 떼는	감기 감기는 주로어떻게 치료를 했을까요
댄니파리허고 또 그거 이르미 머이니라 흐건 꼬치 요리 지대머니 이씨문 그거뽀라묵꼬 그러는디 그걸 먼 나무라니라 그 나무 이르믈 모르건네	댓잎하고 또 그것 이름이 뭐니라 하얀 꽃이 이리 길다랗게 있으면 그것 빨아 먹고 그러는데 그걸 무슨 나무라고 하니라 그 나무 이름을 모르겠네
그거를 인자 막 쌀마가꼬	그것을 이제 막 삶아 가지고
그 무를 마시고	그 물을 마시고
댄니파리하고	댓잎하고
댄닙싹하고이	댓잎하고
그 나무를 머 윤동초라 그러데요	그 나무를 뭐 인동초라 그러데요
윤동초	인동초
오  윤동초 나무 그거를 인자 막 능끄레기로 거더다가 대바까야 그거이 마니 능끄러 올라가거등요	인동초 나무 그것을 이제 막 넝쿨을 걷어다가 대밭 가에 그것이 많이 넝쿨이 울라가거든요
그걸 인자 베다가 댄니파리허고 막 베가꼬 와서 쌀마 노먼 복싹허니 무리 그래요	그걸 이제 베어다가 댓잎하고막 베어가지고 와서 삶아 놓으면 불그스름하게 물이 그래요
검 그거를 인잗 마시고 막 따믈 내지요	그러면 그것을 이제 마시고 막 땀을내지요
이우르 둘러 씨고 막	이불을 둘러쓰고 막
찌  찜질허는 시그로	찜질하는 식으로
으음  따믈 내고 그래써요  이저네는	땀을 내고 그랬어요 이전에는
우리들 감기 드러가꼬 그래가 누씨믄 어메드리 가서 그걸 해다 쌀마가꼬 항그륵 그냥 머 당걸 타 저네 요새는 설탕이 이꼰 허제마는 저네는 당원 우리들 클쩨는 당원그노믈 타가꼬	우리들 감기 들어가지고 그래가지고 누워있으면 엄마들이 가서 그걸 해다삶아가지고 한 그릇 그냥 뭐 단 것을 타 전에 요새는 설탕이 있곤 하지마는 전에는 당원우리들 클 적에는 당원 그것을 타가지고
달게 해가꼬 인자 주믄 그눔 항그륵 마신 마신 무어 점 마시레 노코는 그냥 이우르 가따 처더퍼가꼬 그냥	달게 해가지고 이제 주면 그것 한 그릇 마신 마신 뭐 전부 마시라 해 놓고는 그냥 이불을 가져다 쳐덮어가지고 그냥
따믈 쪽빼주고 그래써요	땀을 쭉 빼 주고 그랬어요
그 효꽈가 이썬나요	예 그 효과가 있었나요
인제 따믈 빼농깨 나산능가 그걸 무꼬 나산능가	이제 땀을 빼 놓으니까나았는지 그걸 먹고 나았는지
나리 가서 나산능가 모르지요 인자	날이 가서 나았는지 모르지요 이제
그거이 야기라고 그래가꼬 무거씅깨	그것이약이라고 그래가지고 먹었으니까
그다으메 머 콤무리 마니 난다던가이 가레가 이따덩가 이러먼 또 어떠케 치료를 헤쓸까요	그 다음에 뭐 콧물이 많이 난다든지 가래가 있다든지 이러면 또 어떻게 치료를 했을까요
그렁거능 머 먼냐글 핸능고 잘 모르거써요	그런 것은 뭐 무슨 약을 했는지 잘모르겠어요
풍이 든 사람 이짜나요 풍 풍마자따고	풍이 든 사람 있잖아요 풍 풍 맞았다고
풍마즌 사람 떨고 드란잔는 사람	풍 맞은 사람 떨고 들어앉아 있는 사람
에 목 반 반쪼기 한 잘	예 목 반 반쪽이 한 잘
어떠케 치료 함니까 치료가 인나요 엔나레 그런 냥반드른	어떻게 치료합니까 치료가 있나요 옛날에 그런 양반들은
엔나레는 그래가 드란즈먼 이자 바로 병신멩이로 드러 안자써찌요	옛날에는그래가지고 들어앉아 있으면 이제 바로 병신처럼 들어 앉아 있었지요
머 나산능가요 저네는	뭐 나았나요 전에는
그레쪼이	그랬지요 예
그다으메 또 인제 엔나레는 체하 체를 체하기도 마니 헤짜나요이 꽉꽉	그 다음에 또 이제 옛날에는 체하 체를 체하기도 많이 했잖아요 꽉꽉
체하고이 그러먼 어떠케 헤씀니까 엔나레는	체하고 그러면 어떻게 했습니까 옛날에는
훌짜녀기 따찌 머 요런디	땄지 뭐
손까라게 끄테	손가락에 끝에
바늘로 가꼬	바늘을 가지고
피를 네	음 피를 내
따고 훌꼬 배가 아푸먼훌꼬	따고 훑고 배가 아프면 훑고
배도 훌른 사라미 이써요	배도 훑는 사람이 있어요
잘 훌른 사라미	아 잘 훑는 사람이
그 사람한 그 사람 지베감니까	그 사람한테 그 사람 집에 갑니까
아이고 명제리 데머 우리지비 우리 친정 어머니 배 훌른 사라미라	아이고 명절이 되면 우리 집 우리 친정어머니 배 훑는 사람이야
인자 오모까심 소글 쪽쪽 요리 훌터가꼬 등거리를 뚜디리고	이제 오목가슴 속을 쪽쪽 요리 훑어가지고 등을 두드리고
아하  또 손톰민요런디를 따고	또 손톱 밑 이런 데를 따고
아하  거 급체헌사람 그렁깨 대방 나떼요	그 급체한 사람 그러니까 대번에 낫데요
그레요	아 그래요
급체허는 사람	급체한 사람
가가꼬 그냥 어러니고 아고 명질 띠 데문 그냥 우리 지비 피바리 서요	그래가지고 그냥 어른이고 아이고 명절 때 되면 그냥 우리 집에 줄이피발은 아마도 줄 정도의의미인듯
마니 머꼬	
마니 머꼬	많이 먹고
언치따고	예 얹혔다고
으음  또 체를 체를 넨 사람도 이짜나요 체 넨다고	또 체를 체를 내는 사람도 있잖아요 체 낸다고
인자 체 내능거는 인자 중가네 그래꼬	이제 체 내는 것은 이제 중간에 그랬고
중가네	중간에
중가네 인자 체르 내찌요	중간에 이제 체를 냈지요
상구 저네 우리 째깐해서는 내는 사람도 업꼬	사뭇 전에 우리조그마해서는 내는 사람도 없고
무조껀 막 훌른거이라 막 창시로 훌터 내레찌	무조건 막 흝는 거야 막 창자를 훑어 내렸지
그레꾸나 거또 잘 하는 사라미 이쓰니까요이	그랬구나그것도잘 하는 사람이 있으니까요
체  어디가 여무다네요 훌트먼	어디가 여물다네요 훑으면
창소를 요리요리 누지리무	창자를 이리이리 누르면
어디가 여문데가 이따네요	어디가 여문 데가 있다네요
아하  거그를 인자 몬질 몬질흐니 그래가꼬 인자 무리게 해가꼬 훌터 내룬데요	거기를 이제 만지작만지작하게몬질몬질허다는 만지작만지작하다의 뜻 그래가지고 이제 무르게 해가지고 훑어 내린대요
거 우리더른 몰라요 어디가 어딘지	그 우리들은 몰라요 어디가 어딘지
그래도 우리 어메는 그걸 자래	그래도 우리 엄마는 그걸 잘해
나중에 중가네 인자 체 네는 사람 요그 이런데도 체 네는 데가 이써씀니까	나중에 중간에 이제 체 내는 사람 여기 이런 데도 체 내는 데가 있었습니까
저 하동가머 이써써요	저 하동 가면 있었어요
하동까지 가야데요	하동까지 가야 돼요
저 과냥도 이꼬	예 저 광양도 있고
오호 순천 순천 순천 거그 저저 그 불끄는 그거 머이라 하능 거이	아 순천 순천순천 거기 저 저 그 불 끄는 그것 뭐라 하는 것이
소방  소방서 미테	소방서 밑에
그가먼 체를 저그 잘랜다고 함참 오지게 댕견는디 난주에느 그거이 머 마수리라 싸코 그머 그래 싸테	거기 가면 체를 저기 잘 낸다고 한창 오달지게 다녔는네 나중에는 그것이 뭐 마술이라 쌓고 그 뭐 그래 쌓데  체를 머하먼 이러게 고기가 체를 뭐 하면 이렇게 고기가
무운 거또 엄는디 머 되지괴기 그렁걸 어찜 그 소게서 나옹거이 그저 썩또 안허고 가마니 싱싱허길 항걸 줌서 요걸 내따고	먹은 것도 없는데 뭐 돼지고기 그런 걸 어찌그 속에서 나온 것이 그저 썩지도 않고 가만히 싱싱하기를 한 것을 주면서 이걸 냈다고
아하  뵈주고 그런다고	보여 주고 그런다고
거진마리다고	아 거짓말이라고
그리고 어떤 사람드른 거 체를 냉깨 난는닥 허고 어떤 사라드른 또 그거이 마수리라	그리고 어떤 사람들은 그 체를 내니까 낫는다고 하고 어떤 사람들은 또 그것이마술이라
근다 그러고 그래 싸튼만 몰라요	그런데 그리하고 그래 쌓더니마는몰라요
그레요이	그래요
뉘 마리 오릉고	누구 말이 옳은지
자 그다으메 토사광란 이렁거늠 막 토하고	자 그 다음에 토사광란 이런 것은막 토하고
예  설사하고 그렁게 이찌요 갑짜기	설사하고 그런 것이 있지요 갑자기
강라네 그 약찌로 가따고	광란에 그 약 지으러 갔다고
그렁거슨 야기 뭐  헤야되나요	그런 것은 약이 뭐 해야 되나요
우리드 클쩌게는 머이냐 소다 소다 그걸 그냥 무꼬 무를 마시고 막 겅거주준허이 그러커등 그거이	우리들 자랄 적에는 뭐냐 소다 소다 그걸 그냥 먹고 물을 마시고 막건건찝찔하게 그렇거든 그것이
그걸무꼬 망 그러고	그걸 먹고 막 그리하고
인자 어메가 배를 잘 훌틍깨 훌꼬	이제 엄마가 배를 잘 훑으니까 훑고
또 소금도 한주먹 그때는 시방은 짜붕거또 암뭉는다는디	또 소금도 한 주먹 그때는 시방은 짠 것도 안 먹는다는데
소금도 한주먹 무꼬 그냥 무를 자꼬무꼬 막	소금도 한 주먹 먹고 그냥 물을 자꾸 먹고 막
무를 막 항그러글 다마시라 그러고	물을 막 한 그릇을 다 마시라 그러고
그러고 나먼 인자 또 막 등거리를 뚜드리고 배를 훌꼬 손꾸라글 따고 인자 그러먼	그리고 나면 이제 또 막 등을 두드리고 배를 훑고 손가락을 따고 이제 그러면
거 대게 설사가 나다가 사라미 씨러지고 금 막 넉씨 엄시뿐 드러누워씨문 또 막힌주글 쒀가꼬 주고 그러데요	그 되게 설사가 나다가 사람이 쓰러지고 그러면 막정신이 없이 들어누워 있으면 또 막 흰죽을 쒀가지고 주고 그러데요
그레써요이	그랬어오
그다으메 에 트키 에드리 마니 그러조이 딸꾹찌리이	그 다음에특히 애들이 많이 그러지요 딸국질이
어떠케 그침니까 거 딸꾹찌른 막 오레 하는수가 이짜나요	어 어떻게 그칩니까 그 딸꾹질은 막 오래 하는 수가 있잖아요
그거또 인자 따꾹찌를 허먼 등거르 뚜디고 무를 자꼬 마시고 그러데요	그것도이제 딸꾹질을 하면 등을 두드리고 물을 자꾸 마시고 그러데요
무를 마시고	아물을 마시고
그다으메 에드리 막 놀레가지고 경 정끼가	그 다음에 애들이 막 놀래가지고경 경기가
정끼	경기
그거슨 어떠게 또 그거 이런	그것은 어떻게 또 그거이런
저네는 머 빨강걸 베기먼 더 근다고	전에는 뭐 빨간 걸 보이면 더 그런다고
아하  막 꺼멍 보따르 가따 둘러씨고 막 그러데요	막 검정 보따리를 가져다 둘러씌우고 막 그러데요
그거또 깍깍 언치먼 그거이 정끼가 나요 애기들또	그것도 꽉꽉 얹히면 그것이경기가 나요 아기들도
언치먼	아 얹히면
언치먼	얹히면
음  시방 그런 애기들 업써요이 저네는 영	시방 그런 아기들 없어요 전에는 영
지금도 이쓸껌니다 가끔 머제 꽁 영 언처서 하는지 어쩐지 모르지마는	지금도 있을 것입니다 가끔 뭐 꽉 얹 얹혀서 하는지 어쩐지 모르지마는
아이고 저네는 저그 정끼가 나문 그냥 새파래이 아가 주거뿐는디	아이고 전에는 저기 경기가 나면 그냥 새파랗게 아기가 죽어 버리는데
시방 그렁거이 엄는디	시방은 그런 것이 없는데
헤기는 쪼깜 시방은 쪼깜 어쩌문 와 벵워느로 다라낭깨 머	하기는 조금 시방은 조금 어쩌면 와 병원으로 달아나니까 뭐
약또 쌛꼬 시방은	약도 쌨고시방은
또 여 쎄빠느리 혀에가 일 일 수도 이짜나요 쎄빠다게 쎄빠느리	또 이혓바늘이 혀에 일 일 수도 있잖아요 혓바닥에 혓바늘이
어째뜽가네 쎄 이베 거서거능거는 소그미를 가꼬 허데요	어쨌든지 혀 입에 뭐하는 것은 소금을 가지고 하데요
소금  소그미	소금이 음
그 다으메 다으메 엔나레다 하신 말쓰민데이	그 다음에 다음에 옛날에 다 하신 말씀인데
머 저네 손니메 데헤서 자세하게 말씀 헤주션는데 손니믄 증상이 어쩜니까 이게 여가 뽈귿뽈귿	뭐 전에 손님에 대해서 자세하게 말씀해 주셨는데 손님은 증상이 어떻습니까 이게 여기가 불긋불긋
거또 인자 여리 오리고 그러능갑떼요	그것도 이제 열이 오르고 그러나 보데요
여리 어뜨 오리고 인자 그더믄 인자	열이 오르고 이제 그러면 이제
머 물찌비 셍깅가요	뭐 물집이 생기나요
인자 오 하무요	이제 오 아무렴요
거 인자 물찌비 생기고	그 이제 물집이 생기고
그러문 인자 저 그거인자 그냥 가마니 이쓰 안 저지리먼 소로가지 그냥 그거이 딱지가 내리문 갠차는디	그러면 이제 저 그거 이제 그냥 가만히 있으 안 저지르면 쉽게 가지 그냥 그것이 딱지가 내리면 괜찮은데
인자 저지라노먼 막 그걸 긍는다데요 막	이제 저질러 놓으면 막 그걸 긁는다네요 막
그 가려우니까이	그 가려우니까
글거가꼬 인자 따까르 자꾸 주어 뜬는다데요	긁어가지고 이제 딱지를 자꾸 주워 뜯는다데요
저지르먼	저지르면
그러믄 인제 여기 흉터가 셍기고이	그러면 이제 여기 흉터가 생기고
예  그 아까 인제 푿 푸씸 푸씸	그 아까 이제 학 학질 학질
푸씨믄 증상이 어떵가요	학질은 증상이 어떤가요
거또 여리 오리고 인자 한참 여르 올라따가 인자 또 막 또 추우가 달라 드러서덜덜덜덜덜덜 떨고	그것도 열이 오르고 이제 한창 열이 올랐다가 이제 또 막 또 추위가달려들어서 덜덜덜덜덜덜 떨고
대게 떨쩨는 이울 두개 세개 더퍼도 소게서 떨리요	되게 떨 적에는 이불 두개 세 개 덮어도 속에서 떨려요
으음  그 인자 한창 그래 알코나머 인자 막 그 시간쩍 그러고 나먼 인자 막 더우가 올라와요	그 이제 한창 그렇게 앓고 나면 이제 막 그 시간씩 그러고 나면 막 더위가 올라와요
아하  여리 올라와요	열이 올라와요
사라미 더워따 추워따가	음 사람이 더웠다 추웠다가
기우니 기냥 다 빠지게 셍겐네요	기운이 그냥 다 빠지게 생겼네요
긍깨 그 함번허고 나머 여름철 그냥 사람 맥빠진다고 그러고	그러니까 그 한번 하고 나면 여름철 그냥 사람 맥빠진다고 그러고
그다으메 홍지니요 홍지는	그 다음에 홍역은요 홍역은
홍지니 내나 그거이지	홍역이 내나 그것이지
에들한테 이뜽거 아니여요 홍진 호녁	애들한테 있던 것 아니예요 홍역 홍역
호녁	아 홍역
그거또 또 또들또들또드래이 그래요	그것도 또도톨도톨하게 그래요
홍진도	홍역도
거또 여리나	그것도 열이 나
거또 여리나고	아 그것도 열이 나고
거또 여리나서 그냥 아가 그냥 불링그락거테	예 그것도 열이 나서 그냥 아기가그냥 잉걸불 같아
그냥 이비 막 헤지고	그냥 입이 막 헤지고
음  시방 홍역 주사가 이싱깨 그만 나아 뿌리고	시방 홍역 주사가 있으니까 그만나아 버리고
그러조 예방이	그러지요 예방이
그다으메 어리네드리 이러케 보리 이러케 쏙	그 다음에 어린애들이 이렇게 볼이 이렇게 쑥
볼치기	볼거리볼치기는 볼거리의 방언형
볼치기	볼거리
예  보리 좀 부짜나요이	볼이 좀 붓잖아요
그거슨증상이 어떵가요그냥 볼만 분나요 그 아푼데가 인나요	그것은증상이 어떤가요 그냥 볼만 붓나요그 아픈 데가 있나요
아휴 보리 부서서 한쪼기 요러치요 막	아휴 볼이 부어서 한 쪽이 이렇지요막
그 대리보문 막 뜨근뜨근해요 여리 올라가꼬 여가 벌그레이 요래	그 만져 보면 막 뜨근뜨근해요 열이 올라가지고 여기가 벌겋게 이렇게
그럼 그걸 어떠케야 난는데요	음 그럼 그걸 어떻게 해야 낫는데요
글쩨는 인자 베니신 주사르 가서 마치요	그럴 때는 이제 페니실린 주사를 가서 맞혀요
열 내리는 주사를	열 내리는 주사를
페니실리느로	페니실린으로
베니신 이라고 그 주사를 마치고 또 그래도 얼릉 안갈리가문 인자 먼 야래 먼야글 핸능가 모르거따 먼 야글 핸는디	페니실린이라고 그 주사를 맞히고 또 그래도 얼른 안 내려가면 이제 무슨 이렇게 무슨 약을 했는지 모르겠다 무슨 약을 했는지
어디 장터 어디 강깨로 거 그리 말고 노랑조시	어디 장터 어디 가니까 그 그리말고 노른자
계란 노랑조시에다가 힌조시 빼뿔고 노랑조시에다가 소그믈 여라데요	계란 노른자에다가 흰자빼 버리고 노른자에다가 소금을 넣으라데요
소그믈 여가꼬 헤 저싱깨로 소그믈 여먼 자꾸 데저요	소금을 넣어가지고 휘휘 저으니까 소금을 넣으면 자꾸 돼져요
데지먼 인자 그거를 인자 문쫑우에다가 저네 창호지	돼지면 이제 그것을 이제문종이에다가 전에 창호지
창호지를 인자 쪼깐허이 요리 짤라가꼬 그거이에라가 요리 페가꼬 볼라농깨로그거이 또 야기데	창호지를 이제 조그맣게 이리 잘라가지고 그것에다가 이리 펴가지고 발라 놓으니까 그것이 또 약이데
오 볼치기 야기에요	오 볼거리 약이에요
하 노랑조시에다가	하노른자에다가
노랑조 조시에다가 소그믈 여가꼬 저싱께 자꾸 여 데지데요	예 노른자 자에다가 소금을 넣어가지고 저으니까 자꾸 돼지데요
그럼 인자 수꾸라글 가 글거가꼬	그럼 이제 숫가락을 가지고 긁어가지고
짝 까라가꼬 딱 부치농깨로 그거또 야기로 나떼	쫙 깔아가지고 딱 부쳐 놓으니까 그것도 약으로 낫데
네  주사르 마치서 나산능가	주사를 맞혀서 나았는지
그거이 야기라고 그래서 나산능가 나떼요	그것이 약이라고 그래서 나았는지 낫데요
그러고 나머 애기드리 빼뺃 얘비저요 그거또 허고 나먼 볼치기도 허고 나먼	그리고 나면 아이들이 빼빼 야위어져요 그것도 하고 나면 볼거리도볼치기는 볼거리의 방언형 하고 나면
고놈 보데껴 가지고	그것 보대껴가지고
여리 나고 그렁깨	예 열이 나고 그러니까
에 저 봉사는 누니 암보이는 사람 아님니까	예 저 봉사는 눈이 안 보이는 사람 아닙니까
근데 누니 암보이는데도 누니 암보이는 그 이저네 먼 병을 아라께찌요 눔뼝을이 어쩌다가 누니	그런데 눈이 안 보이는데도 눈이 안 보이는 그 이전에 무슨 병을 앓았겠지요 눈병을 어쩌다가 눈이
모르지요 어짼는지 그렁거는	모르지요 어쨌는지 그런 것은
고건 치료 방버비 엔나레도 치료가	그건 치료 방법이 옛날에도 치료가
우리 저 친정에 거 우리 칭구 주구매가 그래가꼬 드러안잔는디	우리 저 친정에그 우리 친구 저희 엄마가 그래가지고 들어앉았는데
더드마서도 영 이를 잘헌다네요	더듬어서도 영 일을 잘 한다네요
안보여도	안 보여도
더드마서	예 더듬어서
으음 인 잘 아는 근처는 외우고 이찌요	으음 이제 잘 아는 근처는 외우고 있지요
인자	이제
외우고 이씽깨 그렁가 어쩡가 뭗 메느리가 어디든 나가뿌리도 멀 잘 차자다 무꼬 그런다데요	외우고 있으니까 그런지 어쩐지 뭘 며느리가 어디든 나가 버려도 뭘 잘 찾아다 먹고 그런다네요
집 아네서는	집 안에서는
익쑥하니까 세로운디 가먼 인자 모타고	익숙하니까 새로운 곳 가면 이제 못하고
인자 인제	이제 이제
방에만 드러 안자씽깨	방에만 들어앉아 있으니까
말리거튼디 그런디 나오고 냉장고에서도 멀 더드마서따 가따 무꼬 근다 그래싸테	마루 같은 데 그런 데 나오고 냉장고에서도 뭘 더듬어서 가져다 먹고 그런다 그래쌓데
그다으메 엔나레 무당 이런 사람들 와가지고 병 고친다고 그렁거 보셔써요 어떤지븐 보통 불러다가 허자나요 굳허고이	그 다음에 옛날에 무당 이런 사람들 와가지고병 고친다고 그런 것 보셨어요 어떤 집은 보통 불러다가 하잖아요 굿하고
꼭 구드 구슬허고 그러지마네도 그래서 곤칭는가 어짼능가 그러고 나먼 모도 난는다고 모도 그러싸틈만	꼭 굿을 굿을 하고 그러지마는 그래서 고쳤는지 어쨌는지 그리고나면 모두 낫는다고 모두 그래 쌓더구만
몰라요 혀를 차며 나는 손 암비벼바써요	몰라요  나는 손 안 비벼 봤어요
근데 어떤 지븐 그렁걸 조아하는 지비 이찌요	예 그런데 어떤 집은 그런것을 좋아하는 집이 있지요
이 정월되문 이 요 요새 막 집찜마동 뚜드릴꺼여	이 정월 되면 이 요 요새 막집집마다 두드릴 거야
갈궁치고 다닝거	아 걸립 치고 다니는 것
떠개노코	떡 해 놓고
서레 떠글 쪼까만 한다 그래요 저저그 안택올때	설에 떡을 조금만 한다 그래요 저기 안택 올 때
음  헌다허고 그거 인자 안태기라고 지비서 그 나를 바다가꼬 점재이한테 가 저믈 해가꼬 언제 며친날 우리집 뚜디리 도라고	한다 하고 그것 이제 안택이라고 집에서 그 날을 받아가지고 점쟁이한테 가서 점을 해가지고 언제 몇 일 우리집 두드려 달라고
그러무 와서 인자 뚜드리고 뚜드리문 또 점재이 반치나 줘부리고	그러면 와서 이제 두드리고 두드리면 또 점쟁이 반이나 줘 버리고
욕씸 마는 점재이는 머 쌀도 마니 나라 머 머또 떡또 마니 나라 우째가 싹 싸질머지고 가고	욕심 많은 점쟁이는 뭐 쌀도 많이 놔라 뭐 뭐도 떡도 많이 놔라 어째서 싹싸서 짊어지고 가고
정워레 점쟁이 불러다가 그러케 하는 데도 이꼬	아 정월에 점쟁이 불러다가 그렇게 하는 데도 있고
보르마네	보름 안에
응 보르마네이	응 보름 안에
또 인제어떤 막 정심뼝이 이따거나 막 그런 사람드른 구테가지고 막 막 할	또 이제어떤 막 정신병이 있다거나 막 그런 사람들은 굿해가지고 막 막 할
귀신 드러따고	귀신 들었다고
그람 막 메에도 가서 뚜두리고	그럼 막 묘에도 가서 두드리고
어디요 메 메	어디요 묘 묘
무다니 귀신드러따고 머 저쩌그문 선조들 메에 가서 뚜두리고	괜히 귀신 들었다고 뭐 걸핏하면 선조들 묘에 가서 두드리고
으으음  머 니가 드러서 이런다 그러고 머를 잘몯 해줘서 그런다 그러고 인자 점재이 마레게야 이찌요	뭐 네가 들어서 이런다 그리하고 뭐를 잘못 해 줘서 그런다 그리하고 이제 점쟁이 말하기에 달렸지
그러고 저 네거리에 가서 또 뭐 그사람 오슬 뭐 가따가 또 꼬실라 주고 어쩌고머 막 그래싸트만 우는 그렁거 안해바는 몰라요 놈 허능 검만 봐찌	그리고 저 네거리에가서 또 뭐 그 사람 옷을 뭐 가져다가 또 불살라 주고 어쩌고뭐 막 그래 쌓더니마는 우리는 그런 것 안 해 봐서 몰라요 남 하는 것만 봤지
네 약초 캐기  또 진상은 사니 주위에 만차나요이	또 진상은 산이 주위에 많잖아요
예  그르니까 약초가틍거 쫌 케고 그러셔써요	그러니까 약초 같은 것 좀 캐고 그러셨어요
삽초 또 머 항가꼬	삽초 뭐 엉겅퀴
머 저렁걸 캐다 모도 막 쌀마 무꼬 그래땁떼	뭐 저런 걸 캐다 모두 막 삶아 먹고 그랬다고 하데 삽초는 어떠 어디 아푼데 쓰나요 삽초는 어떠 어디 아픈 데 쓰나요
몰라요 나능 그렁걷 머 제처레 댕이니라고 안해 반는디	몰라요 나는 그런 것뭐 광양제철에 다니느라고 안 해 봤는데
할메드리 그렁걸 캐다가 막 소테다가쌀마가꼬 무를 마시고 날리를 치데요	할멈들이 그런 걸 캐다가 막 솥에다가 삶아가지고물을 마시고 난리를 치데요
그레요	그래요
나는 나 살기가 복짜배가꼬 돔벌라고만 애를 써쩨	나는 나 살기가 복잡해가지고 돈 벌려고만 애를 썼지
으음음 그런 약초에 데해서는 관시미 업써꾸마뇨	으음음 그런 약초에 대해서  는 관심이 없었구먼요
또 모캐러 가는 사라미 저 하동 자아 가먼 거 캐다가 즈저그 막 다라이 거튼디 노코 폴먼 인자 거 그거 면무더리 사다가 쌀마 무꼬	또 뭐 캐러 가는 사람이 저 하동장에 가면 그 캐다가 저 저기 막 넓은 대야 같은 데놓고 팔면 이제 그 그거 몇 무더기무더리는 무더기의 방언형 사다가 삶아 먹고
머 돌가지 대추 골고루 골가래 저으저저 참꼬뿌렝이	뭐 도라지 대추 고루고루고루고루 저기 저 진달래 뿌리  캐다가 막 쌀마가꼬 거따가 담바블 해 뭉는 사람 머 머 어쩌고 해싸튼만 그래서 멩이 징가 멩이 진사람 쌔야씹띠다 웃음 캐다가 막 삶아 먹고 거기에다가 식혜를단밥은 식혜의 방언형 해 먹는 사람 뭐 뭐 어쩌고 해 쌓더구마는 그래서 명이 긴지 명이 긴 사람 쌨습디다
자 그다으메 엔나레는 인제 설 보름 머 머 달마다	자 그 다음에 옛날에는 이제 설 보름 뭐 뭐 달마다
머시 다 이짜나요 그레가지고 헹사 그떼마다 머 머 특뼈라게 어뜨 이 하는 이리 이꼬 그러자나요	뭐가 다 있잖아요 그래가지고 행사 그때마다 뭐 뭐 특별하게 어뜨 이 하는 일이 있고 그러잖아요
그렁걸 다 해가꼬	그런 걸 다 해가지고
하문 그러지요	하면 그러지요
자 함 그거슬 인자 거 하나씩 하나씩 함번 예서 설	자 한 그것을 이제 그 하나씩 하나씩 한 번 여기서 설
서리믄 지그믄 인자 마니 풍스비 달라저찌마는	설이면 지금은 이제 많이 풍습이 달라졌지마는
엔날 정월 보 초하루 여기 서리믄	옛날 정월 보 초하루 여기 설이면
서떨 그뭄날 저녀게 밥 채리노코	섣달 그믐날 저녁에 밥 차려 놓고
서떨 그뭄날 밥 바블 체려놈니까	섣달 그믐날 밥 밥을 차려 놓습니까
걸게 해가꼬	예 걸게 해가지고
오  제사를 모시요	제사를 모셔요
그레요	그래요
저 예나 정월 초하린나른 떠꾸끼리노코	저  정월 초하루는 떡국 끓여 놓고
제사는 차레는	아 제사는 차례는
그뭄날 저녀게 허고	그믐날 저녁에 하고
그걸 머라고 그레요 무슨 고거이 이르미 이씀니까 서딸 그뭄나레 하능 거 보고	그걸 뭐라고 그래요 무슨 그것이 이름이 있습니까 섣달 그믐날에 하는 것보고
인자 제사 모신다 그러지요	이제 제사 모신다 그러지요
제사모신다고 그레요	제사모신다고 그래요
글고요	아 그리고요
제사 모시고 인자 또 정월 초하린날 인자 또 떠꾸끼리노코 또 제사 모시고	제사 모시고 이제 또 정월 초하룻날 이제 또 떡국 끓여 놓고 또 제사 모시고
또보르메 하고	또 보름에 하고
보르메는 주로 멀 함니까	보름에는 주로 뭘 합니까
보르멘 또 인제 찰밥 오곡빱 해노코 인자	보름엔 또 이제 찰밥 오곡밥 해 놓고이제
또 채리노코	또 차려 놓고
음식은 인제 보르메 체려 노치마는	음식은 이제 보름에 차려 놓지마는
또 서우레는 서울 쪼게는 이렁게 이떼요 거 딱딱한 머 땅콩이나 이렁걸 가따가 께 멍는 보르메	아 또 서울에는 서울 쪽에는 이런 게 있데요 그 딱딱한 뭐 땅콩이나 이런 걸 가져다가 깨어 먹는 보름에
그 여기도 그렁게 이씀니까	여기도그런 게 있습니까
그냥 여는 오곡빱 해요	그냥 여기는 오곡밥 해요
오곡빱 허지요이	오곡밥 하지요
오곡빱 허고 또 새 쪼꼬 보름날	오곡밥 하고또 새 쫓고 보름날
세쫀는 날 어떠케 어디가서 세쫀능가요	
세쫀는 날 어떠케 어디가서 세쫀능가요	새 쫓는 날 어떻게 어디 가서 새 쫓나요
새보게 인자 또 모닥뿔 나 노코	새벽에 이제 또 모닥불 놓아 놓고
인자 새쪼꼬	이제 새 쫓고
세보게 어디다 모닥뿔 피어요	새벽에 어디에다 모닥불 피워요
저지 암데라도 마당에 어디 해노코는 막 새쫀는다고 우여 우여	저기아무 데라도 마당에 어디 해 놓고는 막 새 쫓는다고 우여 우여
오 그거이 무슴 마리까요 웨 그러까요	오 그것이 무슨 말일까요 왜 그럴까요
또 더우 포라뭉는다고 또 내더우 허고	또 내 더위 팔아 먹는다고 또 내더위하고
그러조이	예 그러지요
니더우 네더우이 더우 포라 뭉는다고이	네 더위 내 더위 더위 팔아 먹는다고
그다으메 또 그거 허션 나 나무지베 머 찰밥또 이러케 돌라서 머끼도 하고	그다음에 또 그것 하셨 남 남의 집에 뭐 찰밥도 이렇게 훔쳐서 먹기도 하고
인제 조레르 가꼬 어드로 댕기요	이제 조리를 가지고얻으러 다녀요 어드로 뎅긴다 조레로얻으러 다닌다 조리로
조레르 가꼬	예 조리를 가지고
집찜마동 어드로 댕겨	집집마다 얻으러 다녀
웨 어드로 다닐까요 웨	음 왜 얻으러 다닐까요 왜
더우 파라 뭉는다고 인자 그러 인자 가문	더위 팔아 먹는다고 이제 그러 이제가면
조레를 가꼬 어드로 가문	조리를 가지고 얻으러 가면
머시야그러먼 대다믈 허먼 내더우 그러먼 더우 인자 그지비서 더우 포라멍는다 허고	뭐야 그러면 대답을 하면 내 더위 그러면 더위 이제 그 집에서 더위 팔아 먹는다고 하고
그러고	아 그러고
인자 몬자부린 사라미 인자 대다블 허먼 인자 엽 더우를 포라뭉능거이고 근다고	이제 먼저 부른 사람이 이제 대답을 하면 더위를 팔아 먹는 것이고 그런다고
으음  동네들 끼리도 뭐 헹사가 인나 노 노리가 이씀니까 이 중네하고 저 동네하고머그먼 저기를 헌다덩가	동네들끼리도 뭐 행사가 있나 노 놀이가 있습니까 이 동네하고저 동네하고 뭐 그러면 저기를 한다든지
달집 진는 거이지	달집 짓는 것이지
달찜 진는다고	달집 짓는다고
동네마동	예 동네마다
달찌픈 어떠케 진는	달집은 어떻게 짓는
인자 미테다가 인자 집 꺼틍걸 마니 여코 대 쩨다가 인자 세워가꼬 지블 맹그러가꼬 요리 해	이제 밑에다가 이제 짚 같은 걸 많이 넣고 대 베다가 이제 세워가지고 집을만들어가지고 이리 해
인자 거따 인자 또 소를 베다가 또 인자	이제 거기다 이제 또 소나무를 베다가또 이제
해가꼬 그래 인자 꼬시리능 거 인자	해가지고 그래 이제 불사르는 거야 이제
보르메 달리 뜨문 인자 볼보롬허니 뜨문 인자 거따 소원 빌지요 젝쩨금 인자모 자석한테 허구잔 사람 머 뉘한테 허구잔 사람 들매김성	보름에 달이 뜨면 이제 불그스레하게 뜨면 이제 거기에다 소원 빌지요 각자 이제 뭐 자식에게하고 싶은 사람 뭐 누구한테 하고 싶은 사람 들먹이면서
그사람 오슬 가따가거따가 여노코 인자 막 저를 허고 막  이라가꼬 저를 허고 그래요	그 사람 옷을가져다가 거기에다가 넣어 놓고 이제 막 절을 하고 막  이리해 가지고 절을 하고 그래요
달찝 달찌블 인제	어 달집 달집을 이제
올해도 허꺼이네요 저저저 그러먼 인자 동네 인자 집찜마동 인잗 동네똔 헌다고	올해도 할 거예요 저 저 저 그러면 이제 동네 이제 집집마다 이제 동넷돈 한다고
머 마눤 내는 사이 이마눤 내는 사람 머 직쩌금 이냐 성이껃 내먼 그놈 가꼬인자 동네또네 씨고 그래요	뭐 만원 내는 사람 이만원 내는 사람 뭐 각자 그냥 성의껏 내면 그것 가지고 이제 동넷돈에 쓰고 그래요
지금도 함니까 헹사가	아 지금도 합니까 행사가
달찝 테운다고	달집 태운다고
장녀네는 재화이 재화니 지비서 또 오신 소님드리	작년에는 재환이 재환이 집에서 또 오신 손님들이
어허  인자 질띠가 엄써가서 그 아페 거그 논 한나이 논 인는디 거따가 지으가꼬	이제 지을 데가 없어서 그 앞에 거기 논 하나 논 있는데 거기에다가지어가지고
아하    사람 마니 구경하러 가써요	사람 많이 구경하러 갔어요
거 지으가꼬 그냥 재화니 지비 오는 소님드르 모도 막 저녀게 차가 메때가 오고 막 그래가 그러고	어 그 지어가지고 그냥 재환이 집에 오는 손님들은 모두 막저녁에 차가 몇 대가 오고 막 그래가지고 그러고
또 멘장이 댕김서롱 또 동네마동 또 돈 주고 다뭄 머 이마넌 쎄기라도 주고 가고 자 또 머 성거에 날 싸람덜또 와서 또또 한닙썩 쩌 주고 가고	또 면장이 다니면서 또동네마다 또 돈 주고 다만 뭐 이만 원씩이라도 주고 가고 이제또 뭐 선거에 나갈 사람들도 와서 또 또 한 잎씩 주고 가고
장녀네는 풍성헨네요	작년에는 풍성했네요
그니깐 그러케 노능거시 에 에	그러니까 그렇게 노는 것이
매고치고	풍물놀이 하고
메구치고이	풍물놀이하고
보르미 젤로 거 머시 만네요이 보름나리	보름이 제일 그 뭐야 많네요 보름날이
정월 보름떼면	정월 보름 때면
인자 동네 싸람드리 천는디 인자 저저 데모난 디로부터서는	이제 동네 사람들이 쳤는데 이제 저 저 데모난 뒤로부터서는
재화니 지비서 인자 메고꾼들 소리해요	재환이 집에서 이제 풍물놀이꾼들 소리 해요
메고꾸는 어디서 와요	풍물놀이꾼은 어디서 와요
몰라요 어이서 오능고	몰라요 어디서 오는지
이 동네 싸람 아니고	이 동네 사람 아니고
오  금 사라미 와서 그런 사람드리 오문 인자 재화니 지비서 인자 대지대지머리 인자 사가꼬 인잗 몬추믄 내난는디 장녀네는 또 우리 동네서 또 해가꼬 또 대지 제쌍 채리는디 또 노코	그런 사람이 와서 그런 사람들이 오면 이제 재환이 집에서 이제 돼지 돼지머리 이제 사가지고 이제 먼저는몬춤은 먼저의 방언형 내어 놓았는데 작년에는 또 우리 동네서 또 해가지고 또 돼지 제사상 차리는 데 또 놓고
거따가 머 도늘 물리고  주를 처노코 또 도늘 바다서 거딱 걸 주레다가끼고	거기다가 뭐 돈을 물리고  줄을 쳐 놓고 또 돈을 받아서 거기다가 그걸 줄에다가 꿰고
그러먼 인자 또 머 동네 사우되는 사암드리 먿 술도 바다 오는 사람 돈도 거는사람 또 과일도 사다 주는 사람	그러면 이제 또 뭐 동네 사위되는 사람들이 뭐 술도 받아오는 사람 돈도 거는 사람 또 과일도 사다 주는 사람
여러가지라에	음 여러가지예요
저네는	전에는
그래  여 동네 싸람드리 글먼 동네 싸람드리 메구칠리리엄네 다른데서 와버리면	이 동네 사람들이 그러면 동네 사람들이 풍물놀이 할 일이 없네 다른 데서 와 버리면
인자 저 진상 멘딴지에 모도 또 메고치는 사람 또 안인능가요	이제 저 진상면소재지에 모두 또 풍물놀이 하는 사람 또 있잖아요
절문삼들	젊은 사람들
인자 또 어이서 안 불러오문 인자 또 그런사람드리 치고 댕기고	이제 또 어디서안 불러오면 이제 또 그런 사람들이 치고 다니고
으음  어째뜽가네 메고 소리는 내대	어쨌든지 풍물 소리는 내데
그러지요이	그러지요
자 정워레는 그니깐 보르미꼬 정월 초하루 이꼬 그레가지고 놀고	자 정월에는 그러니까 보름 있고 정월 초하루 있고 그래가지고 놀고
다음 이워레는	다음 이월에는
바람 올리능 거이고	바람 올리는 것이고
아까 바람 올리능거 말씀	아까 바람 올리는 것 말씀  하셔쪼이 예하셨지요 예
사뭐레는	삼월에는
사뭐레는 또 삼진날 모도 또 멀	삼월에는 또 삼짓날 모두 또 뭘
거서 헌는디 시방 일허니라고 안해요	거기서 하는데 시방 일하느라고 안 해요
그니까 엔날 기여글 더슬리먼 삼진나레는 멀 하션나요	그러니까 옛날 기억을거스르면 삼짓날에 뭘 하셨나요
저네는 머 삼진날 인자 날 바다가꼬 인자 뭔 땓	전에는 뭐 삼짓날 이제 날 받아가지고 이제 무슨 때
동네사람드른 안해도 인자 직쩌금 인자 마음쩌그로 인자 삼진날 인자 조은나리라바다가꼬 인자 무슨 안택또허고 머 손도 비비고 그런 사람들 그럭허고	동네 사람들은 안해도 이제 각각 이제 마음으로 이제 삼짓날 이제 좋은 날이라 받아가지고 이제 무슨 안택도하고 뭐 손도 비비고 그런 사람들 그렇게 하고
그레요이	음 그래요
사워레는 인제 초파이리 인네요	사월에는 이제 초파일이 있네요
초팰른냐 모도 공디리러 가고 놀러 가고	초파일날은 이제 모두 공 들이러 가고 놀러 가고
이저 저레로 저레로 가능거이고 공 가 공드리러 가능거는	이제 절로 절로 가는것이고 공 가서 공 들이러 가는 것은
이따 가서 저레 가서 인자 젝쩌금 인자 소원 빌고	이따 가서 절에 가서 이제각각 이제 소원 빌고
인자 저 하동 송림 거튼디 그런디 인자 모도 모이지면 거그 가서 논닥허무 인자 거그 머 놀먼 인자 먿 모도 술찌메 지그믄 술찌미지머 술찌메 모도 춤치고 놀고 그런다고 온다요	이제 저 하동 송림 같은 데 그런 데 이제 모두 모여지면 거기 가서 논다고하면 이제 거기 뭐 놀면 이제 뭐 모두 술김에 지금은 술김이지 뭐 술김에 모두 춤추고 놀고그런다고 온대요
여기는 어떤 절로 감니까	여기는 어떤 절로 갑니까
이제 젝쩌금 인자젝쩜 민는 저리 다 따로 안 인능가요	이제 각각 이제 각각 믿는 절이 다 따로 있잖아요
그레요이	음 그래요
초페른 그러케 저레가고 놀고이	초파일은 그렇게 절에 가고 놀고
오워레는	오월에는
인자 다논나리제	이제 단오날이지
다논나른 지 지그믄 다논나른 안세지마는 혹시 엔나레 기여기 이씀니까 다노	단오날은 지 지금은 단오날은 안 쇠지마는 혹시 옛날에 기억이 있습니까 단오
다논날 머 어디 저저그 하동 송리거튼디 그런디	단오날 뭐 어디 저 저기 하동송림 같은 데 그런 데
막 계를 해가꼬	막 계를 해가지고
거그 가서하동 송리메 그네가 이꺼등요	거기 가서 하동 송림에 그네가 있거든요
송리 송리미라는 데가 소나무 수피꼬	송림 송림이라는 데가 소나무 숲이 있고
그러는데 말하는	그러는 데 말하는
예요  그 하동그 다리까에 거 다리미테 거그	그 하동 그 다릿가에 그 다리 밑에 거기
거그가서 막 메고치고 놀고	거기 가서 막 풍물하고 놀고
젝쩜 동네 인자 계를 해가꼬 거 가서 인자 그런날 놀고 오고 그래써요	각각동네 이제 계를 해가지고 거기 가서 이제 그런 날 놀고 오고 그랬어요
아 여기는 하동으로 마니 놀로가네요이	음여기는 하동으로 많이 놀러 가네요
저도 그쪼그로 함번 가바야데겐네 하루는  어떠케그냥 가바야겐네 에 그네도 띠고	저도 그쪽으로 한번 가 봐야 되겠는데 하루는  어떻게 그냥 가봐야겠네그네도 뛰고
그 하동 거그 가먼 그네 종거 메나써요	예 그 하동 거기 가면 그네 좋은것 매어 놨어요
지그믄 인능가 몰라 난 거그 안가본자 여러해 대써	지금은 있는지 몰라 난거기 안 가 본 지가 여러 해 됐어
저네는 그 놀로 계를 해가꼬 거그 놀로도가고	전에는 그 놀러 계를 해가지고 거기 놀러도 가고
막 함복입꼬 가서 다논나리라 그네 탠다고 그냥 계를 해가꼬 안 놀고 오고 그랜는디 그	막 한복 입고 가서 단오날이라 그네 태운다고 그냥 계를 해가지고 놀고 오고 그랬는데
모래바테 막 다름치기 하고	모래밭에 막 다름박질 치기 하고  다름치기 해아꼬 비누 메짱썩 따고 막 그냥 다름박질 치기 해가지고 비누 몇 장씩 타고 막 그냥
동네서 그리 장나늘이루고 그랜는디 지그믄야가가꼬	동네서 그렇게 장난을 하고 그랬는데 지금은 약아가지고
야가가꼬	약아가지고
야가가꼬 젝쩌금 살림만 살라하오 도니나 벌락 허고 누늘 까고 그러지 머	약아가지고 각각 살림만 살려 하고 돈이나 벌려고 하고 눈을 까고 그러지 뭐
유월 처른요 다노 다음 유월	유월철은요 단오 다음 유월
유두	유두
유두 유두 때는 머 함니까	유두 유두 때는 뭐 합니까
유두제 안지내요	유두제 지내잖아요
유두제	유두제
엄  저네는 유두주 지낸다고 또 떡해가꼬 논 물끼미테 또 떡 가따가 부꼬 채리노코	전에는 유두제 지낸다고 또 떡 해가지고 논 물꼬 밑에 또 떡 가져다가 붓고 차려 놓고
논 물꼬 인는데다가	논 물꼬 있는 데다가
물뀌에 물드러가는 물뀌에	예 물꼬에 물 들어가는 물꼬에
거따떠글가따노코 그래따여	거기다 떡을 가져다 놓고 그랬대요
오  유두제라고	유두제라고
고 거기또 거그 구신한테 또	그 거기 또 거기 귀신에게 또
거 구신 달개능거 그거또	그 귀신 달래는 것 그것도
달개는 거조	달래는 거지요
유두제	유두제 음
그다믄 치워른	그 다음은 칠월은
백쭝	백중
백쭝	백중
머심들 설랄	머슴들 설날
머심드른 인제 고셍헤따고	아 머슴들은 이제 고생했다고
긍개 그런 노래가 다 안인능가요	그러니까 그런 노래가 다 있잖아요
그러먼 머심드를 위헤서 먿 함니까 머 어떠게 음식 체려주고	그러면 머슴들을 위해서 뭐 합니까 뭐 어떻게 음식 차려 주고
인자 머심들 서리라고 하문 채리가꼬 인자 우리도 놀고 인자 머심들또 놀고 인자	이제 머슴들 설이라고 하면 차려가지고 이제 우리도 놀고 이제 머슴들도 놀고 이제
그래찌요	그랬지요
외나 추석뽀동 보름 저 치뤌 백쭝을 더 크게 세써요	오히려 추석보다 보름 저 칠월 백중을 더 크게 쇘어요
엔나레느뇨옛날에는요  추서근 써꼬지로 간다고 김 그거이 양식허러 가능거	
추서근 써꼬지로 간다고 김 그거이 양식허러 가능거	추석은 섶 꽂으러 간다고김 그것이 양식하러 가는 것
암 추석떼요	암 추석 때요
저 지리산 미테 그런디 가서 인자 써펄쩌가꼬	저 지리산 밑에 그런 데 가서 인자섶나무를 쪄 가지고
스무대지 인자 그거이 시방 마래자거트문	해장죽 이제 그것이 시방 말할 것 같으면
스무데	해장죽
대요	대요
가느소롬헌 대	가느스름한 대
으으음 막 가지 마이 낭거	막 가지 많이난 것
그걸 여긴 써피라 함니까	그걸 여기는 섶이라 합니까
거인자 산주기라 그래요	그 이제 산죽이라 그래요
산주기고	산죽이고
지그믄 여으가 깔바치 업써요	지금은 여기가 갈대밭이없어요
저네는 여으 방첨미테서부터 내리드리 처그	전에는 여기 저수지 밑에서부터 내리 저기
아하  광영꺼장 깔바치라요	광영까지 갈대밭이에요
그문 그걸 항 쩌가꼬 떼배를 무거가꼬 무리 다든녀나 떼배를 무거가꼬 올러오는디는막 올러 오고	그러면 그걸 항 쪄가지고 떼배를 묶어가지고 물이 다 들어온 때나 떼배를묶어가지고 올라오는 데는 막 올라오고
또 일꾼 엄는 지비는 그걸 막 여자들또 막 마지비르 나와가꼬 한다발썩 이고 오고	또 일꾼 없는 집은 그걸 막 여자들도 막 마중을 나와가지고 한다발씩 이고 오고
그래가 그노믈 인자 난나치 추리요	그래가지고 그것을 이제 낱낱이 추려요
막 요런디가 막	막 요런 데에 막
써플	섶을
인자 그 머이야	이제 그 뭐야
까르	갈대를
인자 그건 일련빼끼는 모대요	이제 그건 일년밖에는 못해요
일련빼끼는모더고 저 산주기라고 저귿 지리산 미테 그런디 가서 이에 스무대 쩌가 옹거는	일 년밖에는 못하고 저 산죽이라고 저기 지리산 밑에 그런 데 가서 해장죽 쪄가지고 온 것은
음  뒨년에도 한 삼년해요	다음 해에도 한 삼 년 해요
으음  긍깨 그거능 비싸고 요거는 싸고	그러니까 그것은 비싸고 이것은 싸고
그 그래가 인자 그노믈 대깨썩 요리 몽치서 지플가꼬 점부 가마요	그래가지고 이제 그것을 댓개씩 이리 뭉쳐서 짚을 가지고 전부 감아요
그래가 인자 요리 한다발썩 한다발썩 해가꼬 인자 배르 메치썩 어울라 가꼬	그래가지고 이제 이리 한 다발씩한 다발씩 해가지고 이제 배를 몇씩 어울러가지고
심지르 빼먼 인자 인자 도리아니 인자 글 보고 머라핸니 저네 인자 수도르 요리 내노코 인자 또 여나무 집썩 요래 한수도고 일수도 이수도 그리 해가꼬 그리 허먼	심지를 빼면 이제 동그랗게 이제 그걸보고 뭐라고 했니 전에 이제 수도를 이리 내어 놓고 이제 또 여남은 집씩 이렇게 한 수도고 일 수도 이 수도 그렇게 해가지고 그렇게 하면
인자 끼리끼리 일수도 사암들 인잔 여나무시 허고	이제 끼리끼리 일 수도 사람들이제 여남은이 하고
이수도 싸암들 이수도 싸암들또 여나무시 오오	이 수도사람들 이 수도 사람들도 여남은이 오고
그래가 인자 제꼉 인자 개지근데로 해가꼬 그걸 그냥 이러케 그냥 떼배 떼배맹키로 이러구 우예다 요리 시러가꼬 그 우예가 막사람들 점부 오게오게 해가꼬 배를 두대썩 인자 저그 태인도 가서 어더다가	그래가지고이제 각각 이제 가까운 데로 해가지고 그걸 그냥 이렇게 그냥 떼배 떼배처럼 이렇게 위에다 이리 실어가지고 그 위에 막 사람들 전부 옹기종기 해가지고 배를 두 대씩 이제 저기 태인도 가서 얻어다가
으흠  두개를 요래가꼬 인자 여귿 쌍나르 요리 떼로 요리 매야가꼬 여따가 막 이러케 하문그냥 우예 인자 사라미 마니 안자서 똥 머 구더로가능	두 개를 이렇게 해가지고 이제 여기 쌍날을 이리 떼로 이리 매어가지고 여기다가 막 이렇게 하면 그냥 위에 이제 사람이 많이 앉아서 꼭 뭐 굿하러 가는
그래가 머 정심 머 새꺼리 머 싸가꼬 가서 인자 물꺼리를 인자 꼬바노코 인자 저녀게 인자 또 두댕깨 인자 갈라가꼬 글쩨 인제 갈때는 짐 실꼬 갈라고 인자 두대로 뭉꺼찌마는 올쩌게는 직쩡 갈라가꼬 인자 치늠치느므로 인자 이 배타고자비 이배타고 저배타고자븜 저배타고라 인자 들무레 올라와요	그래가지고 뭐 점심 뭐 곁두리 뭐 싸가지고 가서 이제 물거리를 꽂아꼽다는 꽂다의 방언형 놓고 이제 저녁에 이제 또 두 대니까 이제 갈라가지고 그때 이제 갈 때는 짐 싣고 가려고 이제 두 대로 묶었지마는 올 때에는 각각 갈라가지고 이제 친한 사람들끼리친함친함으로는 친한 사람들끼리의 뜻 이제 이 배타고 싶으면 이 배 타고 저 배 타고 싶으면 저 배 타고 이제 밀물에들물은 밀물의 방언형 올라와요
이케 그게 김 양식하기위헤서 데를 꼽꾸마뇨	예 이렇게 그게 김 양식하기 위해서 대를 꽂구먼요
인자 그카믄 그걸 인잠 남자드리 인잠 요리 발로가 딘능거 이꼬 인자 미치 쪼삗허니 우에 잠능거디꼬 그래아꼬 발로 가꼬 막 쑤세가꼬 흔들먼 그 모래바테가 드러가머 인자 얼릉 또 우리더른 인자 글 끄꼬 댕임서 얼릉 꼬자야대요 언능 안꼬지믄 거 구녕이 매케삐링깨	이제 그러면 그걸 이제 남자들이 이제 이리 발로 딛는 것 있고 이제 밑이 쪼삣하게 위에 잡는 것 있고 그래가지고 발로 가지고 막 쑤셔가지고 흔들면 그 모래밭에 들어가면 이제 얼른 또 우리들은 이제 그걸 끌고 다니면서 얼른 꽂아야 돼요 얼른 안 꽂아지면그 구멍이 막혀 버리니까
그거 빼자마자 또 얼릉 꼬꼬 또 빼 또 요래가꼬 이따가 또 남자들 심미 드러서 이막 흔듬서롱 욜 꼬자 노먼 언능 빼먼 인자 또 얼릉 꼬꼬	그것 빼자마자 또 얼른 꽂고또 배 또 이렇게 해가지고 있다가 또 남자들 힘이 들어서 막 흔들면서 이리 꽂아 놓으면얼른 빼면 이제 또 얼른 꽂고
하유 사람 사능거이 사능거이 아이라	아휴 사람 사는 것이 사는 것이 아니야
그게 주로 파뤌 보름떼 파뤌	그게 주로 팔월 보름 때 팔월
보름씨예	예 보름 때에
에 그떼 함 하니까	그때 하니까
긍깨 추서글 몬 시요	그러니까 추석을 못 쇄요
그러쿠나	그렇구나
그걷허로 가니라고	그걸 하러 다니느라고
으음  그렁깨 인자 치를 백쭝에 그냥 재미께 놀고	그러니까 이제 칠월 백중에 그냥 재미있게 놀고
치뤌 벡쭝에	칠월 백중에
아까 머 일수도 이수도 그럴떼 수도라능 거슨 머에요	아까 뭐 일 수도 이 수도그럴 때 수도라는 것은 뭐예요
인자 요리 인자 점부 요리 인자 주를 자바서 요리 허먼 인자 여나무시 요리 인자쭉 그러먼 여그를 인자 배가 드러가고러 널찍허이 요래 나또요	이제 이리 이제 전부 이리 이제 줄을 잡아서 이리 하면 이제 여남은이 이리 이제 쭉 그러면 여기를 이제 배가 들어가게 널찍하게 이리 놔 둬요
그 도동놈더리 저그 저저그 저 개적헌디 태인도 저런디 도동넘드리	그 도둑놈들이저기 저 저기 저 가까운 데 태인도 저런 데 도둑놈들이
저녀그로 와서 싹 뜨더가가부리요	저녁으로 와서 싹 뜯어서 가 버려요
뜨더 강깨 인자 요 우리 동네에서 인자 또 상격꾸니라고 저녀그로 지키는 사라믈하나 도요	뜯어가니까 이제 이 우리 동네에서 이제 또 상격꾼이라고 저녁으로 지키는 사람을 하나 둬요
배르 타고 나가서	배를 타고 나가서
근자 그사암드리 인자 가서 그사암들 자바가꼬 오먼 인자 디예 인자 재피 노먼 디예시끄럽쪼 인자	그 이제 그 사람들이 이제 가서 그 사람들 잡아가지고 오면 이제 뒤에 이제 잡혀 놓으면 뒤에 시끄럽지요 이제
인자 벌그블 무러라 어째라 또 모	이제 벌금을 물어라 어째라 또 뭐
근데 아까	그런데 아까
도늘 무러내라	돈을 물어내라
일수도 이수도 그레션는디	일 수도 이 수도 그래셨는데
그렁깨 인제 요리 피노먼 인자 요 배타고 들꺼 아니요 여그에 인자 일수도고	그러니까 이제 이리 펴 놓으면 이제 이 배 타고 들어갈 것 아니예요 여기에 이제 일 수도고
또 요만치 인자 배타고 드러갈 때 마니 냉가노코	또 이만큼 이제 배 타고 들어갈 때 많이 남겨 놓고
또 구여기 이꾸나	아 또 구역이 있구나
또 그다으메또 요리 젝쩌금 구여게 요래먼 또 이수도	또 그 다음에 또 이리 각각 구역에 이리 하면또 이 수도
구여기 일수도 이수도자기 구여기구나	아 구역이 일 수도이 수도자기 구역이구나 음
그래가꼬 기믈 해 무거써요	그래가지고 김을 해 먹었어요
그레써요	음 그랬어요
요쪽 강까에서 등이 이쓰믄 인자 요거이 등거트문 저쪽 강까에야꺼장	이쪽 강가에서 등이 있으면 이제 이것이 등 같으면 저쪽 강가에까지
쭉허니 인잔 도니 자꼬 쫌 헐싸라미 엄는 사라믄 드문드문 해이꼬	쭉 이제 돈이 자꾸 좀 할 사람이 없는 사람은 드문드문 해 있고
인제 일꾼 망코 인자 해무글 싸라미 마는 사람드른 그냥 서펄 마니 해아꼬 함빡 그냥 총총 꼬꼬	이제 일꾼 많고 이제 해 먹을 사람이 많은사람들은 그냥 섶을 많이 해가지고 흠뻑 그냥 촘촘하게 꽂고
그러문 파래가 이나무야서 저나무야 걸고 저나무야서 저나우로 또 불철선 느러농거맹키라요	그러면 파래가 이 나무에서 저 나무에 걸고 저 나무에서 저 나무로 또 전깃줄 늘어 놓은 것처럼 만들어요
그러믄 요리 한주먹 훔치가꼬 바구리에 다머 뻥뻥해요	그러면 이리 한 주먹 움켜가지고 바구니에 담아 가득해요
거 배가 잘금잘금잘금 허드럭까지 인자 막 한지비 두리 가는 사람 하나 가는 사람막 서이 오는 디는 배쪼분디 서이 와따고 또 야다니고 그래노믄 인제	그 배가 잠길락말락 하도록까지 이제 막 한 집에 둘이 가는 사람 하나 가는 사람 막 셋이 오는 데는 배 좁은데 셋이 왔다고 또 야단이고 그래 놓으면 이제
내려갈 때는 무리 다 드러서 내려가찌마내도 올러올 때는 무리 꼬랑에 물 쪽 빠져뿌닝까 물 든는대로 따라 올랑 올랄랑깨 지미 차서 몬 놀랑깨 저그 태인도다가 사람 싹푸러 내비리요	내려갈 때는 물이 다 들어서 내려갔지마는 올라올 때는 물이 도랑에 물쪽 빠져 버리니까 물 드는 대로 따라 올라 올라가려니까 김이 차서 못 올라가니까 저기 태인도에다가 사람 싹 풀어 내 버려요
아하  인자	이제
김만 가저오게끔	김만 가져오게끔
인제 지 내 전는 사람만 이꼬 나무치는 전는 사람만 맨 냉가노코 싹 가라그러믄거서 거러올라와요	이제 저 노 젓는 사람만 있고 나머지는  젓는 사람만 남겨 놓고 싹 가라 그러면 거기서 걸어 올라와요
매 아페오는 사람 다르믈 치고 몬 따라오문 디예 처지고	맨 앞에 오는 사람 달음질을 치고 못 따라 오면 뒤에 처지고
그 그녀 기믈 언제부터 헤떼요 이게 광양에	그 그녀 김을 언제부터했데요
저네 우리 아버지들부터서 다 핸능갑때요	전에 우리 아버지들부터서 다 했나 보데요
그레요이	아 그래요
그러먼 저그 오중에 나루 끄테리라고 근는디 거그그야간 거그도 무리 드는 디가 이써요	그러면 저기 오징어 나루 끝이라고 그랬는데 거기 그  거기도 물이 드는 데가 있어요
글 안흐문 저리 오꼬글 도라와야 뎅깨로 시방 거 그 개마근디 그리 건내오 그리 오문	그렇지 않으면 저리 옥곡을 돌아와야 되니까 시방 그 그 개 막은 곳 그리 건너 그리오면
그니까 무란대 파레 물 안대고잔 사라믄 인자 젝쩜 치늠치르미 어버 건내요 하나이나 그거 어름무레다 바를 당구고 나오먼 인자  모도 어버서 건내고	그러니까 물안 대 팔에 물 안 대고 싶은 사람은 이제 각각 친한 사람들끼리 업어 건너요 하나나 그것얼음물에다 발을 담그고 나오면 이제  모두 업어서 건너고
그레써요	그랬어요
그 김 갑쓴 어떼씀니까 그떼 엔나레는 조아찌 안나요 김깝쓴	그 김값은 어땠습니까 그때 옛날에는 좋았지 않나요 김값은
하모예 그래가 인자 여으 조하베서 해태 조하베서 인자 조합지권드리 인자 또 빼뜨로 댕기요 조하베 안년는다고 조하베 여문 또 즈그가 수수로르 뗑깨로	아무렴요그래가지고 이제 여기 조합에서 해태 조합에서 이제 조합직원들이 이제 또 빼앗으러 와요 조합에 안 넣는다고 조합에 넣으면 또 저희가 수수료를 떼니까
그거 안떼일라고	그것 안 떼이려고
하동장으로 인자 멀리 이고 가요	하동장으로 이제 멀리 이고 가요
멀리 이고 가다 빼끼먼 인자 또	멀리 이고가다 빼앗기면 이제 또
으무저그로 조하베다 네야뒈 메상을 헤야 데능거요	의무적으로 조합에다 내야돼 매상을 해야 되는 것이에요
거년디에 멀리 포라 무을랴다 들리믄	그랬는데 멀리 팔아 먹으려다 들키면
들리믄 빼끼믄 인자 또 구마니라요	들키면 빼앗  기면 이제 또 그만이에요
아하  그거또 으무저기니 저기가	아하  그것도 의무적이니 저기가
그러 우리 망내 저걸 저저 사평이란데 지널 거그에 또 조하비 이썬는디 저 태인도싸라미 거그서 인자 조하브 지궈느로 인자 거 인는디	그러 우리 막내 저걸 저 저 사평이란데 진월 거기게 또 조합이 있었는데 저 태인도 사람이 거기서 이제 조합의 직원으로 이제 그 있는데
서기란 사라미 어떠께 도케 그사라믄 지 장모거또 빼뜨린다요 그사람	서기란 사람이 어떻게 독해 그 사람은 제 장모 것도 빼았는대요 그 사람
너무 누니 에러붕깨	남의 눈이 어려우니까
그래서 그등에는 기미 놀헌디 우리거는 새캄해요	그래서 그 등에는 김이 노란데우리 것은 새캄해요
그래 빼끼삐리고 하동 장에 우리 망내르 업꼬 가가꼬 빼끼삐리고	그래 뺏아겨 버리고 하동 장에 우리 막내를 업고 가가지고 빼앗겨 버리고
그때 세통을 가간냐 야달깨썩 거이 세통을 인잗 포깍 누질라가꼬 그래가 집 싸가꼬 인자 두데기로 인자 우리 애기 인자 포대기지 인자 시방은 저네 두대기를 모라가꼬그래가꼬 이고 간는디	그때 세 통을 가지고 갔나 여덟 개씩 거의 세 통을 이제 아주 꽉 눌러가지고 그래가지고 짚 싸가지고 이제 기저귀로두데기는 기저귀의 뜻 이제 우리 아기 이제 포대기지 이제 시방은 전에 기저귀를 말아가지고 그래가지고 이고 갔는데
갈 때는 몸 만내노건디 우리 칭구 주구 언니가 그걸 핸는디 그또 그 항께 헵짜꾸니라	갈 때는 못 만날 건데 우리 친구 저희 언니가 그걸 했는데 그 또 그 함께 협잡꾼이야
인자 그사라믈 사가꼬 인자 좀 자바도라 그렁걸 나는 짬도 모르고 그 언니를 보고언니 나와 인제 생이라고 그래찌 저네는 생이 나 요걸 애기를 업꼬 가꼬 완는디 좀 포라조그러드만 더르렁 가꼬와서 데꼬와서 가꼬가	이제 그 사람을 사가지고 이제 좀 잡아 달라 그런 걸 나는 짬도 모르고 그 언니를 보고 언니 나와 이제 형이라고 그랬지 전에는 형이 나 이걸 아기를 업고 가지고 왔는데 좀 팔아 줘 그랬더니마는 더르렁 가지고 와서데리고 와서 가져 가
아우  그래가 이 인자	그래가지고 이 이제
아논 사라민데도 그레요	아아는 사람인데고 그래요
하모 동네 언니지	아무렴 동네 언니지
그래 인자 씨예 그 빼끼삐리고 그냥 와가꼬 인제 씨예는 인자 김 뜨더옹거 다 몰류고 인자 조구메 인자 차즈로 강깨	그래 이제 씨에 그 빼앗겨 버리고 그냥 와가지고이제 씨에는 이제 김 뜯어온 것 다 말리고 이제 조금에 이제 찾으러 가니까
인자 그사람드리 빼뜨러 감서 인자 또 전페르랑 해 조요 암디 지궈닝깨 그리 차즈로오라고	이제 그 사람들이 빼앗아 가면서 이제 또 전표랑 해 줘요 아무 데 직원이니까 그리 찾으러 오라고
차즈로 가먼 인자 싸디 싸게 그냥 안 빼뜨라무꼬	찾으러 가면 이제 싸디 싸게 그냥 안 빼앗아 먹고
싸디 싸게 해서 조요	싸디 싸게 해서줘요
그래 강 애기도 업꼬 인자 조고메 인자 하리 가닝깨 영가미 하나 그걷 김 그거다발 무끄는 사라미데요	그래 그냥 아기도 업고 이제 조금에 이제 하루 가니까 영감이 하나 그것 김 그것 다발 묶는 사람이데요
가 어찌 와쏘 그러듬만 나 아리께 하동장날 저 기믈 여그 서기등가 그 당신한테 빼끼쏘 그래서 그거 차지러 완네요 그란디	가어찌 왔소 그러더구먼 나 며칠 전에 하동 장날 저 김을 여기 서기인지 그 사람한테 빼앗겼소 그래서 그것 찾으러 왔네요 그런데
우리 애기가 세사리나 무거씨꺼요 그러다봉깨 애기가 점심 때가 지농깨 막 배아 고파 찡우리를 해쌍깨 인자 또 인자 딴 사람들허고 머 만날 싸라미 이써가 그사라믄 술무그로 가뿌리고 엄꼬 그 영가미 뭉끄다가	우리 아기가 세 살이나 먹었을거요 그러다 보니까 아기가 점심 때가 넘어 놓으니까 막 배가 고파 칭얼대니까 이제 또 이제 딴 사람들하고뭐 만날 사람이 있어가지고 그 사람은 술 먹으러 가 버리고 없고 그 영감이 묶다가
나가 나도 모리게 가가따 허꺼잉깨 언능 요거 쎄이가꼬 요 동네르 드러가마저이 지 저저 동네 입꾸에 거 거그 주막찌비 거 술 무그로 가씽깨	내가 나도 모르게 가져갔다 할 거니까 얼른 이것 몰래 가지고 이 동네를 들어가면저기 저 저 저 동네 입구에거 거기 주막집 거기 술 먹으러 갔으니까
동네르 가지마고 저리 해서 방 개까에 방천미트로 해서 쭉 가라 그러데요 그 노이니 얼릉가꼬 가씨요 쪼꼼이씨먼 오꺼요 고래	동네를 가지 말고 저리 해서 갯가에 저수지 맡으로 해서 쭉 가라 그러데요 그 노인이얼른 가지고 가시오 조금 있으면 올 거요 그래
그먼 하라씨는 어쩌꺼요 난중에 이거 조따고 하라씨 어쩌꺼요 긍깨 나도 모리게가가따 그러꺼잉께 다 걱정 말고 가꼬 가라 글데 그래서 차자가꼬 와써	그러면 할아버지는 어쩔 거요 나중에 이것 줬다고 할아버지 어쩔 거요 그러니까 나도 모르게 가져 갔다 그럴 것이니까 다 걱정 말고 가지고 가라 그러데 그래서 찾아 가지고 왔어
차자가꼬 와서 인자 노 조하베다 여써요	찾아가지고 와서 이제 노 조합에다 넣었어요
저 별말 업떵가요	저 별말 없던가요
하모요	아무렴요
그거또 포라 무글라믄 그리 어시고 저녕내 사능거이 사능거이 아니라요	그것도 팔아 먹으려면 그리 궁하고 저녁내 사는 것이 사는 것이 아니예요
음    쉬웅게 하나도 엄네요	쉬운 것이 하나도 없네요
그런디 그 떼무네 하여튼 파뤄른 추서근 그냥 데충 보네시고 벡쭝은 좀 걸게 하고이	음 그런데 그 때문에 하여튼 팔월은 추석은 그냥 대충 보내시고 백중은 좀걸게 하고
그다으메 구월 구월 이렁거 머 머 이씀니까	그 다음에 구월 구월 이런 것 뭐뭐 있습니까
구월 기일	구월 기일
기일  구월 기이리 머에요	구월기일이 뭐예요
저네는 이 부모들 주그먼 삼년상 안추리능가요이	전에는 이 부모들 죽으면 삼년상 치르잖아요
건디 인자 상자드리	그런데 이제 상주들이
상주드리 구월 기일나른 인자 바블 해가꼬 메 메야 인자 차자가요	상주들이 구월 기일날은이제 밥을 해가지고 묘 묘에 찾아가요
그 제총을 지노코 마당까에다 제총을 지노코	그 제총을 지어 놓고 마당가에다 제총을 지어 놓고
거그서 또 고그 허고	거기서 또 곡하고
오  상주드리	상주들이
아아 구워른 그러는 다리구뇨	아아 구월은 그러는 달이군요
상주드리 점부 와서 인자 인자 추석 그런때는 젝쩌금 밥 채려논니라고 아노는 사라미 마나요	상주들이 전부 와서 이제 이제 추석 그런 때는 각자 밥 차려 놓느라고 안오는 사람이 많아요
아드리라도	아들이라도
아논 사라미 마는데기일나른 인자 아무 거세기 엄씅께 점부 다 와요	안 오는 사람이 많은데 기일날은 이제아무 뭐가 없으니까 전부 다 와요
긍깨 바로 제사 지내는 날	그러니까 바로제사 지내는 날
제사 모시는 나링깨로 인제 점보 고걸허고 큰지비서 인자 세상 베린 지비서음시글 해가꼬 새보게	제사 모시는 날이니까 이제 전부 그걸 하고 큰 집에서 이제 세상떠난 집에서 음식을 해가지고 새벽에
새보게 인자 제사 모시고 또 인능걷 엄능걷 채레가꼬 또 산소에로 가요	새벽에 이제 제사 모시고 또 있는 것 없는 것 차려가지고또 산소에로 가요
산소에 가서 인자 또 절 허고 그래 와서 또 지비 머 와서 밤무꼬 인자 갈리고	산소에 가서 이제 또 절하고 그래 와서 또 집에 뭐 와서 밥 먹고 이제 헤어지고
그 다으메 시워르뇨	그 다음에 시월은요
시워른 먼 나리니	시월은 무슨 날인가
시워른 네 뭐 시워른 상다리라고 허는	시월은 네 뭐 시월은 상달이라고 하는
그러는 그렁게 이씀니까	그러는 그런 게 있습니까
그거는 인자 보 상딸 보름딸	그거는 이제 보 상달 보름달
시월 보름딸	시월 보름달
그거 인자 그거느닌자 머 별로 채리는 거또 업꼬	그거 이제 그것은 이제 뭐 별로 차리는 것도 없고
그러코	그렇고
그러면 인자 서딸	그러면 이제 섣달
저 인제 동지떨	저 이제 동짓달
응 동지딸 동지	응 동짓달 동지
동지 때는 동지죽 써무꼬	동지 때는 동지죽 쒀 먹고
동지죽 써무꼬	동지죽 쒀 먹고
죽만 쑴니까 아니믄 동지주글 또 가꼬 뭐 다른	죽만 쑵니까 아니면 동지죽을 또 가지고 뭐 다른
인제 동지죽 쒀가꼬 천지다 뿌리지요	이제 동지죽 쒀가지고 사방에다 뿌리지요
천지다가	아 사방에다가
시 시간 마차서	시 시간 맞춰서
그레요	아 그래요
동지 시가 안 인능가요	동지 시가 있잖아요
거먼 인제 수두르 떠나따가	그러면 이제 수두를 떠 놨다가
인자 입 안대고 인자 그르게 떠나따가 인자 모도 무꼬 저녀꺼트머 저녁 그시예 인자 천지다 막 뿌리지요	이제 입 안 대고이제 그릇에 떠 놨다가 이제 모두 먹고 저녁 같으면 저녁 그 시에 이제 사방에다 막 뿌리지요
인자 나쁜 귀신 인자 다 업쎄라 업써지라고이	음 이제 나쁜 귀신 이제다 없애라 없어지라고
그다으메 인자 서따레는	그 다음에 이제 섣달에는
서따레는 인자 내나 그뭄날 채리논능	섣달에는 이제 내나 그믐날 차려 놓은 것
그뭄날 체려 논능 거시조이	그믐날 차려 놓는 것이지요
그래서 일련 가조	그래서 일 년 가지요
그러네요	그러네요
동지에도 싹 채리나요 방에	동지에도 싹 차려 놓아요 방에
동지죽쒀가꼬 싹 채리나	동지죽 쒀가지고 싹 차려 놔
동지죽또 체려놈니까	동지죽도 차려 놓습니까
방에다 체려 노코또 바께 뿌리고이	음 방에다 차려 놓고 또 밖에 뿌리고
과거에는 달마다 헹사가 이썬네요이	과거에는 달마다 행사가 있었네요
내일 내일 머 호남 찌방에 비온다덤마는 여그도 올랑가 어쩔랑가	내일 내일 뭐 호남 지방에 비 온다더니마는 여기도 오려는지 어쩌려는지
비온데요	비 온대요
근디 여그도 올랑가 모르건네	그런데 여기도 오려는지 모르겠네
머 일하실꺼 이쓰세요	음 뭐 일하실 것 있으세요
오게되문 저 치눌바틀 거더야지 비로 마처야지	오게 되면 저 비닐밭을 거둬야지 비를 맞혀야지
비마칠라먼 그비니루 비니루 거드시게	비 맞히려면 그비닐 비닐 거드시게
시가니 그러며는 일하셔야야되건 네요 그럼 이정도로 하까요	음 시간이 그러면은 일하셔야 되겠네요 그럼 이 정도로 할까요
더 허껃 이씨먼 허시요 안종피	더 할 것 있으면 하시오 어차피
아니 더 허꺼 시가니 시가니 한 시가니 더 허꺼시야 이찌요 인는데	아니 더할 것 시간이 시간이 한 시간이 더 할 것이야 있지요 있는데
해 해서 쫌 얼릉	해 해서 좀 얼른
예 안  냉게 부먼 쓰거	넘겨 버리면 쓰겠
쪼끔	조금
더 하조 그러면	더 하지요 그러면
자 이러케 헹사드리 이쓸 떼 남자드른 주로 어떤 이를 하고 노란능가 헨는데아까 메구치기도 하고 남자드리요이	자 이렇게 행사들이 있을 때 남자들은 주로 어떤  일을 하고 놀았는지 했는데 아까 풍물 치기도 하고 남자들이요
남자 남자 여자드른 메구 메구 안칭가요	남자 남자 여자들은 풍물 풍물 안 치나요
왜 여자들도 허고 남자들도 허고	왜 여자들도 하고 남자들도 하고
남자드른 주로 머 함니까 놀 놀 논다 헐 떼는	어 남자들은 주로 뭐 합니까 놀 놀 논다 할때는
인자 여자드른 안닐 허고 남자드른 바깐닐 허지요	이제 여자들은 안일하고 남자들은 바깥일 하지요
머 달집 찐는디 달집또 찌꼬	뭐 달집 짓는데 달집도 짓고
남자드른지꼬 여자드른 끄어다 주고	남자들은 짓고 여자들은 끌어다 주고
저 남자들또 지그믄 저네는 그걸 해 소를 솔까지 그렁걸 솔가 솔깽이 솔깽이라그래요 저저 이파리 달링 걸	저 남자들도 지금은 전에는 그걸 해 솔을 솔가지 그런 걸솔가 솔깽이 솔깽이라 그래요 저 저 잎 달린 걸
예예  솔깽이 그거를 인자 남자드리 해가꼬 뭉꺼주먼 인자 제비짐매이로 지어가 젝쩨금 인자 다발다바리 여다 나르고	솔가지 그것을 이제 남자들이 해가지고 묶어 주면 이제 제비집처럼 지어가지고 각자 이제 다발다발 여다 나르고
대도 뭉꺼주먼 끄어다 나리고그랜는디	대도 묶어 주면 끌어다 나르고 그랬는데
지그믄 그냥 남자드리 그냥 차로	지금은 그냥 남자들이 그냥 차로
인자 베미피머 인자 여자드리 가서 인자 요리 개리주고	이제 베 면 이제 여자들이 가서이제 이리 가려 주고
개리주문 남자드리 뭉꼬가 차에다 올려가 차로 막	가려주면 남자들이 묶어가지고 차에다 올려가지고 차로 막
재하니지비 차로 가꼬 용달차르 가꼬 와서 한차 실꼬 와 그냥 헝깨 시버요	재환이 집 차를 가지고 용달차를 가지고 와서 한 차 싣고 와 그냥 하니까 쉬워요
저네는 저무나 새나구 그래	전에는 저무나 새나구 그래
막 줄다리기나 이렁거또 헤써요 과거에 동네에하고 어뜨기 동네하고 막 저기	막 줄다리기나 이런 것도 했어요 과거에 동네하고 어떻게 동네하고 막 저기
그렁거는 저네는 인자 그렁거를 인자 핸능가씹띠다마내도 저네는 시방은 저 하꾜서 그 줄다리기 하리썩	그런 것은 전에는 이제 그런 것을 이제 했는가 싶습디다만 전에는 시방은 저 학교서 그 줄다리기 하루씩
아아  안허능가요	하잖나요
하꾜서	예 학교서
그렁께 인자 안해요	그러니까 이제 안 해요
응  젝쩜 동네별로 노능거이재	각자 동네별로 노는 것이지
여자드른 머 그네를 띤다등가 너를 띤다등가 그렁거뜨른 마니 헤짜나요	여자들은 뭐 그네를 뛴다든지 널을 뛴다든지 그런 것들은 많이 했잖아요
저네는 마니 널 마니 띠찌요	전에는 많이 널 많이 뛰었지요
너른 주로 언제 띠연나요	널은 주로 언제 뛰었나요
설래 띠지 머	설에 뛰지 뭐
설래	설에
인자	이제
소님들 오머 초하리 초이틀 초사헐	손님들 오면 초하루 초이틀 초사흘
인자 딸레드른 인자 사 사허리 너머야 인저 젝쩌금 찌비 소님 다 접때허고 나먼친정에 옹깨	이제 딸네들은 이제 사 사흘이 넘어야 이제 각자 집 손님 다 접대하고 나면친정에 오니까
친장오먼 인자 막 또 초다쌔꺼장 가고 그러먼 인자	친정 오면 이제 막 또 초닷새까지 가고 그러면 이제
널 나아노코 널 띠고	널 놔 놓고 널 뛰고
으흠  노푼 나무미테 인자 이씨먼 또 군데도 띨 쑤구도 이꼬	높은 나무 밑에 이제 있으면 또 그네도 뛸 수도 있고
군데띠구요이	예 그네뛰고요
애기드른 쬐끼 차고	아이들은 제기 차고
쬐끼 차고	제기 차고
그다으메 그 요것	그 다음에그 이것
빼 팽이 치고	빼 팽이 치고
펭이 치고이	팽이 치고
자 그다으메요	자 그 다음에요
또 연 띠우고	또 연 띄우고
여는 여는 주로 나 에드리 띠고 남자드리 띠고 그러조이	아 연은 연은 주로 나 아이들이 띄우고 남자들이 띄우고 그러지요
인자 어런데리 인자 애기들 데꼬 띠우제	이제 어른들이 이제 아이들 데리고 띄우지
그러게찌요	그러겠지요
시방 어디 연띠운디가 어디 인능가요	시방 어디 연 띄운 데가 어디 있나요
나 저그 해네 우리집 연맨드라주까 시퍼서 저 스무대를 주다 난는디 아무도 머거또보도 안 허고	나 저기 행여나 우리집 연 만들어 줄까 싶어서 저 해장죽을 주워다 놨는데 아무도 뭐 거들떠보지도 않고
그리고 시바근 머이마드리 귀헝깨 게지배드링깨로머 연 맨드라도라 쏘리도 안허고	그리고 시방은 사내아이들이 귀하니까 계집애들이니까 뭐 연 만들어 달라 소리도 안하고
여그도 연짜새요 우리 애기거	여기도 얼레요 우리아이 것
으음  저 방아도 항개 이꼬 여그도 이꼬	저 방에도 한 개 있고 여기도 있고
돔만주고 사다노코	돈만 주고 사다 놓고
그건 데게 아부 아빠허고 가치헤야 할텐디	그건 대개 아버 아빠하고 같이 해야 할 텐데
그래 해나 저거 이써서 오라 맨드리꺼이냐 헝깨로 허도 안허고 마네	예그래서 행여나 저것이 있어서 오라 만들까 하니까 하지도 않고 마네
자  그거 머 그정도로 하시구요이	그것 뭐 그 정도로 하시고요
어린에기 막 인제 테어나서 한살 두살 요런 에기들 지난버네 제가 한번 여쭤봐씀니다만 막 기어다니다가 기어다닌 노미 인제 막 슬라고 막 허자나요	어린 아기 막이제 태어나서 한 살 두 살 이런 아기들 지난 번에 제가 한 번 여쭤 봤습니다만 막 기어다니다가 기어다닌 녀석이 이제 막 서려고 막 하잖아요
네 그러믄 인자 어떠케놀림니까	네 그러면 이제 어떻게 놀립니까
아히고 우리 애기 서따서따서따	아이고 우리 아기 섰다섰다섰다
섬마섬마섬마 그러머 서문 인자 아이고 서따서따	섬마섬마섬마 그러면 서면 이제 아이고 섰다섰다
섬마섬마는 막 슬라고	아 섬섬섬마는 막 서려고
서라고	예 서라고
서 서라	서 서라
서라고 애기 서라고 인자섬마섬마섬마섬마 그러먼 막 장애 싸서 막 이꼬 여리 제가 억찌로 요리 포도시 서머 아히고 서따서따서따 솜빠닥 뚜드리고	서라고 아기 서라고 이제 섬마섬마섬마섬마 그러면막 장하다고 해 쌓아서 막 웃고 이리 제가 억지로 이리 겨우포도시는 겨우의 뜻 섬마 아이고 섰다섰다섰다 손바닥 두드리고
그러지요  이	아  그러지요 음
저 에기드른 인제 놀리는 노리가 여러 거 여러가지가 이짜나요이 고게를 자꾸돌린다등가	저 아기들은 이제 놀리는 놀이가 여러 그 여러 가지고 있잖아요 고개를 자꾸돌린다든지
도래도래도래 하고 짝짱구 짝짱	도래도래도래 하고 짝짱구 짝짱
에 솜빠닥 뚜드링건 작 작짱	예 손바닥 두드리는 것은 작 작짱
짝짱	짝짱
에  또지얌지얌	또 쥐염쥐엄
또 머 이써씀니까	또 뭐 있었습니까
또 여보고 머라니라	또 이것보고 뭐라니라
고  곤지곤지	곤지곤지
에 곤지곤지 또 에기드리 이러케 여 여기 이써짜나요 이러게 여푸로 자칭거여푸로 자칭가 요 아푸로	예 곤지곤지 또 아기들이 이렇게 이 여기 있었잖아요 이렇게옆으로 젖히는 것 옆으로 젖히는것 이 앞으로
불미야 불미야	풀무야 풀무야
불미야	어 풀무야
굉상도는 대불미 절라도는 소불미	경상도는 대풀무 전라도는 소풀무
아하하 그러게 헤써요	아하하 그렇게 했어요
요 달깡달깡 허고	이 달깡달깡 하고
그레요이	예 그래요
쩌고는 좀 깐난 에기드리고 인제 쫌 큰 에기드른 아까 말한 제치기를 한다등가	저것은 좀 갓난아이들이고 이제 좀 큰 아이들은 아까 말한 자치기를 한다든지
재치기 허고 딱찌치기 허고	자치기하고 딱지 치기 하고
또아까머  막 발로 차능	또아까 뭐  막 발로 차는
쩨끼차기 허고	제기차기 하고
그 연 연띠우기 가틍거 하구요이	예 그 연 연 띄우기 같은 것 하고요
그 정월 보르멘 막 요론데다가 논뚜렁 가튼데다 불질르고 막 불 돌리고 그런놈 놀이	그 정월 보름엔 막 이런 데다가 논두렁 같은 데에다 불 지르고 막 불 돌리고 그런놈 놀이
그 보름날	그 보름날
보름날 애기들	보름날 아이들
그 머라고헤 그런 노리를 머라고험니까 그러먼	그 뭐라고 해 그런 놀이를 뭐라고 합니까 그러면
그걸 보고 저네는 시방 불꼰노리가 따로 이째마는 걸보고 불꼰노리라 그래찌저네	그걸 보고 전에는 시방 불꽃놀이가 따로 있지마는 그걸 보고 불꽃놀이라 그랬지전에
불꼰노리라 그레써요	아 불꽃놀이라 그랬어요
깡통에다가 부를 여가꼬	깡통에다가 불을 넣어가지고
잉그라글 여가꼬 돌리가꼬	잉걸불을 넣어 가지고 돌려가지고
부리 막 잉글잉글 허머 가따 살째기 논뜨락 그런디 푸레다 요리 대문 막 부리 활허니 부터가	불이 막 이글이글하면 가져다 살짝살짜기는 살짝의 뜻 논두렁 그런 데 풀에다 이리 대면 막 불이 훨훨 붙어가지고
아아 그러코이	아아 그렇고
그다으메 그다이메	그 다음에 그 다음에
아까 쪼끔 하든 하시든 이야기 가운데 요기서는 인제	아까 조금 하던 하시던이야기 가운데 여기서는 이제
진상 여기가 쪼끔 특수해서요이 바다일도 하시고	진상 여기가 조금 특수해서요 바닷일도 하시고
농사도 지꼬	농사도 짓고
산닐도 허고	산일도 하고
산닐도 하고 그러자나요이	산일도 하고 그러잖아요
산 중가네 이써요	산 중간에 있어요
우선 인자 바다이를 아까 또 김	어 우리 이제 바닷일을 아까 또 김
헝거 이야기는 하셔꼬 그거 말고도 바다까에서 헤서 하셔떠닐이 머여써요	하는 것 이야기는 하셨고 그것 말고도 바닷가에서 해서 하셨던 일이 뭐였어요
조개 잡찌요	조개 잡지요
조개  조개  어떤 조게드를 주로	어떤 조개들을 주로
배캅또 잡꼬 우럭또 잡꼬	백합도 잡고 우럭도 잡고
또 요새 꿀땡이도 주어가꼬 오고	또 요새 굴도 주워가지고 오고
꿀뗑이	꿀땡이
구리라는	굴이라는
굴  그 껍찌차	그 껍질채
거 인자 호미로 쪼사 탕탕 뚜디리먼 인자 알등검만 초레이 늘쩌요	그 이제 호미로 쪼아 탕탕 두드리면 이제 알 든 것만 조르르 떨어져요
어어  그럼 그놈 주다마가꼬	그럼 그놈 주워 담아가지고
으음 그야말로 자연사니네요	으음 그야말로 자연산이네요
또 마또 빼고	또 맛도 빼고
마짜븜서 인자 글그머 호미로 글그머 인자 조개거틍거 나오먼 그렁거 다 줍또 앙코	맛 잡으면서 이제 긁으면 호미로 긁으면 이제 조개 같은 것 나오면 그런 것 다 줍지도 않고
그 호미로 다 함니까	그 호미로 다 합니까
호미로 허고 남자드리랑 가먼 인자 마짬능거는 인자 널찍허니 인자 막 거더요	예 호미로 하고 남자들이랑 가면 이제 맛 잡는 것은 이제 널찍하게 이제 막 걷어요
물 모뜨러가게 호부작허이 요래 해노코	물 못 들어가게 호부작하게 이리 해놓고
인자 도라감서 인자 물 모뜨로겐허문 구녀기 빠끔빠끔 똑 올개미 꾸녕매이  로 글 이쓰문 인자	이제 돌아가면서 이제 물 못 들어오게 하면 구멍이 빠끔빠끔 꼭 올가미 구멍처럼 그렇게 있으면 이제
마때 요만헝거이 인는디 미테 이느리 요리 달리써요	맛대 이만한 것이 있는데 밑에 미늘이 이렇게 달렸어요
그 요래 푹 쑤씨 디끄 여가꼬 요래 허먼 인자 그 이느레 걸려가꼬 몬내레가고따라올러와요	그 이렇게 푹 쑤셔  넣어가지고 이리 하면 이제 그 미늘에 걸려가지고못 내려가고 따라 올라와요
이느리 머에요 이느리	음 미늘이 뭐예요 미늘이
인제 그거 만 몬내려가고 인자 요래 끄어 올리능거	이제 그것 맛 못 내려가고이제 이렇게 끌어 올리는것
오  그거 인자 요리 세모로 요리 세모로 되아가 이써요 가운데 여그 마때가 꼬피고 요리 세모로 되아가 그거야 딱 걸려가꼬 올러와요	그것이제 이리 세모로 이리 세모로 되어가지고 있어요 가운데 어기 맛대가 꽂히고 이리 세모로되어가지고 그것에 딱 걸려가지고 올라와요
그러케헤서 마슬 잠네요이	그렇게 해서 맛을 잡네요
근데 여 저그 뻘뜽이 이러케 데스추로 담능거게쪼이	그런데 이 저기 개펄 등이 이렇게  담는 것이겠지요
뻐레서이	개펄에서
음  그리고 또 인제 조게 잡꼬 또 딴 다릉건 머이씀니까 조게 말고 게 가틍거도 잡꼬	그리고 또 이제 조개 잡고 또 딴 다른 것은 뭐 있습니까 조개 말고 게 같은 것도 잡고
게도 잡꼬 갱주개	게도 잡고 갱주개
겡주겡	갱주개
그 겡	그 갱
그 쩌쩌 쩌그 저 요새 섬진강에 거 제첩	그 저저 거기 저 요새 섬진강에 그 제첩
그렁거이 요요 믿 강 요 강에도 쌔써요	그런 것이 이이 밑 강 이 강에도쌨어요
그걸 여기서는 이르믈 머라 갱주게라고	아 그걸 여기서는 이름을 뭐라 갱주개라고
갱주개라 그래요	갱주개라 그래요
겡주게라고	아 갱주개라고
예  요 요요 강 매리 드리서 쌔써요	이 이 이 강  쌨어요
제처븐 그니까 그거슨 조게 종뉴지요	제첩은 그러니까 그것은 조개 종류지요
게는 아니고이	음 게는 아니고
겡주게이 에	갱주개 예
게는 어떤 게드리 인나요 여그서 잠능 거슨	게는 어떤 게들이 있나요 여기서 잡는 것은
밤둥이 밤딩이	밤둥이 밤딩이
밤딩이 또	밤딩이 또
털보까이	털보까이
털버까리 터리 막 다리에 막 보실보실허니	털보까리 털이 막 다리에 막 보슬보슬하게
털게 털보까리	털게 털보까리
그러치요 머	예 그렇지요
거또 여러가지라요 무당게도 이꼬	그것도 여러가지예요 무당게도 있고
포짱게라고 또 바르르이 가능거이 또	포짱게라고 또 바르르 가는 것이 또
포짱게요	포짱게요
어어허 바리 삘그렁거이 그냥 사람 인정끼만 이씨먼 바르르이 달라요	발이 빨그스름한 것이 그냥 사람 인적기만 있으면 바르르 달아나요
어허  그거이 또 포짱게라고 이꼬	그것이 또 포짱게라고 있고
여러 가지라요	여러 가지예요
째깐헌 요렁건 또 밀짱게	조그마한 것이 이런 건 또 밀짱게
밀짱게	밀짱게
그러네요	어 그러네요
그거는 인자 저네 인자 칼 정지야 칼 저저 째깐한 저걸가 째까마이 요러먼 나오고 째깜 요롬 나오고	그것은 이제 전에 이제 칼 부엌칼 저 저 조그마한 저걸 가지고 조그맣게 이러면 나오고 조금 이러면 나오고
거임 자바다가 인자 저네는 사 도랑사구라고 그 사구 쪼깐헝거 이꺼드뇨 그러니까 싹싹 까끄먼 등거리가 흐개요	그것은 잡아다가 이제 전에는 사 도랑사구라고 그 사구 조그마한 것이 있거든요 그러니까 싹싹 깎으면 등이 하얘요
오호  거 인자 파싹 보까가꼬 상추쌈도 싸무꼬	그 이제 바싹 볶아가지고 상추쌈도 싸서 먹고
오호  여르미먼	여름이면
그래요	그래요
굴긍게는 그거이 영 이베 여코 베어무끼가 좀 사나분디	굵은 게는 그것이 영입에 넣고 베어 먹기가 좀 사나운데
그어는 째깐헝깨 와시락와시락허니 마시써요	예 그것은 조그마하니까 와스락와스락 맛있어요
밀짱게요	음 밀짱게요
음     여기는 바닫 바다에만 나가면 머 머글께 마 마니 인네요	여기는 바다 바다에만 나가면뭐 먹을 것이 마 많이 있네요
또 사네도 가문 이꼬	예 또 산에도 가면 있고
사네도 가먼 너물종뉴 머	산에도 가면 나물 종류 뭐
꼬사리너물 머 지부	고사리나물 뭐 지부
쌔써요	쌨어요
그거머 사네인능건 쫌 이따 이야기하구요	그거 뭐 산에 있는 것은 좀 이따 이야기하고요
그 다으메 인제 에 예서 고기도 나가서 베타고가서 잡끼도 헨나요	그 다음에이제여기서 고기도 나가서 배 타고 가서 잡기도 했나요
인제 남자드리	이제 남자들이
인자 남자드리요이	이제 남자들이요
그럼 여기서 주로 어떤 고기가 물리등가요	그럼 여기서 주로 어떤 고기가 물리던가요
남자드리 인자 낙씨거뜽거 지금도 모도 가서 낙씨 해가꼬 오데요	남자들이 이제 낚시 같은 것도 지금도 모두 가서 낚시 해가지고 오데요
강에 그런디 가서	강에 그런 데 가서
그 여그는 지 저녀그로 저네 우리들 각씨 때 총각뜨리 가먼 인자 동네 총각뜨리 메치 어울라가꼬 해뿍써잡꼬	그 여기는 저녁으로 전에 우리들 처녀 때 총각들이 가면이제 동네 총각들이 몇이 어울러가지고 횃불 켜서 잡고
으흠  쩌 인자 우리들 거서걸 때 인자 지르미 세구 지르미 이싱깨	저 이제 우리들 뭐할 때 이제 기름이 석유 기름이 있으니까
음  세구지르메다 깡통에다가 기다문 작때기 가가꼬 저그 철사 거틍걸 소믈 가마가꼬	석유기름에다 깡통에다가 기다란 작대기 가져가가지고 저기 철사 같은 걸 솜을 감아가지고
가 지름깡통 요리 들고 가아꼬 인적 부리 올쭈 부트먼 인자 요골요골 적쎄가꼬또 요리허고 그러먼 인자 한저는 인자 문저리	가서 기름 깡통 이리 들고 가가지고 이제불이 대충 붙으면 이제 이걸 이걸 적셔가지고 또 이리하고 그러면 이제 한때는 이제 망둥이문저리는 망둥이의 방언형
문저리	아 망둥이
모래문저리	모래망둥이
모래바테가 놀해가꼬 업찌따네요 무레가 말그먼 무레가	모래밭에 노랗게 엎드려 있다네요 물에 맑으면 물에
그러무 칼로가꼬 깡 누질라가꼬 주담꼬 칼로가꼬 깡 누질라가서 인자 미끄라웅개 칼로가꼬 땅 누질라가꼬 주담꼬 탁 요래 누지르먼 또 가마니꼬 그래가꼬아 저녀그로총각뜨리 그래 가꼬오먼 영 우리 씨아재들	그러면 칼을 가지고 꽉 눌러가지고 주워 담고칼을 가지고 꽉 눌러가지고 이제 미끄러우니까 칼을 가지고 딱 눌러가지고 주워 담고 탁이리 누르면 또 가만 있고 저녁으로 충각들이 그렇게 가지고 오면 영 우리 시동생들
음  그래가오문 자바오문 막 헤를 해아꼬 마니 무거써요	그래가지고 잡아오면 막 회를  해가지고 많이 먹었어요
예 문저리	음 망둥이
무시 채로 써리 여코	무채를 썰어 넣고
으흠 그거 마니 자피조 지금도 마니 자피능거 가떼요 문저리는	으흠 그것많이 잡히지요 지금도 많이 잡히는 것 같아요 망둥이는
지그믄 가자서 인자 바무로 안나가고 인자 한닙 주무 그냥 사다 무꼬그렁깨 그러지 지금도 나감 이따네	지금은 좋은 것만 골라 먹어서 이제 밤으로 안 나가고 이제 한 잎 주면 그냥 사다 먹고 그러니까그러지 지금도 나가면 있다네요
흔헌 고기니까요	음 흔한 고기니까요 예
자 바다에서 삼소로 그다으메 사네서 사네서는 인제 여그 그 사 사느로 머 나물노물 캐러도 마니 가 다니셔써요	자 바다에서 살면서 그 다음에 산에서 산에서는 이제여기 그 사 산으로 뭐 나물 나물 캐러도 많이 가 다니셨어요
오호  꼬사리 끄느로 가고 인자 요즈믄 인 점부 꼬사리 뿌리를 캐 파다가	고사리 꺾으러 가고 이제 요즘은 전부 고사리 뿌리를 캐 파다가
꾕이르 가 파다가 젝쩜 바테다재배를 해가꼬 해도	괭이를 가지고 파다가 각자 밭에다 재배를 해가지고 해도
으흠  그저네는 요 치드리 막 점부 댕김서롱	그 전에는 이 사람들이 막 전부 다니면서
꼬사리 마니 끄느	음 고사리 많이 꺽어
꼬사르 끄느로	고사리 꺾으러
또 꼬사리 말고 다릉거는 머이 약	또 고사리 말고 다른 것은 뭐가 약
인자 꼬사리 끄느로 가머 인자 딱쭈주도 이씨먼 캐여코 또 돌가지도 이쓰먼캐여코	이제 고사리 꺾으러 가면 이제 잔대도 있으면 캐서 넣고 또도라지도 있으면 캐서 넣고
인자 그리 여러가지른 너물도 이씨먼 뜨더가꼬 여코	이제 그리 여러 가지 나물도 있으면 뜯어가지고 넣고
그러믄 걸지요 지비가서 푸러 노으먼	그러면 걸지요 집에 가서 풀어 놓으면
또 머 버섣까틍거또 따고 그러셔써요	또 뭐 버섯 같은 것도 따고 그러셨어요
저네는 싸리버서비 솔밤미테 이써따요만해도 그건 지그믄 잘 업써요	전에는 싸리버섯이 솔밭 밑에 있었대요마는 그건 지금은 잘 없어요
버서비	음 버섯이
싸리버세비라고그냥 똑 요 송꾸라끄터리매이로 요렁거이 요렁거이 막 몽태이가 이써요	싸리버섯이라고그냥 꼭 이 손가락 끝처럼 이런 것이 이런 것이 막 뭉텅이가 있어요
그랜는디 지그믄 그렁거이 업써요 그거또 칠파레 따가 오두마뇨	그랬는데 지금은 그런 것이 없어요 그것도 칠팔월 따가지고 오더구먼요
그러먼 인제 그런 너물가틍거슨 하고 아까 말헤뜽건 그 사니 사니 깁꼬 그러면약초가틍거또 마느니까 딱쭈도 약초 아님니까이	그러면 이제 그런 나물 같은 것은 하고 아까 말했던 것은 그 산이 산이 깊고 그러면 약초 같은 것도 많으니까 잔대도 약초 아닙니까
약떼능거	약 되는 것
그렁거또 여기서는 마니 한사람도이꼬 그러나요	그런 것도 여기서는 많이 하는 사람도 있고 그러나요
저네 할메하나에 암꺼또 엄씨 사는 할메하나이 펭상 그렁검만 캐로 댕기요	전에 할멈 하나가 아무 것도 없이 사는 할멈 하나가 평생평상은 평생의 방언형 그런 것만 캐러 다녀요
약초만	아 약초만
가 캐다가 저 하동장아 가서 폴고	가서 캐다가 저 하동장에 가서 팔고
음  거머 아드리 껄렁패 아드리 이써가꼬 돈다 빼뜨라 가고  그러다 그냥 벵에 걸리 주거써요	그 뭐 아들이 껄렁패 아들이 있어가지고 돈 다 빼앗아 가고  그러다그냥 병에 걸려 죽었어요
지그믄 그 아주 지겁쩌그로	음 지금은 그 아주 직업적으로
재화니 엄마도	재환이 엄마도
재하니 엄마도 꼬사리 팔짜로 끄너요	재환이 엄마도 고사리 마치 팔자인 듯이 잘 꺾어요
그레요이	아 그래요
봄대먼	봄 되면
끄너다가 딸레들또 주고	꺾어다가 딸네들도 주고
또 폴기도 허고 그래	또 팔기도 하고 그래
그니까 테레비가틍거 보면 강원도나 경상도 가튼데 보면 머 송이	그러니까 텔레비전 같은 것 보면 강원도나 경상도 같은 데 보면 뭐 송이
송이버섭	송이버섯
송이송이버섣 자연산 고놈 모 요러케 따로 뎅기기도 하고 약초 또 케로 다닌 사람도 이꼬	송이송이버섯 자연산 그것 뭐 이렇게 따러 다니기도 하고 약초 또 캐러 다니는 사람도 있고
저 송이 버서슨 나 안따 반는디	저 송이버섯은 나 안 따 봤는데
그럼 머 인니웨 먼 버서비냐 그 약때능거 그 먼 버서비라드니 요새 발그러잉거	그럼 뭐있을까 왜 무슨 버섯이냐 그 약 되는 것 그 무슨 버섯이라더냐 발간 것
게따 양 양 양지 양지버섣 양지버서시라 그레요	아 거 또 양 양 아지버섯양지버섯이라 그래요
말고요 밤나무 우에 주로 마니 뵈요	말고요 밤나무 위에 주로 많이 보여요
음  거는 나 좀 따바써요	그것은 나 좀 따 봤어요
예 아이고  그 먼 버서비란디 이저분네	그 무슨 버섯이라는데 잊어 버렸네
시방재배를 해도 저네는 사네서 그걸 마니 따가꼬 완는디	시방 재배를 해도 전에는 산에서그걸 많이 따가지고 왔는데
요 요요위에서도 그런 약초 전문저그로 케로 다닌 사람드리 어쩌다가 한명씩이께 이써뜬네요	음 이 이 이 위에서도 그런 약초 전문적으로 캐러 다니는 사람들이 어쩌다가 한 명씩 이렇게 있었네요
항가꼬뿌렝이 딱쪼뿌렝이	엉겅퀴 뿌리 잔대 뿌리
돌가지 삽초뿌렝이	도라지 삽초 뿌리
그런 뿌렝인지 알고 잘 마니 캐써요 그 할메는	그런뿌리인지 알고 잘 많이 캤어요 그 할멈은
예  우리드른 우리들 지빈니리 바쁘고 그거 캐로 대이니 채로 저 제처레 불러가능거이 나찌요	우리들은 우리들 집안일이 바쁘고 그것 캐러 다니느니 저 광양제철에 불려가는 것이 낫지요
그러지요	그러지요
그런 할메드른 제철 이를 모릉깨 인자 만날 밥 싸가꼬 사느로 뻐칭게그로	그런 할멈들은 광양제철 일을 모르니까 이제 만날 밥 싸가지고 산으로 뻗치니까
또 어떤 혹시 여기 상 가까오니까 머 사네다가 더슬 나가꼬	또 어떤 혹시 여기산 가까우니까 뭐 산에다가 덫을 놔 가지고
연지버섣 연지버섣	아 영지버섯 영지버섯
연지버섣	영지벗섯
영지 영	아 영지 영
영지버섣	예 영지버섯
양지가아니라 영지버섣	예 양지가 아니라 영지버섯
영지버섣네	영지버섯 네
사냥가틍거 어께 허로 다닌 사람도 읻 읻썬나요	사냥 같은 것  하러 다니는사람도 있었나요
아히고 만치요	아이고 많지요
오오    요새는 인자 그 허가를 내주먼 헝깨로 모 그자해도 그저네는 그냥 여 치드리 막우이우이이 허고 댕기요	요새는 이제 그 허가를 내 주면 하니까 뭐 그런다 해도 그전에는그냥 여 사람들이 막 우이우이우이 허고 다녀요
사람드리	음 사람들이
짐승 몰 모른다고	아 짐승 몬다고
개하고 또 그 총 가꼬	예 개하고 또 그 총 가지고
주로 여기에 머 어떵게 만틍가요	주로 여기에 뭐 어떻게 많던가요
고라니 머 토끼 그렁거 자부로 대니조 꽁 비들키 머 얭긴대로 잡찌요 그런 사람드른	고라니 뭐 토끼 그런 것 잡으러 다니지요 꿩 비둘기 뭐 잡히는앵기다는 잡히다의 뜻 대로 잡지요 그런 사람들은
사니라 그렁게 마나요 짐승이	음  산이라 그런 게 많아요짐승이
에  거비나서 하다 글찌에는 막 사람드리 그리 마니 댕기문 그리막 우이 쏘리가 나먼 그냥 나무 허다가도 막 미테가 돌팍 미테 수머가꼬 이꼬	겁이 나서 하다 그때에는 막사람들이 그리 많이 다니면 그리 막 우이 소리가 나면 그냥 나무하다가도 밑에 돌 밑에 숨어가지고 있고
사니 만하니까 이건 유기오떼가 거 상당히 저기헤야께써요이	산이 많으니까 이건육이오때가 그 상당히 저기했겠어요
긍깨 유기오 때는 처으메는 사느로 올라간는데 난중에는 산네서 발랑구니 이써가무장 저르 바다그로 나가	그러니까 육이오 때는 처음에는 산으로 올라갔는데 나중에는 산에서 반란군이 있어가지고 점점 무장은 점점의 뜻 저기로 바다로바닥은 바다의 방언형 나가
아리께 이약 안해뜽가요	며칠 전에 이야기 했었잖아요
예  무서버예	무서워요
자 그다으메	자 그 다음에
오느른 이정도로 하시조 잔까니요	오늘은 이 정도로 하시지요 잠깐이요
지남버네 노그미 안뎅 거 위예	지난 번에 녹음이 안 된 것 위에
아하그거 그거 다시 말쓰메 주시고	그것 그것 다시 말씀해 주시고
그다메 옫 온 만들기 또 머 체소 제위 나물체취 미빤찬 머 그렁 거시네요 어	그 다음에 옷 옷 만들기 또 뭐 채소 제위 나물 채취 밑반찬 뭐 그런 것이네요 어
난 바차느 잘 허도 모더는디	난 반찬은 잘 하지도 못하는데
그럼 성경이가 한 번 나중에 온만들기부터는 성경이가 무러 여쭤바	음그럼 성경이가 한번 나중에 옷 만들기부터 성경이가 물어 여쭤 봐
네 누에질문	녜 누에 질문
누에요	누에요
여기 사십육쪼게 일쩜 사쩜 이예 그 누에치기와 비단짜기가 이써	여기 쪽에 에 그 누에치기와 비단짜기가 있어
야  어어 엔나레 누에도 키어 보셔딱 헤쪼 길러 보셔딱 헤쪼이	어어옛날에 누에도 키워 보셨다고 했지요 길러 보셨다고 했지요
시집 와서 그레따 헤뜽가요 시집 오기 저네 그레뜽가요	시집와서 그랬다 했던가요 시집 오기 전에 그랬던가요
저네도 허고 여 시집 와서도 허고 그래써요	전에도 하고 여 시집와서도 하고 그랬어요
그레요	그래요
고거슨 메년 하셔써요	어 그것은 몇 년하셨어요
멩주시를 마니 썬는 모양이네요이	어 명주실을 많이 썼는 모양이네요
인자 시집 와서 씨어머니가 인자 쫌 키우고 나가 키웅깨	이제 시집와서 시어머니가 이제 좀 키우고 내가 키우니까
키우능 거슬 앙깨 씨어머니도 허고 나도 허고 그래가꼬 또 좀 허다가 인자	키우는 것을 아니까 시어머니도 하고 나도 하고 그래가지고 또 좀 하다가 이제
각씨 때 허고 인자 그 뒤에느 안 해써요	새각시 때 하고 이제 그 뒤에는 안 했어요
에 그러먼 그 누에가 거 여기선 누에라고 안 하지요	예 그러면 그 누에가 그여기서는 누에라고 안 하지요
이르미 니	이름이 니
니라 그래요	나라 그래요
니라고이	니라고
응  니라고 헌 니가 거 크기게 자긍 거또 이꼬 킁 거또 이꼬 그러자나요 벌레가이	니라고 한 누에가 그 크기에 작은 것도 있고 큰 것도 있고 그러잖아요 벌레가
인자 처멘 알씨릉거부터	이제 처음에는 알 스는 것부터
알씨릉거 여그 손빠당마넌 니 종이에다가 아를 씨릉거를 가따가 멘사무소에 가서 가꼬 와요	알 슨 것 여기 손바닥만한 이 종이에다가 알을 슨 것을 가져다가 면사무소에 가서 가져와요
씨를 바다오구마	씨를 받아오는구먼
인자 네 인자 이장이 가따가 주등가	이제이장이 가져다 주든지
저네느 구장 아니요	전에는 구장이잖소
으음  이장이 구장이라	이장이 구장이야
구장이여써요	아 구장이었어요
저네느 이장이 아이고 지금 이장이지 저네느 구장이라 그랜는디	전에는 이장이아니고 지금 이장이지 전에는 구장이라 그랬는데
그러조일구 이구가 그러니까	그러지요일구 이구가 그러니까
구장인디 인자 그 요론 종이에다가 거 알 씨릉거	구장인데 이제 그 이런 종이에다가 그 알 슨 것
그걸 인자 멘사무소서 가따 줘요	그걸 이제 면사무소에서 가져다줘요
가질로 오라고 인자 구장찌비서 인자 저네느 그래찌 그럼 가서 가저오믄 요그다	가지러 오라고 이제 이장집에서 이제 전에는 그랬지
시방 거트머 오봉 이 어저 오봉이제마느 저네느 함지	시방 같으면 쟁반 이 이제 쟁반이지마는 전에는 함지
쪼까넌 함지에다 다마가꼬 인자 여 인자스 이울 미테 요른디다 따따더이여 노머 거서 벌레가 꼬물꼬물꼬무꼬물 나와요	조그마한 함지에다 담아가지고 이제 이이제 이불 밑에 이런 데에다 따뜻하게땃땃허니는 따뜻하게의뜻 넣어 놓으면 거기에서 벌레가 고물고물고물고물 나와요
며둴따레나 그거를 멘처메 가저오능 거시 그떼가 며둴딸 정도 데야 데요	몇월에나 그것을 맨 처음에 가져오는 것이 그때가 몇 월 정도 되어야 돼요
인자 뽕 닙 트먼 트고 인자 쪼꿈 크문 이양 한 사뭐리나 되거찌이	이제 뽕잎트면 트고 이제 조금 크면 이제 한 삼월이나 되겠지
사뭘 음녀그로 사먹 인나되거찌	삼월 음력으로 삼월이나 되겠지
그믄 사월 정도	그러면 사월 정도
사월 정도 되지	사월 정도 되지
허무 인자 그거를 인잗 아페 나온 노문 인자 또 또 끄르슬 하나 노코 인자 또	아무렴 이제 그것을 이제 앞에 나온 놈은 이제 또 또 그릇을 하나 놓고 이제 또
거따가 인자 머 거석 그걸 가꼬 마니 해 저얻 닥 날개 거 킁 거 킁 거 거 빼다가	거기에다가 이제 뭐 거시기 그걸 가지고 많이 해 저 닭 날개 그 큰 것 그 빼어다가
그걸 가꼬 요리요리	그걸 가지고 이리 이리
옴겨요	옮겨요
씰문잘 씨러저요 솔맹키로	쓸면 잘 쓸어져요 솔처럼
인자 그 소른 거 인자 셍깨로 인자 벌레감 안뎅깨	이제 그 솔은 그 이제 세니까 이제 벌레가 안 대니까
그러문 인자 나으 머 꽁털 거틍거 인자 닥털 거틍거 이자 거 싣 디예 굴근	그러면 이제  뭐 꿩털 같은 것 이제 닭털 같은 것 이제 그 싣 뒤에 굵은
꼬랑뎅이 그노물 가꼬 인자 요리 상구 징꼬랑데이 말고 저 짜링거 그노물 가꼬 요리요리요대 씰먼	꼬리 그놈을 가지고 이제 이리 사뭇 긴 꼬리 말고저 짧은 것 그놈을 가지고 이리 이리 이리 쓸면
씨러서 인자 따로 노코 인자 그거이 나온 거는 인자 또 뽕을 따다가 인자 자자러이 써리 다지가꼬 여 주고 또 염방 나오먼 인자 또 그노물 또 씨러 여코 또 그래가꼬올랴줘 한잠 자고	쓸어서 이제 따로 놓고 이제 그것이 나온 것은 이제 또 뽕을 따다가 이제 자잘하게 쓸어 다져가지고 넣어 주고 또 계속 나오면 이제 또 그놈을 또 쓸어 넣고 또그래가지고 올려 줘 한 잠 자고
또 메치를 뭉는 그 무그무 한잠 자능가 나 그 일주이링가	또 며칠을 먹는 그  먹으면 한 잠 자는지 나 그 일주일인지
오일 정도	오 일 정도
오이링가	오 일인가
일쭈일	일 주일
으이  그 정도되문 인자 그때느 처리 업써농깨 어런드리 허능거잉깨 인자 짜믈 몰라쩨메치 메칠 이쓰머 오이링가 하여틍 치리링가 되문 인자 한잠 자따 그러고	그 정도 되면이제 그때는 철이 없어 놓으니까 어른들이 하는 것이니까 이제 사정을 몰랐지 며칠 며칠 있으면 오 일인지 하여튼 칠 일인지 되면 이제 한 잠잤다 그리하고
네 또 그 그러무냐 그거 잠잘 쩌게느 쪼깐 뽕을 덜 무꺼드뇨	예 또 그 그러면이제 그것 잠 잘 적에는 조금 뽕을 덜 먹거든요
그럼 인자 잠잔다고 인자 쪼깜 찌깐썽만 허처주고 인자	그러면 이제 잠 잔다고이제 조금 조금씩만 흩뿌려 주고 이제
쫌 느께 온 노문 또 느께 나옹거는 인자 또 그걸 무꼬 그러게 인자 찌깐썩 허처주고	좀 늦게 온 놈은 또 늦게 나온 것은 이제 또 그걸 먹고 그렇게 이제 조금씩 흩뿌려주고
인자 고개를 요리 틀고 이써 가마니 요래 가꼬 이써요	이제 고개를 이리 틀고 있어 가만히 이래가지고 있어요
자 잘  자늘 니 잘 쩌게느 그래가 이쓰문 인자 또 게댕기는 그그 그거는 인자 또 무꼬르 인자 어쩌다가 쪼깐썩 허처 주고 그러문	잠을 누에 잘 적에는 그래가지고있으면 이제 또 기어다니는 그 그 그것은 이제 또 먹고는 이제 어쩌다가 조금씩 흩뿌려 주고 그러면
인자 메치를 자능고 어쩐능가 한잠 자따 그러고 인자	이제 며칠을 자는지 어쩌는지 한 잠 잤다 그리하고 이제
어른드리 인자 또 새로 뽕을 써리 여 주고 나문 인자 석짱꺼지 자고 나문 니가인자 막 이망썩 국찌요	어른들이 이제 또 새로 뽕을 썰어 넣어 주고 나면 이제 석 잠까지 자고 나면 누에가 이제 막 이만큼씩 굵지요
그러무 인야 막 뽕 가지를 처다가 인자 상구 그슥 굴근 가지만 뜬내고 그냥 바로 체파네다가 인자 언저 주머 그냥 거그야 우예 기댕김성 무꼬	그러면 이제 막 뽕 가지를 쳐다가 이제 사뭇 거시기 굵은 가지만 뜯어 내고 그냥 바로 섶에다가 이제 얹어 주면 그냥 거기에 위에 기어다니면서 먹고
그러다가 인자 요리 니가 놀해지먼 발도 놀해지고	그러다가 이제 이리 누에가노래지면 발도 노래지고
머리도 놀 놀미야해지고 그러먼 인자  요래 보먼 놀해요 요리 꺼꾸리 들고 바리 우로 가고리 요러먼 놀해요 그러문	머리도 놀 놀면해지고 그러면 이제 기침 이리 보면 노래요 이리 거꾸로 들고 발이 위로 가게이러면 노래요 그러면
그걸 인자 새끼에다가 지플 요정도 써리가꼬 넫 새끼를 요리요리 인잗 비제게가꼬 그 소게다 한 주멍 여가꼬 쩨깐썩 요리 돌리서 잡꼬 새끼다리 요리 나오먼 인자	그걸 이제 새끼에다가 짚을 이 정도 썰어가지고  새끼를 이리 이리 이제 구부려가지고 그 속에다 한 주먹 넣어가지고 조금씩 이리 돌려서 잡고 새끼들이 이리 나오면 이제
쑤세미메이로 쑤세메이르 요리 인자 넹가감서 보문 벌짐메이로 요런 거띠가거따가	수세미처럼 수세미처럼 이리 이제 넘겨가면서 보면 벌집처럼 이런 거기에다 거기에다
또 인자 체빤지르 인자 그 그걸 보고 머이라 핸는디 이르믈 이저분네 인자 오래데농깨	또 이제 섶을 이제 그 그걸 보고 뭐라 했는데 이름을 잊어버렸네 이제 오래 되어 놓으니까
쑤세미 거틍 그거이	수세미 같은 그것이
그거 인자 물 두발썽 요리 디게로 해 가꼬 요리 노코 요리 노코 인자 두 두줄썽 요리 나가 노무 인자 한테가 요리 엥기가 웡 안 헝가요	그것 이제 뭘 두 발씩 이리되게끔 해가지고 이리 놓고 이리 놓고 이제 두 두 줄씩 이리 나가 놓으면 이제 한데 이리옮겨가지고 번성하잖아요
그무 거따가 올리요	그러면 거기에다가 올려요
거따가 인자 떤지 두문두문허이 요리 인자 니를 떤지놈 거서 인자 지블 지여	거기에다가 이제 던져 드문드문하게 이리 이제 누에를 던져 놓으면 거기서 이제 집을 지어
지블 지무 인자 또 일주일 정동가 어찌 이쓰믄 인자 저네는자 어런더리 헝깨로인잗 따라만 항깨 모르지	집을 지으면 이제 또 일 주일 정도인지 어찌 있으면 이제 전에는 이제 어른들이 하니까 이제 따라만 하니까 모르지
일주일 정도나 인능가 그러머 저 꼬치를 하나 여 따 가꼬 요리 흔들문 딸랑딸랑딸랑을 소게서	일 주일 정도나 있는가 그러면 저 고치를 하나 이 따가지고 이리 흔들면딸랑딸랑딸랑 속에서
네    거무주를 요리요리 처 가꼬 제가 드러감성 자꼬 인자 처 드러가문 인자 난중에느 안 보이	거미줄을 이리 이리 쳐가지고 제가 들어가면서 자꾸 이제 쳐 들어가면 이제나중에는 안 보여
네  지으가  처메느 싹 보이 제가 막 거 주를 처서 요리 도라가능거를	처음에는 싹 보여제가 막 그 줄을 쳐서 이리 돌아가는 것을
허므 인자 그거이 안 보이고 그러머 인자 한 일쭈일 정도 그리 이씨문 인자	하면 이제 그것이 안 보이고 그러면 이제 한 일 주일 정도 그리 있으면 이제
이건능가 본다고 인자 요리 따 가꼬 요리 흔들머 소게서 인자 그거이 몰라저가꼬방이 따싱깨	익었는지 본다고 이제 이리 따가지고 이리 흔들면 속에서 이제 그것이 말라져가지고 방이 따뜻하니까
네  몰라저가꼬 딸랑딸랑허문 인자 전분 체빤지르 인자 마당으로 인자 막 꺼내 가꼬따싱깨	말라져가지고 딸랑딸랑 하면 이제 전부 섶을 이제 마당으로 이제 막 꺼내가지고 따뜻하니까
네  꺼내가꼬 인자 막 어런더리 막 점부 따요	꺼내가지고 이제 막 어른들이 막 전부 따요
그거 체빤지하꺼이 금 막 집 올 그거이 오지믈 싸가꼬 또 인잗 구징 거는 또 구징 거 이꼬	그것 섶 한 것 그러면 막 집 그것이 오줌을 싸가지고 또 이제 궂은 것은 또궂은 것 있고
우예서 또 그거이 오지믈 쌍 거이 내로 와가꼬 미테	위에서 또 그것이 오줌을싼 것이 내려와가지고 밑에
웃음  구증 거 이근 인능 건 이꼬 그러먼 인자 구징건따로 개리고	궂은 것 익은 있는 것은 익고 그러면 이제 궂은 것은 따로 가리고
인자 조응 거는 조응 거때로 그래가꼬 인자 조응 거느 인자 멘사무소에 가따달리고	이제 좋은 것은 좋은 것대로 그래가지고 이제 좋은 것은 이제 면사무소에 가져다무게를 달게 하고
구징 거는 인자 또 요만헌 쥐아오가리라고 요론 또 오가리에다가 인자 미테다 부를 때 가꼬 쌀무먼	궂은 것은 이제 또 이만한 기와 오지독이라고 이런 또 독에다오가리는 오지독의 뜻 이제 밑에다 불을 때가지고삶으면
쌈꼬 인자 요리 주리 나오문 인자 요요 미테서느 자꼬 지부믈가꼬 요로고 주를인자 여 하나는 강꼬	삶고 이제 이리 줄이 나오면 이제 이 이 밑에서는 자꾸 젓가락을 가지고 이렇게 줄을 이제 넣어 하나는 감고
물레로 물레멩이로 해가꼬 자새에다 가무머 거 인자 가마 가꼬 그걸 가꼬 또 배  로 나라 가꼬 논 멩지배를 논느디	물레로 물레처럼 해가지고 자새에다 감으면 그 이제 감아가지고 그걸 가지고 또 베를 날아가지고 놓은 명주베를 낳았는데
그러무 인제 여페 애기드른 꼰대기	그러면 이제 옆에 아이들은 번데기  예에  꼰대기 그거 어더 무글라고 그냥 아드리 뺑 돌려 안자꼬웃음 번데기 그것 얻어먹으려고 그냥 아이들이 삥 둘러앉아 있고
거또 막 와삭와삭허이 마시꼬 그랜는디 지그믄 나 그거이 안 무꾸자바	그것도 막 와삭와삭하게 맛있고 그랬는데 지금은 나 그것이 안 먹고 싶어
저네는 온써글 따라댕임서도 울 엄니야 그걸 참 잘헝깨로 따라댕임성 만날 어더무꼬 또 나가 망내라 데농깨 어매르 그리 딸코	전에는 온 구석을 따라다니면서도우리 어머니가 그걸 참 잘하니까 따라다니면서 만날 얻어먹고 또 내가 막내가 되어 놓으니까 엄마를 그렇게 따르고
그람 마니 어더 무꼬 그래써요	그러면 많이 얻어먹고 그랬어요
음음  거 니 올리능 건 표준말로 그냥 서피라고 그런데 섭 서베 올린다고 체빵가틍게 서빙가	그 누에 올리는 것은 표준말로 그냥 섶이라 그런데 섶 섶에 올린다고 체판 같은 것이 섶인가
체파니라 그래써요	체판이라 그랬어요
에에  우리드르	우리들은
서베 올린다고	섶에 올린다고
서페 올린다고 그러니까	섶에 올린다고 그러니까
체판지에다가 인자	체판에다가 이제
그 쑤세미를 쑤세미 그걸 보고머이라 핸는디 그거느 이저부린네요	그 수세미를 수세미 그걸 보고 뭐라 했는데 그것은 잊어 버렸네요
그러머 인젣 그걷 두 발썩 데능 걷 인자 긍깨 인잗 요리 영꺼가 인자 가운데로요리 끄터리 요리 뭉꼬 뿌루문 인자 동그라머이 요리 데지요	그러면 이제 그것 두 발씩되는 것 이제 그러니까 이제 이리 엮어가지고 이제 가운데로 이리 끝 이리 묶어 버리면 이제 동그랗게 동그람허다는 동그랗다의 뜻 이리 되지요
요리 인제 두 줄로 나 가꼬 거따가 인지 이런 데 두문두문허이 떤지 놈 이긍걸 개리가꼬 떤지 노문 지분	이리 이제 두 줄로 나가지고 거기에다 이제 이런 데 드문드문하게 던져 놓으면 익은 걸 가려가지고 던져 놓으면 집은
그며는 한잠 자고 두잠 자고 세잠 자고 이러케 잠 자면 크기가 달라지자나요	그러면은 한 잠 자고 두 잠 자고 세 잠 자고 이렇게 잠 자면 크기가 달라지잖아요
점점 크니까	점점 크니까
하 쪼깐 커지고 쪼칸 커지고	아무렴 조금 커지고 조금 커지고
예에  그러면 이러케 잠 자기 전 이까 그 크기에 따라서 이러케 이르미 따로 혹씨 이썬나요	그러면 이렇게 잠 자기 전 그러니까 그 크기에 따라서 이렇게 이름이 따로 혹시있었나요
그냥 한잠 장 거 두잠 장 거 인자	그냥 한 잠 잔 것 두 잠 잔 것 이제
하 그리 마를 허재	그렇게 말을 하지
예에  인자 어런더른 보문 딱 아라요 두잠 자껀네 그르고 석짬 자껀네 그러고	이제어른들은 보면 딱 알아요 두 잠 자겠네 그러고 석 잠 자겠네 그러고
크기 보고 아라쓰까요 아니면	크기 보고 알았을까요 아니면
그렁 걸보고	예 그런 걸 보고
여페 저미 이러케 이짜나요 점 보고 아라쓰까요	옆에 점이 이렇게 있잖아요 점 보고 알았을까요
몰라 점도 하 이써	몰라 점도 아무렴 있어
잉까	그러니까
근넌디몰라 어런더리 인자 헝깨로 몰라찌 우리더르	그랬는데 몰라 어른들이 이제 하니까 몰랐지 우리들은
그러믄 세깔드른	그러면 색깔들은
거 정그능 거 가꼬능 안 거서 와	그 것 가지고는 안 거시기 와
세깔도 좀 노루스름헤지고	색깔도 좀 노르스름해지고
아이 처메는 껑꼬	아이 처음에는 검고
인자 클쑤록 인자흑해저 니가 인자 사리 타무 흑해지고	이제 클수록 이제 하얘져 누에가 이제 살이 타면 하얘지고
네  인자 난제는 놀해지고	이제 나중에는 노래지고
크기 세깔 등등은 보게쩨	크기 색깔 등등을 보겠지
네 우리더른 그냥	어 우리들은 그냥
네  밤낟 뽕 따다 나리지 긍깨 뽕	밤낮 뽕 따다 나르지 그러니까 뽕
뽕 따시기 힘드셔쪼 뽕 따러 가	뽕 따시기 힘드셨지요 뽕 따러 가
긍깬	그러니까
네  만날 뽕만	만날 뽕만
찌요	지요
니도 그냥 우리 여그 친정 어무니는 그냥 요그 하나인드아 한장이라거등요 한장	누에도 그냥 우리 여기 친정어머니는 그냥 여기 하나인데 한 장이라거든요 한 장
그문 인자 넉장썩 허문 이 통방으로 뺑 도라감성 다뿍 한방이라요 막 칭게를해가꼬	그러면 이제 넉 장씩 하면 이 통방으로 삥 돌아가면서 다뿍 한 방이에요 막 층계를 해가지고
그 다뿍 한방썩 그렁깨 아글 한정도 엄씨 마나	그 다뿍 한 방씩그러니까  한정없이 많아
마니 먹찌요 근데 이거	많이 먹지요 근데 이것
만치 긍깨 점두룩 나는 뽕만 따란다고 나가 울고 막	많지 그러니까저물도록 나는 뽕만 따라고 한다고 내가 울고 막 웃음
그면 자기 바테 뽕 그 자기 바테 뽕나무가 이꼬 뽕 키워야지 받 업쓰면	그러면 자기 밭에 뽕 그 자기 밭에 뽕나무가 있고 뽕 키워야지 밭 없으면
지금 요 요 바까에 매실나무 요렁 거슬 스 심떼끼	지금 이 이 바깥에 매화나무이런 것을 심듯이
건떼느	그런 때에는
그를 쩨느 그냥	그럴 제는그냥
응  받뜨러가가 점부 뽕이고 또 정구 안해문 인자 마니 헐랑깨 인자 또 받 가운데도 숭구고 땅 마는 사라문 긍깨 마니 숭거써요 막	밭두렁이 전부 뽕이고 또 전부 안하면 이제 많이 하려니까 이제 또 밭 가운데도 심고 땅 많은 사람은 그러니까 많이 심었어요 막
산도 이씨무 상삐들게 그런 디도 막 숭거 노꼬 뽕나무가 굴근데 올라가서 그냥따고 그렁깨	산도 있으면 산기숡에 그런 데도 막 심어 놓고 뽕나무가 굵은 데 올라가서 그냥 따고 그러니까
네  지금 긍깨 그 매실 따고 요 감 따고 요런디 날거 나구재기 잘헌다고 핑상 날보고 오래서 또 감 따로 가고느	지금 그러니까 그 매실 따고 이 감 따고 이런 데 나를그 나무에 올라 따는 일을 잘한다고 항상 나보고 오라고 해서 또 감 따러 가고는
근디 자기 뽕 부조갈 경우도 이쓰 꺼 아니예요	그런데 자기 뽕 부족할 경우도 있을 것 아니어요
근 저기 산중에	그러면 저기 산중에
인자 돌뽕	이제 산뽕
돌뽕이랑 게 또 이써요	산뽕이란 것이 있어요
저그 저그 어치꼬랑에 저그 배운산 미테 저저 저 바구로봉 미테	저기 저 저기어치 골짜기에 저기 백운산 밑에 저저 저 바구니봉 밑에
무슨 봉이요  무슨 봉이오  바구리봉	
바구리봉	바구니봉
바구리봉 아봉오리	바구니봉봉우리
바구리봉 미테 그런 디 그 인자 올라가서 막 숩 지튼디 그런디 가머 꼬랑까로 머그냥 그런디 가묻	바구니봉 밑에 그런 데 그 이제 올라가서 막 숲 짙은 데 그런 데 가면도랑 가로 뭐 그냥 그런 데 가면
채리보고 뽕을 뽕 따로 인자 니 함밥 재치노무 뽕이 모지란다고 그냥 보따리큰 보따리르 가꼬 막 또 시꾸대로 가고 남자들도 가 가꼬 인자 비내 주문 따고 인자 이녁뽕나무는	쳐다보고 뽕을 뽕 따로 이제 누에 한 밥 잦혀 놓으면 뽕이 모자란다고모지라다는 모자라다의 방언형 그냥 보따리 큰 보따리를 가지고 막또 온 식구가 가고 남자들도 가가지고 이제 베어 내 주면 따고 이제 이녁 뽕나무는
예  인자 아까바서 마니 몬 비지	이제 아까워서 많이 못 베지
그래서 인자 그런 디는 가무 그양 똥구녀글 바로 그냥	그래서 이제 그런 데는가면 그냥 똥구멍을 바로 그냥
비삐문 나자빠지문 인자 막 여자드른 따고	베어 버리면 나가자빠지면 이제 막 여자들은 따고
인자 동네 메 찌비 여자들허고 남자 하나허고 어울라가꼬 가서 인자 남자드른베 남자가 베 주먼 인자 여자드른 점부 따오그랑 한 뽀따리썽 해가꼬 오고	이제 동네몇 집이 여자들하고 남자 하나하고 어울려가지고 가서 이제 남자들은 베어 남자가 베어 주면 이제 여자들은 전부 따 오거나 한 보따리씩 해가지고 오고
또 뽕 마지메 온다고 지비 이뜬 사람드른 키워 주고 지비 인자 니 키우던 사람드른 또 어어 무겁따고 또 마지메 온다고 또 오고 글쩬 차가 엄씽깨 거러 댕깅깨	또 뽕 마중 온다고 집에 있던 사람들은 키워 주고 집에 이제 누에 키우던 사람들은 또 어어 무겁다고 또 마중 온다고 또 오고 그럴 때는 차가 없으니까 걸어 다니니까
인제 마지밀 허고	이제 마중을 하고
돌  그래써요	그랬어요
돌뽕이 마니 이썬나요	산뽕이 많이 있었나요
인자 새가 인자 요 오둘개 요렁 걸 따서 무꼬 사네 가서 인자	이제 새가 이제이 오디 이런 걸 따서 먹고 산에 가서 이제
똥을 싸문 거그서 나고	똥을 싸면 거기서 나고
지금 우리 여으 치너물바테 요론 디도 혹씨 요런 지굼 뽕을 안 해도 혹씨 저 사네 전디 뽕나무 인능 거 그렁 걸 따무꼬 와서 마니 나요	지금 우리 여기 취나물 밭에이런 데도 혹시 이런 지금 뽕을 안 해도 혹시 저 산에 저런 데 뽕나무 있는 것 그런 것을따 먹고 와서 많이 나요
치너물바테도	취나물 밭에도
음음    오들개 따러 다니느라고 또 바뿔 떼 뽕 바테서	오디 따러 다니느라고또 바쁠 때 뽕 밭에서
긍깨 오둘개 따무거 가느 또 그거이 흑헝 거이 또 찌거등 흑헝 거이 찌문 또그걸 따고 나문 망 머리도 끈끈헝 거이 그냥	그러니까 오디 따 먹어 가면 또 그것이 하얀 것이 또 끼거든 하연 것이 끼면 또 그걸 따고 나면 막 머리도 끈끈한 것이 그냥
음 찐 가틍 게 이써요	음 진 같은 게 있어요
흑헝 거 그거이 막 찌니 막	하얀 것 그것이 막 진이 막
거슨 또 머리 까마야 데고만날 나는 뽕만 따란다고 또 울고 금 뽕 따먼 막 이따감 머 해 준다머 해 준다 홀가노콘 해 주도 안해	그것은 또 머리 감아야 되고만날 나는 뽕만 따라고 한다고 또 울고 그러면 뽕 따면 막 이따가 뭐 해 준다 뭐 해준다 속여 놓고는 해 주지도 않아
큰 이리여껀네요 뽕 따러 다니시능 거시	큰 일이었겠네요 뽕 따러 다니시는것이
이거 한철 거이 버린디요 그 저네느	이것 한 철 거의 버리는데요 그 전에는
아니 이게  며짬 자고 나면 커 가지고	몇 잠 자고 나면 커가지고
하루에 며뻔씩 먹찌요	하루에 몇 번씩 먹지요
인자 무꼬 나머 엄씨먼 또 주고 또 주고 그래야지 인자 긍깨 자꾸 마니 중거느 빨리 올라가고 헝깨 요즈믄 노인들 그래 니도 마니 뭉는 노미 아페든 올라간다고 아페중는다 그러고	이제 먹고 나면 없으면 또 주고 또 주고 그래야지 이제 그러니까 자꾸 많이 준 것은 빨리 올라가고 하니까 요즘은 노인들 그래 누에도 많이 먹는 놈이 앞에 올라간다고 앞에 죽는다 그러고
여기 회과네서도 엥간만 무거 마니 뭉는 놈 아페 중능그잉깨 그래싸 웃음	여기 회관에서도 어지간히 먹어 많이 먹는 놈 앞에 죽는 거니까 그래 쌓아
그래싸코 그러데끼	그래 쌓고 그러듯이
어째등가 잘 미깅자 시꾸 망코 손대 조아서 마니 미긴 사람드른 얼렁 올라가고인자 뽕이 자가가꼬 쩨깐썩 주고 한참 이따가 또 주고 그러먼 또 느께 올라가고 인자	어떻든 잘 먹여 이제 식구 많고 솜씨 좋아서 많이 먹인 사람들은 얼른 올라가고 이제 뽕아 작아가지고 조금씩 주고 한참 있다고 또 주고 그러면 또늦게 올라가고 이제
그 멩주실 뽀불 떼 헐 떼는 어트지 어터케 과정이 데요 실 뽀불 떼는 꼬치꼬치를 가지고	그 명주실 뽑을 때 할 때는 어떻게 어떻게 과정이 돼요 실 뽑을 때는 고치 고치를 가지고
인자 꼬치 그걸 인자 또 그 쑤세미에서 싹 따 가꼬	어 이제 고치 그걸 이제또 그 수세미에서 싹 따가지고
따 가꼬 인자 껍떠그로 인자 제 집 질라 거무장칭 거	따가지고 이제 껍질로 이제 제 집 지으려 거미줄 친것
그렁 걸 싹 또 까야 데요	그런 걸 싹 또 까야 돼요
싹 까 가꼬 인자 그거는 그거때로 인자	싹 까가지고 이제 그것은 그것대로 이제
거또 만들지요	그것도 만들지요
그걸 가꼬 그거는 가꼬 멀 핸능고 모르건네 애리농깨 그즉	그걸 가지고 그것은가지고 뭘 했는지 모르겠네 어려 놓으니까 그때
어런덜한테 거승만 하나 그거는 그거때로 까머 그어또 막 소쿠리로 하나라요	어른들한테 거시기만 하나 그것은 그것대로 까면 그것도 막 소쿠리로 하나예요
큰 소쿠리 저넨 막 굴근 소쿠리로 맨드라	큰 소쿠리 전엔 막 굵은 소쿠리로만들어
맨드라가꼬 중물 젤 인는 사라미 인자 그럼 그너믈 사다가 맨드라 가꼬 그렁 거또 다 또 항 거이고 그리 또 싹 까 가꼬 똗 덕써게다 시방 비느리가 조체마는 저네느덕써글 그냥 또 남자들 두리서 뜨 들고 그냥 탕탕 뚜두레요 티 문는다고	만들어가지고죽물 제일 있는 사람이 이제 그럼 그놈을 사다가 만들어가지고 그런 것도 다 또 한 것이고그리 또 싹 까가지고 또 멍석에다 시방 비닐이 좋지마는 전에는멍석을 그냥 또 남자들 둘이서 떠들고 그냥 탕탕 두드려요 티 묻는다고
탕탕 뚜두리가꼬 인자 페 노코 또 덕써게다가 싹 내려서 당글당글흐이 몰랴가꼬 가야 또 거그서도 공출 잘 바다 주지	탕탕 두드려가지고 이제 펴 놓고 또 멍석에다가싹 내려서 당글당글하게 말려가지고 가야 또 거기서도 공출 잘 받아 주지
그걸 단 고치를 네 버려요 봄 메상을	그걸 단 고치를 내 버려요 봄 매상을
매상을 내야 데요	매상을 내야 돼요
그거또	그것도
지베서그걸 쌀마서 실 뽑꼬나 안 하나고	집에서 그걸 삶아서 실 뽑거나 안 하고
긍깨 인자 구징 건만	그러니까 이제 궂은 것만
구징 건만	아 궂은것만
구징 건만 허고 또 그거또 쫌 칙 잘 무긍 거능 구께 지블 지꼬	궂은 것만 하고또 그것도 좀 잘 먹은 것은 굵게 집을 짓고
몸무긍 거는 잘고 그릉깨그 장 거 인자 물등 거 그렁 거 인잗 에 시를 뽀바요	못 먹은 것은 잘고 그러니까 그잔 것 이제 물든 것 그런 것 이제 에 실을 뽑아요
거 어떠케	그 어떻게
쌍깨	삶으니까
싹 그걸 쌀마야지요 고치를	싹 그걸 삶아야지요 고치를
고치를 긍깨 요만헌 솓 소딴지	고치를 그러니까 이만한 솥 솥단지
오가리	어 오지그릇 독
저네 저네 오가리 소딴지	전에 전에 오지솥
그거에다 인자 미테 스 인제	그것에다 이제 밑에 스 이제
불 느코	불 넣고
불 러코 인자	불 넣고 이제
다글다글 막 벅떡북떡 끄르문 인자 거따꼬치를 또 지버 여코 줄 빼문 인자 또 싹 뽀피 나가머니 또 인제 깬대기먼 흐물흐물허니이쓰 깬대기 소게가 또 이써요	바글바글 막 바글바글벅떡북떡은 심하게 끓는 모양을 나타내는 말 끓으면 이제 거기에다 고치를 또 집어 넣고 줄 빼면 이제 또 싹 뽑혀 나가면 또 이제 번데기만깬대기는 번데기의방언형 흐물흐물하게 있으 번데기 속에 또 있어요
흐물흐무흐이 쩨까만 이씨먼 인자 그거 인자 또 깬대기 그거이 또 나와 뿌리머혹씨나 여 시리 안 조으까이	흐물흐물하게 조금만 있으면 이제 그것 이제 또 번데기 그것이 또 나와 버리면 혹시나 이 실이 안 좋을까 봐
쩨깜 인능 거 쩨깜 허물허물허이 인능 거 인자 요리 건지서 우리드를 주무 인자우리으 요리 찌저가꼬 인자 또 그걸 무꼬	조금 있는 것 조금 흐물흐물하게 있는 것 이제이리 건져서 우리들을 주면 이제 우리는 이리 찢어가지고 이제 또 그걸 먹고
여러 사라미 모여서 헤야 데겐네요	여러 사람이 모여서 해야 되겠네요
인자 거그에 인자 허물허무런 그거 꼰대기 소게 인제 껍떠게 인제	이제 거기에이제 허물허물한 그것 번데기 속에 이제 껍질에 이제
쩨깜 허물허무허이 인능 걷보고 요리 찌저가 무긍 그노문 인자 또 풀쏘그미라고 배 짬서로	조금 흐물흐물하게 있는것 보고 이리 찢어서 먹은 그놈은 이제 또 풀소금이라고 베 짜면서
배 짬서 주리 떠 이리 저 오리 떠러지머 인자 그걸 인자 또 잉애 때에다가 인자요래 막 거러노코 만날 추믈 볼라가 여러가 쩨깜 떼 가꼬 또 비비먼 이서저 그걸 가꼬	베 짜면서 줄이 떠 이리 저 올이 떨어지면 이제 그걸 이제 또 잉앗대에다가 이제 이리 막걸어 놓고 만날 침을 발라가지고 이렇게 해가지고 조금 떼어가지고 또 비비면 이어져 그걸가지고
고치  크덴나 소그로	속으로  긍깨 그걸 보고 풀쏘그미라 그래써요 그러니까 그걸 보고 풀소금이라 그랬어요
그래 그걸 인자 쪼끔 떼 가꼬 인자 그걸 가꼬 요리 이스머 안 떠러지먼 또 배  를 짜고	그래 그걸 이제 조금 떼어가지고 이제 그걸 가지고 이리 이으면 안 떨어지면 또베를 짜고
그래  거또 안 쌀뭉 거는 또 안 이서저요 세서	그것도 안 삶는 것은 또 안 이어져요
세서 안 이서지는 인자 그거또 쌀무머 인자 인자 그거 엄는 사람드른 그냥 모씰 꺼 좀 구징 거 그렁 거를 또 지비 소테다가 쌀마야 데	세어서 안 이어지는 이제 그것도 삶으면 이제 이제 그것 없는 사람들은 그냥 못 쓸 것 좀 궂은 것 그런 것을 또 집 솥에다가 삶아야 돼
쌀마 가꼬 인제 그걸 잉앧 때에다가 인잗 꼬치 그걸 하나썩 인자 요릳 내 쌀마부들부들헝깨 인자 요리 거러 노먼 또 오리 떠러지먼 요리 떼 가꼬 또 요래 가꼬 요리두 개로 요리 이서 가꼬 땅 요로먼 또 이서지고 그래 가꼬 배 짜고	삶아가지고 이제 그걸 잉앗대에다가 이제 고치 그걸 하나씩 이제 이리 내어 삶아 부들부들하니까 이제 이리 걸어 놓으면 또 올이 떨어지면 이리 떼어가지고 또 이리 해 가지고 이리 두 개로 이리 이어가지고 딱 이러면 또 이어지고 그래가지고 베 짜고
베도 마니 짜셔써요	베도 많이 짜셨어요
마니 짜째	많이 짰지
거 이 멩지베 짜능 박 방버븐 삼베락 거이 가꼬요	그 이 명주베 짜는 박 방법은 삼베와 거의 같고요
배 짜능 거느 점부 가태요	베 짜는 것은 전부 같아요
인자 거그예서 인자 보디 지비라 보디라고 인능 거이 인자 다쌔 보디 아홉쌔 보디 야달쌔 보디 인자 그렁거 이짠	이제 거기에서 이제 바디집이라 바디라고 있는 것이 이제 닷새 바디 아홉새 바디 여덟새야달은 여덟의 방언형 바디이제 그런 것 있잖아요
멩지 보디는 또 똑 참비걷 걷꼬 상구 가늘고 그렁깨 인잗 다쌔 보디느두문두무너이 그러코 그래	명주 바디는 또 꼭 참빗 같고 사뭇 가늘고 그러니까 이제 닷새 바디는드문드문하게 그렇고 그래
세으막	
긍깨 인자	그러니까 이제
다쌔는 언능 언능 항개작끄너 주고 가는 배는 또 쪼깜 더디게 끄 짜 암만해도 가능깨 언능아피 안 부릉깨 인자더디게 끙코	닷 새는 얼른 얼른 한 개씩 끊어 주고 가는 베는 또 조금 더디게 끄 짜 아무래도 가느니까 얼른앞이 안 부르니까 이제 더디게 끊고
그믄 언제 여르메 그걸 짜나요 아니며는 베를 언제 짜요	그러면 언제 여름에 그걸 짜나요 아니면은 베를 언제 짜요
삼배는 인자 칠파레 짜고	음 삼베는 이제 칠팔월에 짜고
멩배느인자 삼동에 짜고	무명베는 이제 겨울에 짜고
삼동에느 삼배느 좀 버실기리지 아나요	겨울에는 삼베는 좀 바슬거리잖아요
그지요그러지요 긍깨로	
긍깨로	어 그러니까
인제 칠팔로 짜고 삼 인자 멩 저 멩배는 인자 삼동으로 짜고	이제 칠팔월로 짜고 삼 이제 무명 저 무명베는 이제 겨울로 짜고
멩지베  인제 멩지배도 인제 삼동으로 짜고	이제 명주베도 이제 겨울로 짜고
어그레 삼동으로 짜고	아 그래 겨울로 짜고
인자 멩지배느 인자 허는 사라미 썩 드무라요	이제 명주베는 이제 하는 사람이 썩 드물어요
그레요	아 그래요
집찜마덩 허능 거이 아이고	예 집집마다 하는 것이 아니고
인자멩지배는 참말로 솜씨 조은 사람들 찌비	이제 명주베는 정말로 솜씨 좋은 사람들 집
어  그런 지비서 허고	그런 집에서 하고
그런네요	음 그렇네요 예
그러면 인제되치 데충 이야기덴네	그러면 이제대충 대충 이야기 됐네
그 다으메는 인제 온만	그 다음에는 이제 옷만
네  여쭤 보고 그레나는 할 릴 다 헤따	여쭤 보고 그래 나는 할 일 다 했다
옷 만들기  옫또 마니 만드러서 이브셔찌요	옷도 많이 만들어서 입으셨지요
어유 그 다 저네는 베 짜셔 가지고 그걸로 옫 만드러서 이브셔써요	어휴 그다 전에는 베 짜셔가지고 그걸로 옷 만들어서 입으셨어요
아들 오또 짜시고	아들 옷도 짜시고
인자 어른드리 베 주무 인자 맨들그든 맨드라 바써	이제 어른들이 베어 주면이제 만들거든 만들어 봤어
천 헤가지고 누구 옫 만드셔 보셔써요	예 천 해가지고 누구 옷 만드셔보셨어요
인자	이제
에기들	아이들
씨아버니 옫허고	시아버지 옷하고
아 어른들	아 어른들
인제 어매들허고	이제 엄마들하고
네  그렁 거고	그런 것이고
머 멀로 만드셔써요 시아버지 오슨	뭐 뭘로 만드셨어요 시아버지 옷은
멩배 가꼬도 허고 삼배 가꼬도 허고	무명베 가지고도 하고 삼베 가지고도하고
그걸로 머 둘메기 가틍거 머 그렁 거 만드셔써요	음 그걸로 뭐 두루마기같은 것 뭐 그런 것 만드셨어요
인자 아홉 쌔배 그렁 거능 가꼬 두루막 거틍 거 그렁 거 허고	이제 아홉 새 베그런 것은 가지고 두루마기 같은 것 그런 것 하고
어뜨케 언트게 만드는지 두루막 어트케 만드는지 쫌 말씀 좀 헤 주세요	어떻게 어떻게 만드는지 두루마기 어떻게 만드는지 좀 말씀 해 주세요
인제 접뚜루막 헝 거 멩지 인제	이제 겹두루마기 한 것 명주 이제
네 부자찝뜨른 인자 멩지 안 녀코 쫌 살만한 사람드른 멩지 안 여코 인자 두루마글 허고 글안 하무 거느 인자 접뚜르마 인자 또 멩지 엄는 사람 비다늘 떠다가 인자 또 아늘 여코	부잣집들은 이제 명주 안 넣고 좀 살 만한 사람들은 명주 안 넣고 이제 두루마기를 하고그렇지 않으면 그것은 이제 겹두루마기 이제 또 명주 없는 사람 비단을 떠다가 이제 또 안을 넣고
인자 솜씨 조은 사람드른 그러고 엥가넌 사람드른 그냥 호뚜르막 해서 입꼬 댕기고 그래써요	이제 솜씨 좋은 사람들은 그리하고 어지간한 사람들은 그냥 홑두루마기 해서 입고 다니고 그랬어요
요 요새가 가찌 머 인는 사람드른 조논닙꼬 댕이고 엄는 사라문 그냥 아무꺼이라도 입꼬 댕기데끼 저네	요 요새와 같지 뭐 있는 사람들은 좋은 옷 입고 다니고 없는사람은 그냥 아무 것이라도 입고 다니듯이 전에
그러면 천 떠가지고 만드러라 그러면 어떠께 만드셔요 어떠케	그러면 천 떠가지고 만들어라 그러면 어떻게 만드셔요 어떻게
인자 오또 베는 사라미 따로 이써요 집마둥 다 베능 거이 아이고 인자 옫 잘베는 지비 가서 베가꼬 와서 인자 거 맨드러라 그러먼 인자 맨드리곤드	이제 옷도 베는사람이 따로 있어요 집마다 다 베는 것이 아니고 이제 옷 잘 베는 집에 가서 베어가지고와서 이제 그 만들어라 그러면 이제 만들곤
우리 친정 어무니는 그렁 거또 잘 베고	우리 친정어머니는 그런 것도 잘 베고
그렁깨 누에 고치 그렁 거또 잘 허고 그렁깨 머 너만테 배우꺼이 엉꼬 우리 어무니한테 배아찌요	그러니까 누에고치 그런 것도 잘하고 그러니까 뭐 남한테 배운 것이없고 우리 어머니한테 배웠지요
거 인자 두루막 거틍 거또 해 바야 시집 가문	그 이제 두루마기 같은 것도 해봐야 시집 가면
허능 거이라고 우리 올캐르 열 딸 인자 어매다 엄는 사라믈우리 친정에도 좀 업씨 사라써요	하는 것이라고 우리 올케를 열 딸 이제 엄마 없는 사람을 우리 친정에도 좀 없이 살았어요
그릉깨로 거 인자 울 어매가 그런 눈쌀미가 이씽깨 그렁 걸 배아 가꼬 만날 너무배 매로 댕기고 배 나라 주고 배 짜고 머 그렁 걸 헝깨	그러니까 그 이제 우리 엄마가 그런 눈썰미가 있으니까 그런 걸 배워가지고 만날 남의 베 매러다니고 베 날아 주고 베 짜고 뭐 그런 걸 하니까
인자 울 올캐르 인자 열다서쌀 뭉능 걸 어매도 엉꼬 그리 인능 거를 인자 데이다가 주구 어매가 일칭이 주거 부리고 인자 호래비가 인자 말허자머 호라부지허고 인자 사능 걸 데꼬 와 농깨 멀 몰 모리는디 그러 우러 올캐도 눈쌀미가 그리 조아서 잘 배우드라네요	이제 우리 올케를 이제 열다섯 살 먹은 걸 엄마도 없고 그리 있는 것을 이제 데려다가 저희 엄마가 일찍 죽어 버리고 이제 홀아비가 이제 말하자면 홀아버지하고 이제 사는걸 데리고 와 놓으니까 몰 모르는데 그러 우리 올케도 눈썰미가 그리 좋아서 잘 배우더라네요
그래 인제 나 네살 무거서 올캐가 완는디 울 올캐 울 엄니는 그냥 금 바꾸로 먿두리로 댕기고 머 금 바쿠러 너무 이리나 댕기고 그래도 인자 울 올캐르 그르시 잘 배와농깨로	그래 이제 나 네 살 먹어서 울케가 왔는데 우리 올케 우리 엄마는 그냥 금 밖으로뭐  다니고 뭐 금 밖으로 남의 일이나 다니고 그래도 이제 우리 올케를 그렇게 잘 배워놓으니까
울 올캐가 그냥 어매메이라 나이 에 애기라 농깨르 어매메이로 그리 사라농깨울 올캐느 똑 또 자기 딸 키우데끼 나를 키우고	우리 올케가 그냥 엄마 같아 내가 아기었으니까 엄마처럼 그리 살아 놓으니까 우리 올케는 꼭 또 자기 딸 키우듯이 나를 키우고
그래 울 올캐가 데꼬 안자서 울 어맨테 배아 가꼬 또 울 올캐가 데꼬 안자 날 그리 겔차 주고	그래 우리 올케가 데리고 앉아서 우리 엄마한테 배워가지고 또 우리 올케가데리고 앉아 날 그리 가르쳐 주고
또 울 언니가 옥곡 상깨로 우런니가 또 수물아호베 혼자 데써	또 우리 언니가옥곡 사니까 우리 언니가 또 스물 아홉에 혼자 됐어
수물아호베 혼자 데 가꼬 애기는 너열 나 노코 우리 형부가 구니네 가따 와서  주거 부러농깨로 도라가시농깨로	스물 아홉에 혼자 돼가지고 아이는 넷을 낳아 놓고 우리형부가 군인에 갔다 와서 죽어 버려 놓으니까 돌아가셔 놓으니까
그 또 우리 어매 미테서 커 농깨 울 언니도 그리 잘 헝깨 나는 그냥 우런니지비반쯤 살데끼 해써	그 또 우리 엄마 밑에서 커 놓으니까 우리 언니도 그리 잘 하니까 나는 그냥 우리 언니 집에서 반쯤 산 듯했어
그 애기들 봐 주고 또 거그서 또 배우고	그 아이들 봐 주고 또 거기서 또 배우고
긍깨 머 바느질도 너무 소네 가서 허도 안 허고	그러니까 뭐 바느질도 남의 손에서 하지도 않고
시지볼 때 오또 점부 우런니지비 가 가서 우런니가 허고 또 날 보고 바그라고인자 베 주고 금서 바그라고 그러먼 이 시터 주먼 인자 또 나가 허고	시집올 때 옷도 전부 우리 언니집 가서 우리 언니가 하고 또 나보고 박으라고 이제 베어 주고 그러면서 박으라고 그러면 이  주면 이제 또 내가 하고
그래가꼬 와 농깨 머 옫 허고 그렁 거는 넘한테 머 아수운 거이 업씨 배와써	그래가지고 와 놓으니까 뭐 옷 하고 그런 것은 남한테 뭐 아쉬운 것이 없이 배웠어
만드는 방버비 저이는 안 베워서 어떠케 만드는지 모르는데	만드는 방법이저희는 안 배워서 어떻게 만드는지 모르는데
그냥 베 가꼬 온 대로 쫄쫄 인자	그냥 베어가지고 온 대로 졸졸 이제
바 바 베서 바그무 데지 머	바 바 베어서 박으면 되지 뭐
바지 덥찌	바지 덥찌
인자 그때는 양장을 인자 더우까다 양장을 헤농께	이제 그때는 양장을 이제 양장을 해 놓으니까
양장은 나 똑떼기 잘 몰라	양장은 나 똑똑히 잘 몰라
이 그러나 인자 시집 와서도 씨아재드리 서이나 데옹께 여 우리 여 요지비가우리 자근지비 사란는디 우리	이 그러나 이제 시집와서도 시동생들이 셋이나 돼 놓으니까이 우리 이 이 집에서 우리 작은집이 살았는데 우리
그때도 양장저메 댕기씨문 허는디	그때도 양장점에 다녔으면 하는데
울 아부지가 구시기 데고 가이네가 바람나고로 어디로 장짜뽀태	우리 아버지가구식이 되고 계집애가 바람나게 어디로 장터 곁에
장떡 바다 거그흔들고 도라댕기야고 야당이가꼬 몽 깐는디	장터 바닥 거기흔들고 돌아다니냐고 야단이어가지고 못 갔는데
인자 눈쌀미가 이따고 모도 그자사 우리 자느어무이가 능네기 베 베 주무 허건네 그래가꼬 그 우리 씨누가 인자 베 주무 우리 씨아재들 오또 해 이피고 그래찌요	이제눈썰미가 있다고 모두 그래 쌓아서 우리 작은어머니가 넉넉히 베 베어 주면 하겠네 그래가지고 그 우리 시누이가 이제 베어 주면 우리 시동생들 옷도 해 입히고 그랬지요
인자 나 소느로 베기르 모대	이제 내 손으로 베지를 못해
베 온다능 거시 그럼 옫 뽄데로 이러케	베어 온다는 것이 그럼 옷 본대로 이렇게
응 응뽄지대로 인자 짤라가꼬 허능 거	응 응본대로 이제 잘라가지고 하는 것
글며는	아 그러면은
그릉 거	그런 것
그 다 다르니까 시아버지나 또 여자드리나 오시 다 다르니까	그 다 다르니까 시아버지나 또 여자들이나 옷이 다 다르니까
그대로 다  하 인제 남자들 오슨 이 남자들 올 대 그러구 인자 인자 바지덥찌랑은 인자 엔날 옫	아무렴 이제 남자들 옷은 이 남자들 올 대 그러고 이제 이제 바지 덥찌랑은 이제옛날 옷
노인들 임는 그거이고 인자 양보기라무 인자 지금 임는 요렁 거 양복이고 글 안허요	노인들 입는 그것이고 이제 양복이라면 이제 지금 입는 이런 것 양복이고그러잖아요
그러먼 다 기리가 좀 기리를 어따 저거나따가 가꼬 가야 쓰건네요	그러면 다길이가 좀 길이를 어디에다 적어놨다가 가지고 가야 되겠네요
인자 혹 베로 갈라무 인자 씨어무니가 인자 오슬 가꼬 가	이제 혹 베러 가려면이제 시어머니가 이제 옷을 가지고 가
거세기 읻	거시기 있
인자 몬자 헌 오슬 헌 오슬 가꼬 가무 인자 그 기리대로 허고	이제 먼저 한옷을 한 옷을 가지고 가면 이제 그 길이대로 하고
그러고 또 이 양장저메서 인자 배웅깨	그리고 또 이 양장점에서 이제 배우니까
배웅깨 인자 또 메싸른 메 치 머 그렁 걸 또 아능갑떼요	배우니까 이제 또 몇살은 몇 치 뭐 그런 걸 또 아나 보데요
그래가 인자 베다 주문 인자 나가 다 허고	그래서 이제 베어다 주면 이제 내가 다 하고
먼 오시 젤 만들기가 힘드러요	무슨 옷이 제일 만들기가 힘들어요
인자 함보근 인자 저네부터 헝 거잉깨 갠찬치마느 인자 양복	이제 한복은 이제전에부터 한 것이니까 괜찮지마는 이제 양복
양복 그렁 거이 인자 좀 대 보먼 인 거세도 인자 그거또 인자 메 뻔 헝깨로 에 눈 누네 이거가꼬 잘 데데	양복 그런것이 이제 좀 대어 보면 거시기도 이제 그것도 이제 몇 번 하니까 에 눈 눈에 익어가지고잘 되데
두르막 가틍 거는 얼마나 걸려요 하나 만드는데	아 두루마기 같은 것은얼마나 걸려요 하나 만드는데
두루마글 부지러니 해야 한나자레 한나 한 차 끼미 두루마글	두루마기를 부지런히 해야 한나절에 하나 한 채 꾸며 두루마기를
쪼깜 머 어정기리고 머 바가테난 가따머 더러 좀 가따 느 오고 드로고 머 어쩌고 오 오더다가	조금 뭐 어정거리고 뭐 바깥에나 갔다뭐 더러 좀 갔다 오고 들어오고 뭐 어쩌고 옷 하다가
머 애기드리 바가테 어쩌고 그러먼 또 애기들한테 또 쫌 디다 보고 어쩌고 나먼한 나자레 한차 모 끼민데	뭐 아이들이 밖에 어쩌고 그러면 또 아이들한테 또 좀 들여다보고 어쩌고 나면 한나절에 한 채 못 꾸미는데
난나지 소를 싹 윤디로가꼰 지저야 뎅깨	낱낱이솔기를솔은 솔기의 뜻 싹 인두를윤디는 인두의 방언형 가지고 지져야 되니까
아  하리부를 가따가 윤로 꼬바 노코	화롯불을 가져다가 인두를 꽂아 놓고
난나지 솔마등 그걸 대려야 뎅깨로	낱낱이 솔기마다 그걸 다려야 되니까
얼릉몬 해	얼른 못 해
그러며는 혼자 혼자 하싱 거에요	그러면은 혼자 혼자 하신 거예요
하무 혼자 하지 그라문	아무렴 혼자 하지 그러면
혼자 그러며는 바쁘시겐네요 하면서 또	어 혼자 그러면은 바쁘시겠네요 하면서 또
인자 싹 인자 솔부터 느질라 노코 인자 윤디로 가꼬 대레 가꼬	아 이제 싹이제 솔기부터 눌러 놓고 이제 인두를 가지고 다려가지고
그래 인자 또 꾸매꺼는 꾸매고	그래 이제 또 꿰매는 것은 꿰매고
다른 오또 다 만드러서 이브셔쓸 꺼 아니에요 에기들 오시랑	다른 옷도 다만들어서 입으셨을 것 아니어요 아이들 옷이랑
다 만드셔써요다 만드셨어요  에기들 오슬	
에기들 오슬	아이들 옷을
애기들 오슨 그냥 나가 얄구께 베가꼬 해서 이피고 그래찌요	아이들 옷은 그냥 내가 얄궂게 베어가지고 해서 입히고 그랬지요
에기들 오또 다 윤디로 이러케 지저 가지고 헤야 데요 똑까테요	아이들 옷도 다 인두로 이렇게 지져가지고 해야 돼요 똑같아요
인자 멩옫 그릉 거느 안 지지도 대 그거는 인자 두루막 그렁 거느 인자	이제무명옷 그런 것은 안 지져도 돼 그것은 이제 두루마기 그런 것은 이제
대리야 인자 입 넘 나 입꼬 나가무 이쁘고 그래치요	다려야 이제 입 남나 입고 나가면 이쁘고 그렇지요
그냥 지베서 임는 오슨 그러며는	그냥 집에서 입는 옷은 그러면은
또 두루막또 인자 소매도 이 다늘	또 두루마기도 이제 소매도 이 단을
다늘 요리딱 해야꼬 요러무 싹또 풀로 부치야 대	단을 이리 딱 해가지고 이러면 싹 또 풀로 붙여야 돼
풀로요	풀로요
풀로 끼매문 인자 바느질 식 껃 베긴다고	풀로 꿰매면 이제 바느질 겉 보인다고  풀로 인제 요리 꼬치 가꼬는 풀로 인잗 요리 여그를 싹 푸를 밥테을 밥티나 인자푸를 데게 끼리덩가 해가꼬 가따 노코 풀로 이제 이리 꼽쳐가지고는 풀로 이제 이리 여기를 싹 풀을 밥알을 밥알이나 이제 풀을 되게 끓이든지 해가지고 가져다 놓고
머 멀 멀로 밥 바브로	뭐 뭘 뭘로 밥 밥으로
바브로도 허고	밥으로도 하고
풀로 끼리 가꼬도 허고 그래가꼬 인자 요리 조르레이 요노믈 요리 부치가꼬 요리 단댄만침 요리 꼬츠머 요리	풀로 끓여가지고도 하고 그래가지고 이제 이리 조르르하게 이놈을 이리 붙여가지고 이리 단 댄 만큼 이리 꼽치면 이리
네  여가 인자 디씨따고 생각허머	여기에 이제 뒤집었다고생각하면
응  욜 해가꼬 싹 인자 그노무 파 윤디로가 지지야 요노미 딱 부찌	이리 해가지고 싹 이제 그놈을 인두를 가지고 지져야 이놈이 딱 붙지
그러치요	그렇지요
응  응  그릉깨 난나치 풀로 부침성 지지야 뎅깨로 윤디로 가꼬 은때야 뎅깨로 거거이벵이지	그러니까 낱낱이 풀로 붙이면서 지져야 되니까 인두를 가지고 문질러야 되니까 그것이 병이지
글면 여기다 그레가꼬 다시 또 이러케 바느질 이러케 안 헤요	그러면 여기에다 그래가지고 다시 이렇게 바느질 이렇게 안 해요
인자 그래가꼬 인자 두문두문허이 인자 꼬 인자 끼매 나야조 글 안하무 요노미	이제 그래가지고 이제 드문드문하게 이제 꼬 이제 꿰매 놓아야지요
푸푸 혹씬남자들 머 수리나 잡쏴떤지 어째떤지 허먼	혹시 남자들 뭐 술이나 잡쉈든지 어쨌든지 하면
좀 꾸부재지덩가 업꼬 드러가머 이거 덜렁덜렁 나가게 뎅깨	좀 구겨지든지 업고 들어가면 이것 덜렁덜렁 나가게 되니까
인제 또 다문다문허니 인제 또 바느를 가꼬 와	이제 또 다문다문하게 이제 또바늘을 가지고 와
함 바늘썩 꾸매 나야지 안 풀리고로	한 바늘씩 꿰매나야지 안 풀리게
근디 풀로 부처 노코 그러케만 헤 노면 나중에 빨 떼 그건 어뜨케요	아 그런데 풀로 붙여 놓고 그렇게만 해 놓으면 나중에 빨 때 그건 어떻게요
그럼 또 그노믈 따야지 긍깨 두문두문허이 허네 안 떠러저 갈 안 풀리나갈 쩡도로	그러니까 또 그놈을 따야지 그러니까 드문드문하게 하네 안 떨어져 갈 안 풀려나갈정도로
그러며는 빤 다으메 다시 또 풀로 또 부처야 데는 거예요 또 이러케	아 그러면은 빤 다음에 다시 또 풀로 또 붙여야 되는 거예요 또 이렇게
하무 이그시 싹	아무렴 이것이 싹
저거  빨무 또 그래야 데지요 긍깨느 만날 옫 그걷 허다가 말지	빨면 또 그래야 되지요 그러니까는 만날 옷 그것 하다가말지
동정도 동정도 세로 헤야 데고	동정도 동정도 새로 해야 되고
싹 또새로움멩키로 새로 해야지 이제 두루막 거틍거느	음 싹 또 새 것처럼 새로 해야지 이제두루마기 같은 것은
아이고    그거 보통 이리 아니어껀네요 그러면	그것 보통 일이아니었겠네요 그러면
하도 또 소믈루 소게다 소믈 농깨로 또 싹 뜨더가꼬 새로 해야 데고	하도 또솜으로 속에다 솜을 놓으니까 또 싹 뜯어가지고 새로 해야 되고
함번 빨며는 소믄 다 끄지버 네서	한번 빨면은 솜은 다 끄집어 내서
그릉깨 안 안 허고 껍떡 허고 그릉깨 두 암팍 꺼주글 뜨더서 헝깨 인잗 인자두가지 허는 세미지	그러니까 안 안하고 겉하고 그러니까 두 안팎 거죽을 뜯어서 하니까 이제 이제 두 가지 하는 셈이지
그지요	그러지요
거 이 노인들 옫 함벌 뜨더노무 통으로 하나이다 저네느	그 이 노인들옷 한 벌 뜯어 놓으면 통으로 하나예요 전에는 웃음
자주 그러며는 어떠케 자주 모빨겐네요	자주 그러면은 어떻게 자주 못 빨겠네요
긍깨 저네느 막 그냥 더럽찌 지금거치 어찌 이리 깨끔해가꼬 사라써 저네느	그러니까 전에는 막 그냥 더럽지 지금같이 어찌 이렇게 깨끗해가지고 살았어 전에는
한 우리 씨아부지는 영 부를 잘 때조	한 우리 시아버지는 영 불을 잘 때 줘
부를 잘 때중깨 끄시르미 찌서 시컴허무 그냥 또 씨그 씨처야 뎅깨 밤낟 끼 오끼매다가 마라 긍깨 밤낟 옫 끼매다가	불을 잘 때 주니까 그을음이 껴서 시컴하면 그냥 또 씻어 씻어야시치다는 씻다의 방언형 되니까 밤낮 꿰 옷꿰매다가 말아 그러니까 밤낮 옷 꿰매다가
바메	밤에
바무로	밤으로
옫 안 끼맨 모시 사마야재 삼동으로도 모시는 사믄 여르므로 삼찌마느	옷 안꿰매면 모시 삼아야지 겨울로도 모시는 삼은 여름으로 삼지마는
네  모시는 머 스	모시는 뭐 스
저 베게 하나 베고 좀 누우시다	저 베개 하나 베고 좀 누우십시오시다는 십시오의 뜻
네  교수님 이쪽 쫌 누우세요 이쪼그로	교수님 이쪽 좀 누우세요
응 아라서 허께	응 알아서 할께
에     누우세요	누우세요
그 더럼네 요그느	더럽네 여기는
데찌요	아 됐지요
사믄 다저야 데니까 여르메 모타지요	삼은 다져야 되니까 여름에 못 하지요
사문 긍깨 여르므로 허고	삼은 그러니까 여름으로 하고
응 모시는 겐차나요 모시는	응 모시는 괜찮나요 모시는
모시는 삼동도 허고 여름도 허고 아무때라 데	모시는 겨울로도 하고 여름도 하고 아무 때라도 돼
그거또 참바람 쒜면 좀 안 조타고 그러던데 겐차능가요	그것도 찬 바람 쐬이면 좀 안 좋다고 그러던데 괜찮은가요
안 조체 여 물팡 요런 디가 그냥 삼동으노느 시리재	안 좋지 여 무릎 이런 데가 그냥 겨울로는 시리지
긍깨 순 인자 굼불 때고 따순 방에 안자서 인자 해는	그러니까 순 이제 군불때고 따뜻한 방에 앉아서 이제 하는
그래 자미 와서 몬 사라 자미 와서 밤낟 자우르지라	그래 잠이 와서 못 살아잠이 와서 밤낮 졸지요
인자 늘거 농깨 요 자미 아노지만 절문 사람도 자미 그리 마니 아노요 저네느	이제 늙어 놓으니까 이 잠이 안 오지만 젊은 사람도 잠이 그렇게 많이 오잖아요 전에는
시방도	시방도
시방도 머 이료일 토요일도 머 정심 때꺼지 모두 머 자고군넌디	시방도 뭐 일요일 토요일도 뭐 점심 때까지 모두 뭐 자고 그러는데
또 새보게 일라 방애 찌서 또 밥해야지	또 새벽에 일어나 방아 찧어서 또 밥해야지
만날 자우르다가그냥 씨어무니한테 만날 머 소리 드꼬 막	만날 졸다가 음그냥 시어머니한테 만날 뭐 소리 듣고 막
막 부애가 나무 뚜들 패고 막	막 부아가 나면 두들겨 패고 막
뚜르라 마꼬 그래요 뚜들 마꼬는 또 합씬 울고도	두들겨 맞고 그래요 두들겨맞고는 또 엄청 울고도
그래도 또 자미 오고	그래도 또 잠이 오고
바메 그러며는 게속 하셔야 데겐네요 이불도 꼬 꿰메시고 오또 만드러야 데고 빨레하면 그거또	밤에 그러면은 계속 하셔야 되겠네요 이불도 꼬 꿰매시고 옷도 만들어야 되고 빨래하면 그거도
인자 그렁 거 인자 허고 나무 인자 또 하린 인제 또 업짜 무슨 수월허문 인자	이제 그런 것 이제 하고 나면 이제 또 하루는 이제 또 없으면 무슨 수월하면 이제
우리 씨어무니는 바느지를 모대	우리 시어머니는 바느질을 못해
아이고 저 태인도서 커 가꼬	저 태인도에서 자라가지고
네  밤낟 조개나 자부로댕기고 그래 가꼬 바느지를 모대 긍개야 오끼매기에 몬살거태	밤낮 조개나 잡으러 다니고 그래가지고 바느질을 못해 그러니까 옷 꿰매기에 못 살 것 같아
혹 애기가 깨먼 그 자미 와서 딱 애기 재운당 거이 나도 자 부리고	혹 아기가깨면 그 잠이 와서 딱 아기 재운다는 것이 나도 자 버리고
그래 노문 그냥 자는 디 와서 그냥 뚜디리고 악 아글 씨고 그냥 어디 시방 그람하나도 안 사꺼이요	그래 놓으면 그냥 자는 데 와서 그냥 두들기고 악 악을 쓰고그냥 어디 시방 그러면 하나도 안 살거요
다 도망가 버리시제	다 도망가 버리시지
항꺼 첟 쌔보게 일나서 또 방애 찌 가꼬 또 밥해 얼릉 줘야 또 학스 하꾜 간 씨아재들 하꾜 가야재	한껏 첫 새벽에 일어나서 또 방아 찧어가지고 또 밥해 줘야 또 학스 학교 간 시동생들 학교 가야지
씨아제들 오또 다 거서 헤서 만드러서 이피셔껜네요	시동생들 옷도 다 거기서 해서 만들어서 입히셨겠네요
저네는 인자 이 바느 인자 트리꼬 바느질 바느질쨍이라 그래찌 저네느	전에는이제 이 바늘 이제 재봉틀 있고 바느질 바느질꾼이라 그랬지 전에는
바느질쨍이한테다 가따 매끼먼 인자 해 나따고 허문 인자 와서 가서 차자 가꼬메친 날 오라고 그러먼 차자 가꼬 와서 이피고 그래따요 만해도	바느질꾼한테다 가져다맡기면 이제 해 놨다고 하면 이제 와서 가서 찾아가지고 몇 일 오라고 그러면 찾아가지고와서 입히고 그랬대요 하지마는
나가 와서는 하 바느질쨍이한테 가도 안 허고 두루막또 넘 일 해 주고	내가와서는 바느질꾼한테 가지도 않고 두루마기도 남 일 해 주고
네  일 해 주고 인자인제 동네 인자 여 이 바느질허는 사암드리 와서 인자 두루막또 끼매 주고 그래따고 허데	일 해 주고 이제 이제 동네 이제 이 이 바느질하는 사람들이 와서 이제 두루마기도 꿰매주고 그랬다고 하데
가치 모여서 하나요 막 모여서도 마니 하셔찌요	같이 모여서 하나요 막 모여서도 많이 하셨지요
멀 인자 모이서느 바느질거튼 제낌 지비서 혼자서 허재	뭘 이제 모여서는 바느질 같은 제각각 혼자서 하지
근디 인자 우리 씨어무니느 그렁 걸 몯헝깨 몯헝깨로 인자 너무 지비 일 해 주고 머 바또 매 주고 먼 논도 매 주고 머 저렁 걷 허고 인자	그런데 이제 우리 시어머니는그런 걸 못하니까 못하니까 이제 남의 집에 일 해 주고 뭐 밭도 매어 주고 무슨 논도 매어주고 뭐 저런 것 하고 이제
네  바느질 시기고 그래땁띠다	바느질 시키고 그랬답디다
근는디 인자 긍깨 자기거니 동네 싸람들 인자 그 마리라	그러는데 이제 그러니  까  동네 사람들 그 말이야
자이가 몯허무 메느리가 일류 바느질쨍이느 아니제마느 그 자기 몯허능 걸 헝깨	자기가 못하면 며느리가 일류 바느질꾼은 아니지마는 그 자기 못하는 걸 하니까
헝깨 암 머래야 하꺼인디	하니까 꾸중을 안 해야 될 텐데
시지블 살린다고 인자 동네서 모두	시집살이를 시킨다고 이제 동네서 모두
나 몯허능 건 너미으 해 메느리 그런 메느리가 와서 해 주머	나 못하는 것은남이 해 며느리 그런 며느리가 와서 해 주면
곱께 바 줘야 허꺼인디 그래도어러이라고	곱게 봐 줘야 할 텐데 그래도 어른이라고
머 어러느 도가지르 깨도 머 흐미 엄따고	뭐 어른은 독을 깨도 뭐 흠이 없다고
예   자기는 허도 몯험서롱	자기는 하지도 못하면서
잘몯핸네 잘핸네그러고 그래 가꼬 또 넘 바느질 잘 허는 사람한테 해 옹걷허고 나 헝걷허고 좀 나 헝 거이 솜씨가 조 좀 앙 구께 구즈먼 또 싹쭈 뜨더뿌리요	잘못했네 잘했네 그러고 그래가지고 또 남 바느질 잘 하는 사람한테 해 온 것하고 내가 한 것하고 좀 내가 한 것이 솜씨가좀 좀 궂게 궂으면 또 싹 쥐어뜯어 버려요
이거 바느지리라고 해 난냐고	이것 바느질이라고 해 놓았느냐고
그 뽀느로 뽀느로 아까 이러케 어떠케 헤 가꼬 와야 데지요 이러케	아 그본으로 본으라 아까 이렇게 어떻게 해가지고 와야 되지요
인자	이제
그 그런 사람드른 인자 뽄지가 이씽깨로	그 그런 사람들은 이제 본이 있으니까
예예  인자 양장경 양장 이 응어느 인자 뽄지로 가꼬 허오지만해도	이제 양장 양장이런 것은 이제 본을 가지고 해 오지만
응  이리 저네 함봉 인자 중우적쌈 머 그리 저구리 그렁 거느 그냥	이리 전에 한복이제 중의 적삼 뭐 그리 저고리 그런 것은 그냥
네  대강 허노슬 노코 그냥 짤라요	대강 헌 옷을 놓고 그냥 잘라요
인자 꼽치기에 인자 젝쩜 솜씨껃 꼽치기에 이찌 인자 짤라 가꼬	이제 꼽치기에이제 각자 솜씨껏 꼽치기에 있지 이제 잘라가지고
이삐게 꼽처 가꼬 허는 사람	이쁘게 꼽쳐가지고 하는 사람
꼽 꼽친다는거시	꼽 꼽친다는 것이
긍깨 요 도런 요렁 거 요리 인자 내리 여그서는 짜리고 여그느 요 내리 수거 가꼬 여그르 인자	그러니까 이 도련 이런 것 이리 이제 내리 여기서는 자르고 여기는 이 내리 숙여가지고 여기를 이제
씅 요렁 걸 인제 이삐게 요리 인자	쑥 이런 걸 이  제 이쁘게 이리 이제
꼽치능 거	예 꼽치는 것
돌리능 거	돌리는 것
그렁 거 인자 솜씨가 인자 잘허고 몯허고가 이찌요	그런 것 이제 솜씨가 이제잘하고 못하고가 있지요
오시 즈 요즈메도 이러케 저기 하는데 인제 엔날 오또 보며는 다 이르미 이써쓸 꺼 아니에요	옷이 즈 요즘에도 이렇게 저기 하는데 이제 옛날 옷도 보면은 다 이름이있었을 것 아니어요
여기는 머 다 어디 꼬메진	여기는 뭐 다 어디 꿰매진
소매	소매
소메라 하고 그러면 여기 여기도 이러케 이르미 인나요	소매라 하고 그러면 여기 여기도 이렇게 이름이 있나요
여그는 인자 둥치 인자	여기는 이제 둥치 이제
언 언둥치딛 압썩	원 둥치뒤 앞섶
딛 도련	뒤 도련
응  인제 디는 여그는 동그라허니 욜 안 하등가요 영게	이제 뒤는 여기는 동그랗게이리 하잖아요 이렇게
예예  제트랑 미츤 좀 더 올라가고 양쪼글	겨드랑이밑은 좀 더 올라가고 양쪽을
올라가고 등거리는 쪼깜 내리가고 헝깨 동그람허이 요리 허고	올라가고 등은조금 내려가고 하니까 동그랗게 이리 하고
인자 아픈 인자 또 내리수거	이제 앞은 이제 또 내리 숙여
여그느	여기는
요리 내리수거가꼬 인자 요리 허무 요거는 썩	이리 내리 숙여가지고이제 이리 하면 이것은 섶
요거는 압 또련 요거는 딛 딛 또런	이것은 앞 도련 이것은 뒤 뒤 도련
응  또 여그느 요거 여 동그람허이 요거	또 여기는 여 동그랗게 이것
응  요거는 짇	이것은 깃
여그는 동정	여기는 동정
예  요거는 소매	이것은 소매
여기다 머 하나 다 다라나야 데자나 이러케여기에다 뭐 하나 달 달아놔야 되잖아요 이렇게  거 인자 고름 다는 사람 고름 달고 단추 다는 사람 단추 달고 그러고 인자 요	
거 인자 고름 다는 사람 고름 달고 단추 다는 사람 단추 달고 그러고 인자 요	그 이제 고름 다는 사람 고름 달고 단추 다는 사람 단추 달고 그리하고 이제 이
요 끄테리예 요거 댕거느 끄똥	이 끝에 이것 댄 것은 끝동
끄똥	끝동
짇 지슨 멍가	깃 깃은 무엇인가
요걸 보고 짇	이걸 보고 깃
지시라고요 지치라 그레요	짓이라고 그래요 짗이라고 그래요
지시라 그래써요 저네 우리느	짓이라 그랬어요 전에 우리는
지치라그리도 허고 지시라 그러도 허고	짗이라 그리고 하고 짓이라 그러기도 하고
써근요 썩피라 그레요 서비라 그레요	음 썩은요 쎂이라 그래요 섭이라 그래요
압써피라 그리도 허고 인자	앞쎂이라 그리도 하고 이제
써피라 그래도 허고	쎂이라 그리도 하고
그  인자 되게 부치기에 여꼬 인자 좀 수워리 말 허는 거는 그냥 서비라그러고	이제 되게 붙이기에 넣고 이제 좀 수월하게 말하는 것은 그냥 섭이라 그러고
써피라 그러고	쎂이라 그러고
음음  어어  바지도 이짜나요 바지도	바지도 있잖아요 바지도
바지도 이러케 이러케 무꺼야 데니까 이거 이거는 머라고 그레요 여기	바지도 이렇게  이렇게 묶어야 되니까 이것 이것은 뭐라고 그래요 여기
거 꼼말 꼼말	그 허리춤 허리춤  꼼말 허리춤
어이  여그 요거이 요거 요거이 여그 요걷 반동가리 요거는 새끼포	여기 이것이 이것이것이 여기 이것 반 동강 이것은 새끼포
요거는진포	이것은 긴포
여그에 인제 또 가랭이	여기에 이제 가랑이
예에 여그느 가랭이	여기는 가랑이
인제 무꺼야 데자나요	예 이제 묶어야 되잖아요
건 인자 뭉끄는 그거는	예 그건 이제 묶으는 그것은
댄님	대님
거능보고 댄니미	그것을 보고 대님
그다메 인제 머 또 하나 시너야 데고	그 다음에 이제 뭐 또 하나 신어야 되고
보선	버선
다 만드셔써요	다 만드셨어요
하무 그건 다 허조	아무렴 그런 다 하지요
보선 가틍 거는 만들라면 시가니 오레 걸리나요	버선 같은 것은 만들려면 시간이 오래 걸리나요
보서는 인자 내나 요거 뽄지대로 요고 요고 베 가꼬	아 버선은 이제 내나이것 본대로 이거 이거 베어가지고
베 주머 암모리	베어 주면 앞 머리
음  요거는 뒨머리	이것은 뒷머리
여그는 요걸 보고 머라냐 머 여 인자 코 보선코	여기는 이걸 보고 뭐라 하니뭐 이 이제 코 버선코
요고 인자 바늘로 가꼬 요리 해가꼬 여그르 인자 바늘가끼가 욜 코 나오라고 인자 자바 댕기라	이것 이제 바늘을 가지고 이리 해가지고 여기를이제 바늘 가지고 꿰어가지고 이리 코 나오라고 이제 잡아당겨
자버 뎅겨서 그걸 꺼네는 거예요	아 잡아당겨서 그걸 꺼내는 거예요
응  지그문 그냥 움지니여 요래도	지금은 그냥  이래도
저네는 요고	전에는 이것
요리 째삗허이 요래 안 들린다고	이리 쭈뼛하게 이리 들리잖아
예에  그무 인자 거그르 인자 주 가꼬 요리 디씨무 요거이 안 나오머	그러면 이제 거기를 이제 기워가지고 이리 뒤집으면 이것이 안 나오면
거글 애를 씨고 요리바늘 가꼬 끄 내래가꼬	거기를 애를 써서 이리 바늘 가지고 끌어 내려가지고
요노문 요리 끼 가꼬 망 여그르 막 이래데예	이놈은 이리 꿰어가지고 막 여기를 막 이렇게돼요
예에에에  거그도 그래야 데고 요 썸	거기도 그래야 되고 이 섶
네  썸 이거또 디치 가꼬 인자	섶 이것도 뒤집어가지고 이제
네  요거이 안 나오무 여여 바느를 여끄터리 여그다 요리 끼 가꼬 요래 해야 거으가 이삐게 나오고	이것이 안 나오면 이 이바늘을 이 끝 여기에다 이리 꿰어가지고 이렇게 해야 거기가 예쁘게 나오고
그레 가꼬 하 으 버선 가틍 거는 하나 만들려며는 금방 만드러요	그래가지고 하 으 버선 같은 것은 하나 만들려면은 금방 만들어요
항 거는 인젣 또 임잗 보순 볼반능 거는 인잗 또 에럽찌	아무렴 그것은 이제또 이제 버선 볼 받는 것은 이제 또 어렵지
볼반는다능 거시	볼 받는다는 것이
여가 인자 요발로 인자	예 여기가 이제 이쪽으로 이제
요리 더믄 인제 처메 인자 새거느 요리 인자 해 가꼬 뺑 돌리 요리마 이삐게요리만 주문 인자 보순 디지무 보서니 데는디	이리  이제 처음에 이제 새 것은 이리  이제 해가지고 뼁 돌려 이리 막 예쁘게 이리 기우면 이제 버선 뒤집으면 버선이 되는데
이거 인잗 저네는 배가 귀헝깨	이것 이제 전에는 베가 귀하니까
인제요말로 요리 요만큼 요래 가꼬 인제 여가 떠러저서 인자 거서면 인젣 여그가 아까 바서인제 요리 볼 요거는 인자	이제 이쪽으로 이리 이만큼 이렇게 해가지고 이제 여기가 떨어져서 이제 뭐하면 이제 여기가 아까워서 이제 이리 볼 이것은 이제
요걸 보고 머라핸냐 중불 중볼	이걸 보고 뭐라 했니 중볼 중볼
여기	여기
응  여기가	여기가
응  중보리에요	중볼이에요
이 요리 요리 인자	아 이리 이리 이제
야 허문 중볼 요리 해 가꼬 또 인제 요 인자 보시니 인자 요리 나가 요리 뺑 돌리 인자준 보서니 뎀먼	이제 하면 중볼 이리 해가지고 또 이제 이 이제 버선이 이제 이리 나가이리 뺑 돌려 이제 기워 버선이 되면
요걸 안죽 여그를 안 허고 여그 인자 또보를 바다야 데 보를	이걸 아직 여기를 안 하고 여기 이제 또볼을 받아야 돼 볼을
소게꺼 안 떠러지라고 요리	속에 있는 것 안떨어지도록 이리
더더 박 더 이제 이러케 위에다가	아 더 더 박 더 이제 이렇게 위에다가
바가 논능 거에요	박아 놓는 것이에요
잉  안 떠러지게	안 떨어지게
우예다가	위에다가
네  거 인자 볼 반능 거이고 목또리 목 모글 요리 헌당 거느 목 목 반능 거이라 그러고	그 이제 볼 받는 것이고 목도리 목 목을 이리 한다는 것은 목 목 받는 것이라 그러고
여기도 웨	여기도 왜
보짐 목	버선 목
웨 웨 여기는 웨 헤요	왜왜 여기는 왜 해요
여가 떠러징깨로	여기가 떨어지니까
여그도 떠러지고 여그도 떠러지고 그래농깨 인제 여그가	여기도 떨어지고 여기도 떨어지고 그래 놓으니까 이제 여기가
아까붕깨 요고늠 나 뚜고요	아까우니까 이것은 놔 두고요
요리 인자 중가늘 보 모글 바다머	이리 이제 중간을 보 목을 받으면
네 바다 가꼬 인자 또 또 토 또 요놈 떠러지꺼이라가 안 떠러지게 헌다고 요리 인자 또 보를바다	받아가지고 이제 또 또 토 또 이놈 떨어질까 봐 안 떨어지게 한다고 이제 또 볼을받아
요리	이리
여그느 요리	여기는 이제
그걸 보고 인자 볼 목 빤는다고 허고 볼볼 반는다 그러고	그걸 보고 이제 볼 목 받는다고 하고 볼 볼 받는다 그러고
그건 항커리가지고 얼마를 시늘라고	그건 한 켤레 가지고 얼마를 신으려고
한 일련 신따가	한 일 년 신다가
만날 긍깨 쥘 끼매다가 만당깨 바늘로	만날 그러니까 기워 꿰매다가 만다니까 바늘로
멩워른 또 쪼깜 시늠 떠러저 뿌리고	무명베는 또 조금 신으면 떨어져 버리고
멀 머느뇨	어 뭘 뭐는요
멩 멩베 가꼬	무명 무명베 가지고
그 저네느	그 전에는
강모까꼬	광목 가지고
그러니까	그러니까
어이 강목까꼬 허고	어이 광목 가지고 하고
아이고 머 만날 온저 바느를 끼매능 걷 밤낟 끼매다가 마라 긍깨	아이고 뭐 만날 옷 저 바늘을 꿰매는 것 밤낮 꿰매다가 말아 그러니까
시꾸 마는 집이는 그 오시 다 어째	어 식구 많은 집은 그 옷이 다 어째
씨아재들 똗 먿 저런 디 머 딱찌치기허고 어디 가서 은때고 그러문 요 궁딩이 요노미 옴싹 드러안네	시동생들 또 뭐 저런 데 뭐 딱지치기 하고 어디 가서 문지르고 그러면 이 궁둥이 이놈이 움퍽 들어앉네
궁딩이	궁둥이
이   무릅허고	무릎하고
금 조깜 포도씨 끼매 주고마 하리나 이트리나 가서 도라댕이다 오무 또 도로 그래 그냥	그러면 조금 겨우 꿰매주고 하루나 이틀이나 가서 돌아다니다 오면 또 도로 그래 그냥
또   인제 여 여그도 인자 궁뎅이 여그도 인잗 예쁘게 인잗 짤라서 그래 가꼬 바다주문 거서건넌디	이제 여 여기도 이제 궁둥이 여기도 이제 예쁘게 이제 잘라서그래가지고받아 기우면 뭐 하는데
나 시지블 옹깨로 우리 씨아재느 그냥 넙떠건 그냥 판때기메기 요걸 그냥 우리씨어무니가 등 쭝쭝주서 해서 노먼 가서 그냥 딱찌치기 좀 허고 요로고 어쩌고 나묻 땡기서 뚜두둑 떠러지문	내가 시집을 오니까 우리 시동생은 그냥 넓적한 그냥 판자처럼 이걸 그냥 우리 시어머니가 등 쭝쭝 기워서 해서 놓으면 가서 그냥딱지치기 좀 하고 이렇게 어떻게 나면 당겨서 뚜두둑 떨어지면
실랴가 벌러꿍벌러꿍 그래	가 벌렁벌렁 그래 웃음
힘껃 땡기문	힘껏 당기면
그걸 보고 우찌 인잗 우리 지비 저거 호이라 그래 지금 깅차레다가 저귿 여서사는디 호이 궁뎅이 짐빨짜기 덜러꿍덜러꿍 헌다가 할매드리 그래 노코 이꼬	그걸 보고 웃지 이제 우리 집이 저기 호이라 그래 지금 경찰에다가 저기 여기서 사는데호이 궁둥이 김발이 벌렁벌렁 한다고 할멈들이 그래 놓고 웃고
그랜는디 무 인자 나가 와서 그리 야무치게 끼매 주고 그렁깨로	그랬는데 뭐이제 내가 와서 그리 야무지게 꿰매어 주고 그러니까
참 메느리가 차말로 솜씨가 조타고 날 보고 막 곰보라고 우리 지비서는 야다니고 그랜넌디	참 며느리가 정말로솜씨가 좋다고 나보고 막 곰보라고 우리 집에서는 야단이고 그랬는디
머 곰보까 몰라도 머 다만때기 지잔타고 요옴 다만때기느 허도 몯허능 걸 메느리저리 야무칭 거이 와 잘해준다 싸도 그래도 어른 노리헌다고 시지블 살려	뭐 곰보인지 몰라도 뭐 담안댁 지지 않는다고 이 담안댁은 하지도 못하는 것 며느리 저리 야무진 것이 와 잘해 준다 쌓아도 그래도 어른 노릇 한다고 시집살이를 시켜
시어머니 테코가 다만떼기에요	아 시어머니 택호가 담안댁이에요
어  저 태인도 다마네 그걷	저 태인도 담안에 그것
거서 물때꺼리 만날그 조개 빼끼느 안 자반능갑써	거기서 물때꺼리 만날 그 조개밖에는 안 잡았나 봐
앙꺼또 몬해	아무 것도 못해
바깐닐만 하시고	바깥일만 하시고
네  아네 이른 안 하셔서	안일은안 하셔서
긍깨 인자 각씨르 메느리가역 각씨르 가이내가 오무 메느리는 두루매이고 머이고척척 다 끼매 논는디	그러니까 이제 각시를 며느리가 각시를 계집애가 오면 며느리는 두루마기고 뭐고 척척 다 꿰매어 놓는데
당시는 그거또 노버더가꼬 해 긍깨 품아시 해 가꼬	당신은 그것도 놉 얻어가지고 해 그러니까 품앗이 해가지고
그럼성도 큰소리헌다고 동네 싸람드리 시방꺼장도 그 소리를 허고	그러면서도큰소리 한다고 동네 사람들이 시방까지도 그 소리를 하고
보신 주 시너라 해농깨로 머 보시늘 저넴 음음 물레로 자사 가꼬 인냥 세꼬뼁이멩이라고 말해든 세꼬뼁이거튼 시를 가꼬 듬성듬성허이 감치 싱꼬 댕기고 글드마	버선기워 신어라 해 놓으니까 뭐 버선을 전에 음음 물레로 자아가지고 그냥 쇠코뚜레처럼 말하자면 쇠코뚜레 같은 실을 가지고 듬성듬성하게 감쳐서 심고 다니고 그러더구먼
메느리가 트레다가 저리 야무치게 해가꼬 저래 줘도	며느리가 재봉틀에다가 저리 야무지게 해가지고 저리 해 줘도
큰소리치고 그런다고 모두 다 다만때기 마른 마리 참말도 거짐마리라 그러고	큰소리 치고 그런다고 모두 다 담안댁의 말은 말이참말도 거짓말이라 그러고
그래도 시방 구십야사쌀 머 그제 사라가꼬 이써	그래도 시방 구십여섯 살 뭐 아직까지그제는 아직까지의 뜻살아가지고 있어
아직도 게세요	아직도 계세요
응  저 시집싸리를 데게 하셔써	저 시집살이를 되게 하셨어
그레요	아 그래요
아주	어 아주
지금 그 부부늘 또	지금 그 부분을 또
이써 이써	어 있어 있어
드따 보며는	듣다 보면은
나중에 또 다 그러 저	나중에 또 다 그러 저
다 드러바야게씀니다	다 들어 봐야겠습니다
웨냐허면 저네 조사 저히 다니다 보면 다 어르신들 말쓰믈 제 셍가게는 그	왜냐하면 전에 조사 저희 다니다 보면 다 어르신들 말씀을 제 생각에는 그
시집싸리다 안 헤따 그러데	시집살이 다 안 했다 그러데
웨냐허면	왜냐하면
제 제 셍가게 선셍님 제가 제 남편 노코 시어른들 요카면 누가 조아하게써요	제 생각에선생님 제가 제 남편 놓고 시어른들 욕하면 누가 좋아하겠어요
데부분근데 제보자가	대부분 그런데 제보자가
여 근데 그저네장년 불른 하라부지가 할 떼 수를 마니 드셔 가지고	이 그런데 그전에작년 부른 할아버지가 할 때 술을 많이 드셔가지고
어어어어어  우리 하라부지는 술 마니 드시도 나한테는 영 조케 해 근디 씨어무니가 그래만날 그리 씨아부지는 날 달개	우리 할아버지는 술 많이 드셔도 나한테는 영 좋게 해그런데 시어머니가 그래 만날 그리 시아버지는 날 달래
시어머니가 질투하싱 거에요	시어머니가 질투하신 거예요
일 잘 헌다고	일 잘 한다고
잘 하니까	잘하니까
하  아니 당시는 모타시는데	아니 당신은 못하시는데
바느지를 이러케잘하시니까	바느질을 이렇게 잘하시니까
그렁 거또 이쩨 여자들 마으미	어 그런 것도 있지 여자들 마음이
응   그러니까 네 에	그러니까 네 예
거 만날 우리 씨아바이네즘 마느레 달갤라나 나 달갤라나	그 만날 우리 시아버지는 마누라 달래랴 나 달래랴
하 중가네서 에써께써	하 중간에서애썼겠어
드레 일 허러 가먼 고상허먼 난제 바래미 인능 거이다	들에 일하러 가면 고생하면 나중에 보람이 있는 것이다
씨아재들또 그새 싸우먼 난중에 다 나가뿌림 다 네 거이다	시동생들도 그 사이에 싸우면 나중에 다 나가 버리면 다 네 것이다
항상 그래싸코 글드마 게구겐 나 몬 쌀고 나가써	항상 그래 쌓고 그러더니 결국엔 나 못 살고 나갔어
아  하  모 쌀건는디 어찌꺼이라	못 살겠는데 어쩔 거야
잘 하셔써요 하	잘 하셨어요 하
하  함께 안 상 거시 조치	함께 안 사는 것이 좋지
시방 세상 잘 마련해써	시방 세상 잘 마련했어
에  직쩌금 다들 구지든지 조뜬지 직쩌금 사능거 잘 마련해써	각자 다들 궂든지 좋든지 각자 사는 것이 잘마련했어
인제 시집싸리 항 걷 다른 저 다른 지역 껃 좀 일거반는데 야 진짜	이제 시집살이 한 것 다른 저 다른 지역 것 좀 읽어 봤는데 야 진짜
먼데 그레	뭔데 그래 음
머가 이써	뭐가 있어
어 나중에 바	어 나중에 바
에 머 그 바느질 할 떼 여러가지 머머 노코 헤야 데자나 아까 머머 노코 이러켇 헤야 데따고 그레쪼	예 뭐 그 바느질할 때 여러 가지 뭐 뭐 놓고 해야 되잖아요 아까 뭐 뭐 놓고 이렇게 해야 됐다고 그랬지요
윤디	인두
가시개 실꾸리 바늘 인자 반지끄레기 아니쏘 저네느	가위 실꾸리 바늘 이제 반지그릇이 있잖아요 전에
반지끄럭 그렁 걷 다 이씽깨 인자 반지끄렁만 인자 가따 여페 노먼  여그 요거또 이짜나요 소네다 끼고 항 거	반지그릇 그런 것 다 있으니까 이제 반짓그릇만 이제 가져다 옆에 놓으면
네  골미	골무
그거느 골미고	그것은 골무고
골미도 만 만드셔가꼬 쓰셔쪼	골무도 만 만드셔가지고 쓰셨지요
쫍짱허니 인자 해가꼬 여그 손꾸락댈만허이 해야꼬	아 좁다랗게 이제 해가지고 여기 손가락 댈 만큼 해가지고
네  인자 바늘 앙끼 드러가게 인제 좀 뚜껍께 해	이제 바늘 안 끼여 들어가게 좀 두껍게 해
네  해야꼬고 인자 또 저네느 예쀼게 또 요릳	해가지고 이제 또 전에는 예쁘게 또이리
짤라가꼬 또 해각꼬도 해고 그랜는디 우서느느 머 바뿡깨로 인자 그냥	잘라가지고 또 해가지고도 하고 그랬는데 우선은 뭐 바쁘니까 이제 그냥
손꾸랑만 인자 안 불거지고로 인자 맨드러가꼬 오고	손가락만 이제 안 불거지게 이제 만들어가지고 오고
저넨 예쁘게 또 예쁨 거슥 머 저네 공당 그렁 거까 예쁘가 쭐쭐허지	전엔 예쁘게 또 예쁘면 거시기 뭐 전에 공단 그런 것이 예뻐가지고 쭐줄하지
이럼시무그리 주 가꼬도 허고	일 없으면 그리 기워가지고도 하고
그라 요 기밥 친다고 인자 뺑 돌리 인자 또 기바블 치고 저네  그럼 이쁘게할라고 그러케 하능 거지	그리 이 귀밥 친다고 이제 뺑 돌려 이제 또 귀밥을 치고 전에
인자 각씨들 인자 예쁘게 저네 기밥 처가꼬 인자 반지륵끄륵 가에다가 싹 다라가꼬 오고	이제 각시들 이제 예쁘게 전에 귀밥 쳐가지고 이제 반지그릇 가에다가 싹 달아가지고 오고
바늘쌈도 빼 인자 바늘 요로 꼼능 거이르 인자 또 요이 예쁘게 복쑹을 해가꼬	바늘쌈도 빼어 이제 바늘 이렇게 꽂는 것이 이제 또 이 예쁘게 복숭을 해가지고
또 가에다가 인자 내를르 달고	또 가에다가 이제 레이스를 달고
에또 뺑 돌리 기바블 치고	예 또 뺑 돌려 귀밥을 치고
그래가꼬	그래가지고
예거기다 꼬자 노코	예거기다 꽂아 놓고
네  그렁 거 다 맹그러가 다라 가꼬 와찌시 우리드른	그런 것 다 만들어가지고 달아가지고 왔지 우리들은
바늘도 바늘도 마니 피료하셔껜네요	바늘도 바늘도 많이 필요하셨겠네요
저네느 신랑 찌비서 윤디 그렁 거느 또 와써 다	전에는 신랑집에서 인두 그런것은 또 왔어 다
사다 줘	사다 줘
사 가꼬 시집 오는디 다 보네 반지끄르게다가	사가지고 시집오는데 다 보네 반지그릇에다가
그럼 인자 바늘쌈 윤디 저저저저 골미 그렁거느 인자 우리가해가꼬 또 거따가 반지끄르기 오문 인자 농허고 반지끄륵허고 오먼 인자 거따 우리드리 해가꼬 또 싹 다라 가꼬	그러면 이제 바늘쌈 인두 저 저 저 저 골무 그런 것은 이제 우리가 해가지고 또 거기에다 반지그릇이 오면 이제 농하고 반지그릇하고 오면 이제 거기에다해가지고 또 싹 달아가지고
아우 시집 오실 떼	아유 시집오실 때
그걸 평셍 쓰시능 거예요 그걸로	그걸 평생 쓰시는 거예요 그걸로
인자 씬다고 해찌만 거 며 메치리나 가능가	아 이제 쓴다고 했지만 그 며며칠이나 가나
바늘 가꼬 자꼬 쑤시는디 그건 보늘	바늘 가지고 자꾸 쑤시는데 그건 바늘
안 떠러저요	안 떨어져요
또 사야지	또 사야지
그만 떠러짐	그만 떨어지면
또 만들고 응	또 만들고 응
인자 버리고 인자	이제 버리고 이제
인자 훋 머 다른 일도 바뿐디 뉘가 예삐게 그걷 기밥치고 예쁘게 그거 줄	이제 뭐 다른 일도 바쁜데 누가 예쁘게 그것 귀밥 치고 예쁘게 그것 기울
여개가 어디써 그냥	여가가 어디 있어 그냥
요리 꼽처가꼬 인자 송읃	이리 꼽쳐가지고 이제 송곳
바늘만 손꾸라가 앙 끕 뚜꼬 드러고르 맨드러 가꼬 그냥 끼고 허고 그래찌	바늘만 손가락이 안 뚫고들어오게 만들어가지고 그냥 끼고 하고 그랬지
음 바느질 할 떼 근데 바느질 하는 방버비 아까 여기는 여기는 저기	바느질할 때 그런데 바느질 하는 방법이 아까 여기는 여기는 저기
소매	소매
에뿌게 에뿌게 그냥살짝 이러케 쪼그만 훔치기도 하는데 다 그러케는 안 하자나요 다른 데는 또 그 또	예쁘게 예쁘게 그냥 살짝 이렇게 조금 훔치기도 하는데 다 그렇게는 안 하잖아요 다른 데는 또그 또
인자 두루막 그렁 거느 요론 소를	이제 두루마기 그런 것은 이런 솔기를
예  쌍 요리 한 쪼그로 여그 디야꺼느 싹 아프록 해야 데	싹 이리 한 쪽으로 여기 뒤에 있는 것은 싹 앞으로 해야 돼
디야서부터 요리 아푸로 오게롣 소를 이피야 데 뒤에서부터 이리 앞으로 오게솔기를 입혀야 돼 방향이 이써요	
방향이 이써요	아 방향이 있어요
인자 그러고 인자 여 여그 아페 인자 써픈 인자 또 요리 디로 가거로 인자요리 허고	이제 그리고 이제 이 여기 앞에 이제섶은 이제 또 이리 뒤로 가게 이제 이리하고
방향을	방향을
이  그래가꼬 싹 인잗 요릳 속 대루고	그래가지고 싹 이제 이리 속 다리고
껍떡 대루고	겉 다리고
싹 그리 대루장깨 얼매나 시가니 가야지	싹 그리다리려 하니까 어느 정도얼매나는 어느 정도의 뜻 시간이 가야지
데려 데려 가지고 그 바느지를	다려 다려가지고 그 바느질을
바느지를 인자 시리 인자 껍떠그로 안 나오구로 인자 소글 수무 떠야지	바느질을 이제 실이 이제 겉으로 안 나오게 이제 속을 숨어 떠야지
아주 근데 안 안 뜨더지게 떠야 델 꺼 아니에요 그 바느지를 할 떼	음아주 그런데 안 안 뜯어지게 떠야 될 것 아니어요 그 바느질을 할 때
난중에 또 대리고 헐라먼 그거이	나중에 또 다리고 하려면 그것이
웅깨로 우니까  빠라농 거이 인자 바느질 구녕이 점부 울지 아나	
빠라농 거이 인자 바느질 구녕이 점부 울지 아나	빨아 놓은 것이 이제 바느질구멍이 전부 울잖아
쭈글쭈글해징깨로	쭈글쭈글해지니까
예예예  그렁깨 인자 두문두문허이 그래가꼬 또 새로 싹 해 그렁깨 거 에터지지	그러니까 이제 드문드문하게 그래가지고 또 새로 싹 해 그러니까 그 애타지
그러믄 다른 데도 다 드문드문드문드문 다 이러케 헤 논능 거예요	그러면 다른 데도 다 드문드문드문 다 이렇게 해 놓는 것이어요
드문드문	드문드문
근디 요런 디는 포근 다 인자 바가 노치	그런데 이런 데는 폭은 다 이제 박아놓지
이 그릉까 이거 이거 바느질 하능 거하고	예 이 그러니까 이것 이것 바느질 하는 것하고
요거는 인자	이것은 이제
이거	이것
싹 포근 인자 윤디로 가 대루고	싹 폭은 이제 인두를 가지고 다리고
인자	이제
긍깨 저네느 바늘로 헝깨로 바늘 시 실거는 불거진다고 인자 그랜는디 인자	그러니까 전에는 바늘로 하니까 바늘 실 그것은 불거진다고 이제 그랬는데 이제
우리드른 싹 다 틀로 바가씽깨로	우리들은 싹 다 재봉틀로 박았으니까
인자 인자 요 가에 요런 디나 인자 안 거서그라고	이제 이제 이 가에 이런 데나 이제안 거시기하라고
응  자 싹 이걸 대루고	이제 싹 이걸 다리고
고부라고 대루고	곱도록 다리고
그렁 거이지	그런 것이지
이르미 바느질 여 하는 이르미 이써쓸 꺼 아니에요 바믄 나는 여기는 어뜨게  꼼꼬마게 뜨능 거는	이름이 바느질 이 하는 이름이 있었을 것 아니어요 밤은 나는 여기는 어떻게 꼼꼼하게 뜨는 것은
새끼포	새끼포
원포	원포
그래지 머	그러지 뭐
아 천 이르미	어천 이름이
다니	단이
이 요 바느질 할 떼 바느질 방는 바근다고도 허고 또 머슨	이 바느질할 때 바느질 박는다고도 하고 또 뭐는
줌는다고 그러조 줌는다 그리도 허고	깁는다고 그러지요 깁는다 그리도 하고
어 여기 오 요거이	어여기 오 이것이
요러게 요건 감친다 허고	이렇게 이건 감친다 하고
아니 또	아니 또
그 여러가지 방버비 이짜나요	그여러 가지 방법이 있잖아요
인제 요라가꼬 인제 요라가꼬 인자 두문두문허이 요리 감치가고	이제 이래가지고 이제 이래가지고 이제 드문드문하게 이리 감쳐가지고
그노문 인자 요릳 쫑쫑쫑쫑 요리 준능 거는 인자 준는다 그러고	그놈은 이제 이리 쫑쫑쫑쫑 이리 기운 것은이제 깁는다 그러고
어어  그러재	그러지
인자	이제
또 빡빠카게 이러케 하능 거는	똑 빡빡하게 이렇게 하는것은
인자 요래가꼬 인자 바근디다가 요리 뜨고 인자 또 요리 허고 또 요리 허고 인자 요래 가능 걷 방는다 그러고	이제 이래가지고 이제 박은 데다가 이리 뜨고 이제 또 이리 하고 또 이리 하고 이제 이래 가는 것 박는다 그러고
방는다 그러고	아 박는다 그러고
그 다메 또 솜 너코 할 하능 거느 또 머라고 하고	그 다음에 또 솜 넣고 할하는 것은 또 뭐라고 하고
이불 가틍 거슨 머라고 이불 헐 떼 그 여르케 길게 이르게 상 요로케 하능거	이불 같은 것은 뭐라고 이불 할 때 그 이렇게 길게 이렇게 상 이렇게 하는 것
솜 너코	솜 넣고
요거	이것
이러케 길게	이렇게 길게
이부른	이불은
게속	계속
이부른 호창 가틍 거	이불은 홑청 같은 것
요건 인자요거 보고 머라핸니	이건 이제이거보고 뭐라 했니
겨우레 인제 솜 느코	겨울에 이제 솜 넣고
이  니빈다고	누빈다고
니비능 거야 니비능 거느 총총허능 거이 니비고	누비는 거야 누비는 것은 총총하게 하는 것이 누비고
고거 보고 머라 핸니라 고또 이저분네	그것보고 뭐라 했느니라 그것도 잊어 버렸네
음음  이  어어  시찌미요	시침이오
시튼다 그래	시친다 그래
시튼다고 시침 시침	시친다고 시침 시침
요걸 보고 시치미라	이걸 보고 시침이야
아  한 바늘썩 요래가꼬 또 요오그 와서	한 바늘씩 이래가지고 또 여기 와서
어  또  요로고	이렇게
요거 시침헌다 그래	이것 시침한다 그래
시침헌다	시침한다
응  그러조	그러지요
시튼다란 말도 이써요 시튼다	시튼다란 말도 있어요 시튼다
시튼다 그러기도 허고	시튼다 그러기도 하고
거 시침한다고도 허고	아 그 시침한다고도 하고
시터야지 그거느	어 시터야지 그것은
시터야지	아 시터야지 아
시트다는 마리 인네	시트다는 말이 있네
그레가꼬 빨레도 빨 빨레 그거 아까터가꼬 또 빨레헤야 덴다고 헤짜나요	그래가지고 빨래도 빨 빨래 그거 아까터가지고 또 빨래해야 된다고 했잖아요
빨레 할라문 또 빨레 하능 거시 명주하고	빨래하려면 또 빨래하는 것이 명주하고
요론디 요 도른 요론디 노인들 이버 노머 여여여 도런 요런디가 저네멩오슨 때가 안 저	이런 데 이 도련 이런 데 노인들 입어 놓으면 이이이 도련 이런 데가전에 무명옷은 때가 안 져
네  긍개 여	그러니까 이
네  조르르이	조르르하게
예예예예  하이 요거를 요거 안 지여따고 또	하이 이것을 이것 안 지웠다고 또
메 저저저저 저네 꺼멍 비누	뭐 저 저 저 저 전에 검정 비누
지그므힌 비누제만 저네 꺼멍 비누 꺼멍 비누 요만헌 그거를 반트로 쫑글라 줘 돈 안 들라이라고	지금은 흰 비누지만 전에 검정 비누 검정 비누 이만큼 한 것 그것을 반으로 잘라쫑글다는 자르다의 뜻 줘 돈 안 들이려고
반트로 요리 쫑글라 주머 반쪼가리 그노믈 가꼬 시방 가트문 싹뚜디리뿌리나찌안 살고 가지 그 몬 모내	절반으로 이리 잘라 주면 반 조각그놈을 가지고 시방 같으면 싹 두드려 버리고 나갔지 안 살고 가지 그 못 못 해
그거이 그래 줌스렁 인제 또 차나락찝 그걸 인자 지 무를 소테다 무를 부꼬 인자그걸 인자 한다발 가따 데피	그것이 그래 주면서 이제 또 찰벼짚 그걸 이제 물을 솥에다 물을 붓고 이제 그걸 이제 한 다발 가져다 덥혀
데피문 인자 따따더이 물 뎅 그노믈 인자 또 그르게다 퍼 노코 우예다가 인자시리예다가	덥히면 이제 따뜻하게 물 데운 그놈을 이제 또 그릇에다 퍼 놓고 위에다가 이제 시루에다가
저네 사그시리	전에 사기 시루
시방은 머 수댕도 이꼬 머또 이꼬	시방은 뭐 스테인리스도 있고 뭐도 있고
저리 조응 거 쌔찌만해도 사그시리 그걸 가따가 인자 인자 옴막헌 요리 쎄소테다가 거따가 안차 노코	저리 좋은 것 쌨지마는사기 시루 그걸 가져다가 이제 이제 오목한 이리 쇠솥에다가 거기다가 안쳐 놓고
인제 미테 불 땡 거 그거 차나락찌피 인잠 재무리 마이 나온다요	이제 밑에 불땐 것 그것 찰벼짚이 이제 잿물이 많이 나온대요
음  금 차나락찝 그노믈 인제 미테다가 함 한다발 가따가 인자 그 물 데핀서룽 인제때노머 물 그놈 인자 묻	그러면 찰벼짚 그놈을 이제 밑에다가 한 한 다발 가져다가 이제그 물 덥히면서 이제 때어 놓으면 물 그놈 이제 묻
뜨근뜨근 안 허요이우예 미테다가 차나락찝 그거를 꼬실라 농깨 그러먼	뜨끈뜨끈하잖아요 위에 밑에다가 찰벼짚 그것을 불살라꼬시르다는 불사르다의 뜻놓으니까 그러면
그걸 인자 요리 따로 퍼내 노코	그걸 이제 이리 따로 퍼내 놓고
인제 미테다가 인자 저거 머이냐 저네느 시리르라고 저거	이제 밑에다가 이제저기 뭐냐 전에는 시루라고 저거
저 깔바테 그거 그걸 보고 머라 핸냐또 야커디 야컹 그걸 보고 머 머이라 핸니 시방	저 갈대밭에그것 그걸 보고 뭐라 했니 또 약하디약한 그걸 보고 뭐 뭐라 했니 시방
노 노끄늘 인자 가꼬 영꺼 시리 미치라고 인제 떡 찜성도 허고 인자 그노믈 인자 원 너나노코	노 노끈을 이제 가지고 엮어 시루밑이라고 이제 떡 찌면서도 하고 이제그놈을 이제 애초에 넣어 놓고
구예다가 인잔 집 꼳 미테 직 저 재 그노믈 차나락째 그노믈 인자 옫 시리에다항걷 퍼부우	그 위에다가 이제 짚 밑에 저 재 그놈을 찰볏재 그놈을 이제 곧 시루에다 한껏 퍼부어
퍼부가꼬 인자 뜨근뜨근흔 그노믈 인자 자꼬 요리 퍼부어 인자	퍼부어가지고 이제 뜨끈뜨끈한 그놈을 이제 자꾸 이리 퍼부어 이제
거먼 미테치 그거이 재무리라고	그러면 밑에 치 그것이 잿물이라고
거따가 인자 빨래르 인자 주물라	거기에다가 이제 빨래를 이제 주물러
예예예  시방 수뻐따이메이로	시방 수퍼타이처럼
주물라 가꼬 인자	주물러 가지고
줄때 인자 그거이 때질 꺼이라고 요만침 떼 준 그노믈 가꼬 여그 인자	지울 때 이제 그것이 때가 질 것이라고 이만큼 떼어 준 그놈을 가지고 여기 이제
오썸 머 도련 요런디 주울 때 그놈 지우라는디 빨래르 그거 머 온제 거서 이고건서글 빨래가 두 통이나 데는디 그거 항 개 가꼬 머으 그거를 다 지우꺼이라	옷 섶 뭐도련 이런 데 지울 때 그놈 지우라는데 빨래를 그것 뭐 언제 거기서 이고 식구를 빨래가 두통이나 되는데 그것 한 개 가지고 뭐 그거를 다 지울거야
덜 지여가꼬 소테 인제 쇠죽소테느 인자 캐카리 쇠죽 써주는 소츨 인자 깨끔씨꺼가고 인자 거따 쌀마	덜 지워가지고 솥에 이제 쇠죽솥에는 이제 깨끗하게 쇠죽 쒀 주는 솥을 이제 깨끗하게 씻어가지고씨끄다는 씻다의 방언형이제 거기에다 삶아
빨래르 인자 멩옫 그렁 거 인자 쌀무머 주울 때 그걷 앙거스 해따꼬 또 부작때르가 싹 주 떤지비리	빨래를 이제 무명옷 그런 것 이제 삶으면 지울 때 그것 안 거시기했다고 또 부지깽이를 가지고 싹 집어 던져 버려
새로 시끄라고 거 멀 가꼬 또 시끄꺼이라 그럼성	새로 씻으라고 그 뭘 가지고또 씻을 거야 그러면서
인제 게심타고 인자 비누 반동가리 그노미라도 또 줌스렁 씨끄라문 허는디 그노믈 인자 보리끋	이제 괘씸하다고 이제 비누 반 동강 그놈이라도 또 주면서 씻으라면 하는데 그놈을 이제 버리고
이런 세멘바닥딴 뻘 빠다게다가 그걸 주 떤지노먼 그놈 가따 씨끌라먼 눔무리 허 한숨	이런 시멘트 바닥이나 개펄 바닥에다가 그걸 집어 던져 놓으면 그놈 가져다 씻으려면 눈물이  허 한숨
인자 우러매느 먿헐라고 날 나가꼬 요런디다 보내 노코는 우러	이제 우리 엄마는 뭐 하려고 나를 낳아가지고 이런 데다 보내 놓고는 울어
그러고 사라	그렇게 살아
저네느 싸게라	전에는 산 거야
그런 에기도 하더라구요 겨우레 어르신드리 오딥꼬 그 서플 보메 빨라고 보무 이가 아를	그런 얘기도 하더라고요 겨울에 어르신들이 옷 입고 그 섶을 봄에 빨려고보면 이가 알을
요런 똑 이도 요런 모서리에 요런디다가 씰커등	이런 꼭 이도 이런 모서리에이런 데다가 슬거든씷다는 슬다의 방언형
인자 굴근 놈부터 자바	이제 굵은 놈부터 잡아
톰방니부터 인자 톰방니라 그러고 갈강니라 그러거등	톰방니부터 이제 톰방니라 그러고 갈강니라 그러거든
큰 이를 머라 그레요	어 큰 이를 뭐라 그래요
톰방니	톰방니
글고 자긍 거슨	아 그리고 작은 것은
가가 가강니	가가 가강니
우수붕깨 눔무리 나네	아 우스우니까 눈물이 나네
시방 그런 닐 엄찌	시방 그런 이 없지
굴긍 거이 아페 게강깨 그놈부터 자바	굵은 것이 앞에 기어 가니까 그놈부터 잡아
네 듀 애기들또 인자 어른더리 자주 인자 요리 거세해 준 사라믄 근디 머리도안 깽기가꼬아이들도 이제 어른들이 자주 이제 거시기해 준 사람은 그런데 머리도 안감겨가지고  요리 떠드르무 흑해 쎄까레가	
요리 떠드르무 흑해 쎄까레가	이리 떠들면 하얘 서캐가
거기에도 요리 디끼무 이가 출출출출 에이고	거기에도 이리 뒤집으면 이가 출출출출 아이고
왜 그래쓰까 저네느 안 씨꺼 이붕깨 더러버서 그러꺼이여	왜 그랬을까 전에는안 씻어 입으니까 더러워서 그럴거야
그러지요	그러지요
예예  굴근 놈부터 인자 디시 오슬 디시노먼 인자 궁거 불부게이랑 그놈부터 이리 지기머 손티비 빌그레	굵은 놈부터 이제 뒤집어 옷을 뒤집어 놓으면 이제 굵은 것 불부게이랑 그놈부터 이리 죽이면 손톱이 불그레해
빌그러고 인자 큰놈 싹 자꼬나문 인자	불그레하고 이제 큰놈 싹 잡고 나면 이제
요리 인자 장 거	이리 이제 잔 것
잔니 요리 자꼬나머 인자 요런디다 또 쎄로 씨러나	잔 이 이리 잡고 나면 이제 이런 데다 또 서캐로 슬어 놔
쎄 씨러논 그노믈 인자 종제기 부레다가	서캐 슬어 놓은 그놈을 이제 종지 불에다가
요리 꾸실먼 또드락또드락또드락 해	이리 불사르면 또드락또드락또드락 해
드러 이써서	아 들어 있어서
그러고 인자 저기 저 할매드른 이잔 누니 어두버 안 베잉깨 그냥	어그리고 이제 저기 저 할멈들은 이제 눈이 어두워 안 보이니까 그냥
으  또드락또드락또드락해 그냥 씨부머	또드락또드락또드락해 그냥 씹으면
근데 제 살에서	그런데 제 살에서
긍데 이릉 거이다고 안 더럽떼	그 이제 인 것이라고 안 더럽대
아니 아니 근데 할머니들 이도 업쓰실텐데 어떠케 이로	아니 아니 그런데 할머니들 이도 없으실 텐데 어떻게 이로
이 항 개씩 인는 그노믈 가꼬 요래가꼬 욜욜 요로무 그냥 또드락또드락또드락 허이 그래	이 한 개씩 있는 그놈을 가지고 이래가지고 이리 이리 이러면 그냥 또드락또드락또드락 하게 그래
인자	아 이제
제 사레서 나옹 거이라고 안 더럽따고	제 살에서나온 것이라고 안 더럽다고
하 인제 누넌 어둡꼬 모짭꺼꼬 그렁깨 시방거치 그젇 도빼기도 흔허고 그러지마느	하 이제 눈은 어둡고 못 잡겠고 그러니까 시방처럼 그저 돋보기도 흔하고 그러지마는
저네느 머 도빼기도 엉꼬 이는 베기도 안 허고 헝깨 무조껀 씸능 거이라 그냥	전에는 뭐 돋보기도 없고 이는 보이지도 않고 하니까 무조건 씹는 거야 그냥
더럽찌 참 저네 시방 다 장가지꺼이네	더럽지 참 전에 시방 다 까무러칠 것이네
다 장가지꺼이라 그렁거이	다 까무러칠 거야 그런 것이
애기들또 좀 일 바뿌고 그런 집 애기드른 보머 그냥 요로무 그냥 쎄가 이 끄터리에 이가 그냥 뻬따따헌 베테 인능 지므 이가 우로 올러와가꼬 성글서글서글성글 요리게댕기고 그래써요 저네느	아이들도 좀 일 바쁘고 그런 집 아이들은 보면 그냥 이러면그냥 서캐가 이 끝에 이가 그냥 볕 따뜻한 볕에 있는 집은 이가 위로 올라와가지고 성글성글성글성글 이리 기어다니고 그랬어요 전에는
그무 인자 참비뒈	그러면 이제 참빗에
저네느 그거이 참비치 먼 남자그러 그거 이 쎄 쎄 잠능 거이라 그래	전에는 그것이 참빗이무슨 용도냐 하면 그것 이 서캐 서캐 잡는 것이라고 그래
인자 그거를 인자 요리 그걸가 요리 비티문 굴근 이는 요리 떠러진디 쎄가 안떠러지거등	이제 그것을 이제 이리 그걸 가지고 빗으면 굵은 이는일 떠러지는데 서캐가 안 떨어지거든
그러문 인잗 실 그노믈 가꼬 요리저리요리 영꺼	그러면 이제 실 그놈을 가지고 이리저리이리 엮어
영꺼가꼬 인자 요러먼 망 머크레이 반쯤 빠질꼬 그냥 그리 그러머 인자 쎄가 흑허니 인자 그래가꼬 인자	엮어가지고 이제 이러면 막 머리카락이 반쯤 빠지고 그냥 그리그러면 이제 서캐가 하얗게 이제 그래가지고 이제
요로먼 인제 쎄가 흑허머 그냥 망 요리 지머 또드락또드락또드락 해 머리에도	이러면 이제 서캐가 하얗게 그냥 막 이리 지면 또드락또드락또드락 해 머리에도
저넨 더러께 사라써	전에는 더럽게 살았어
참  더러끼도 헤찌만 얼마나 가려와쓰까요	더럽기도 했지만 얼마나 가려웠을까요
근 똑 비리 오릉거멩이 시방 곡썩 비리 오리먼 안 크데끼	그 꼭 진딧물 오른 것처럼 시방 곡식 진딧물 오르면 안 크듯이
어  그러치먼	그렇지 뭐
그러치	그렇지
긍깨 저네 싸람드른 사람도 얄구꼬	그러니까 옛사람들은 사람도 얄궂고
시방은 어디 미분 사라미 어디 이써	시방은 어디 미운 사람이 어디 있어
사리 통통 찌고	살이 통통 찌고
응    몬 미긴 사람드른 불거지고 머 어디 쪼그라지고 말짱 그러코	못 먹인 사람들은 불거지고 뭐 어디 쪼그라지고 말짱 그렇고
인는 지 싸람드른 좀 반질반질허고 저네는 글 안 해써	있는 집 사람들은 좀 반  질반질하고 전에는 그렇지 않았어
저네 산 이야글 허머 먼 말도 몯해지	아 전에 산 이야기를 하면 무슨 말도 못하지
그레가꼬 인제 그러케 빨레를 헤가꼬 와서 어찌데건 다 빠라 가꼬 인제 어떠께헤야데꺼 아니에요	그래가지고 이제 그렇게 빨래를 해가지고 와서 어떻든 다 빨아가지고이제 어떻게 해야 될 것 아니어요
이 너러 몰류머	아 널어 말리면
너러 몰랴가꼬 인자 또 푸를 끼리가꼬	널어 말려가지고 이제 또 풀을 끓여가지고
저네느 대궁밀 시방 대궁물라 키 킁 거 저 사네 군디 갈데여	전에는 대국밀시방 대국밀이라 키 큰 것 저 산에 그런 데 갈데요
그걸 인자 한 떼기썩 인자 가라 인자 받 한 자리썩	그걸 이제 한 뙈기씩 이제갈아 이제 밭 한 자리씩
갈먼 그건 따로 해가꼬 그노믈 인제 무를 부어가꼬 써콰	갈면 그건 따로 해가지고 그놈을 이제 물을 부어가지고 썩혀
써쿠먼 그거이 요리요리 주무리문 거기에서 흐거이 알만 빠지고 인자 체에다가걸러서 인자 껍떠근 걸러 내삐리고 나먼 그걸 인자 또 우라 인자 무	썩히면 그것이 이리이리 주무르면 거기에서 하얗게 알만 빠지고 이제 체에다가 걸러서 이제 껍질은 걸러 내버리고 나면 그걸 이제 또 우려 이제 무
거 흐건 가리 인자 빠징 그거를 인자 뚬물 거틍 거이 나오먼 그노믈 우라가꼬 메뻔 우라노먼 흑해	그 하얀 가루 이제 빠진 그것을 이제 뜨물 같은 것이 나오면 그놈을우려가지고 몇 번 우려 놓으면 하얘
흑허먼 인자 그걸 끼리노먼 끼리가꼬 인자 푸를 미기고	하야면 이제 그걸 끓여 놓으면 끓여가지고 이제 풀을 먹이고
또 밀까리	또 밀가루
밀까리 푸를 끼리가꼬 인자 또 그러고인자 또또 먿 헌 지비느 인자 좀 인는 지비느 인자	밀가루 풀을 끓여가지고 이제 또 그러고 이제 또 또 뭐 한 집은 이제 좀 있는 집은 이제
풀 매라고 요새 왜 쪼까너이 풀 매고 압쭈딩이 요리 흐리능 거 아니씹띠여	풀매라고 요새 왜 조그맣게 풀 매고 앞 주둥이 이리 흐르는 것 있잖습디까
그거 인자 또 싸를 인자 부라가꼬 거기에 매또라 풀 매다 가서 가라가다가 인자  또 끼리가꼬 미기고	그것 이제 또 쌀을 이제 불려가지고 거기에 맷돌에 풀 매다 가서 갈아다가 이제 또 끓여가지고 먹이고
하  거 대궁물 우랄 떼는 무레다가 이러케	그 대국밀 우릴 때는 물에다가 이렇게
여러가꼬	열어가지고
그거는 인자 여르므로 마니 허지 잘 써긍깨	그것은 이제 여름으로 많이 하지 잘 썩으니까
그래 인자 우라가꼬 그노믈 또 푸를 끼리가꼬 인자 삼베옫 그런 디는 미이가꼬인자 막	그래 이제 우려가지고 그놈을 또 풀을 끓여가지고 이제 삼베옷 그런 데는 먹여가지고 이제 막
손질헌당 거이 그냥 쪽쪽 훌터 인자	손질 한다는 것이 그냥 쪽쪽 훑어 이제
저긷 간지떼에다가 인자 끼쓰 끼 너러노코 막 요로 훌터 글먼	저기 간짓대에다가 이제 꿰어 널어 놓고 막 이렇게 훑어 그러면
막 빠빧허먼 그노믄 시바는 쑤씨싸서 꺼끄라서 아무도 안 이브 꺼여	막 빳빳하면 그놈은 시방은 쑤셔 쌓아서 거칠어서 아무도 안 입을거야
좀 뻐뻗허면 그거 가꼬와가꼬 또 이러케	좀 빳빳하면 그것 가지고 와가지고또 이렇게
하 또 뚜디리고 긍깨 인잗 여르메는 뚜디리문 구닝이 매킹깨 덥꺼등	하 또 두드리고 그러니까 이제 여름에는 두드리면 구멍이 막히니까 덥거든
그렁깨 인제요리 소느로 훌터	그러니까 이제 이리 손으로 훑어
이러케	아 이렇게
망 요리로 막 요리 안 거서근 디는 막 요래 가꼬 요리허고	막 이리로 막 이리거시기 한 한 데는 막 이래가지고 이리 하고
또 인제 요런 디는 인자 요리 훌꼬	또 이제 이런 데는 이제 이리 훑고
그러곤 그러고 인자 종 곱께 헐라먼 인자 정때로 인자 숟 대래비에다가 은자 잉그락뿌를 다마가꼬 인자 막 대루고 하나느 잡꼬 이꼬 하나느 대루고	그리고는 그리고 이제 좀 곱게 하려면 이제  이제 숯 다리미에다가 이제 잉걸불을 담아가지고 이제 막 다리고 하나는 잡고 있고 하나는 다리고
시방은 왕구에서 수월치이 왕구에도 수월치 점드리 그걷허다 마라 그렁깨	시방은 천하에 수월하지 천하에 수월하지 저물도록 그것 하다 말아 그러니까
점드리 그걷허다 나옹개 잠 잘 여개도 엉꼬	저물도록 그것 하다 나오니까 잠  잘 여가도 없고
게다가 따진디 머 어디 째진 디 그런 디 또 저 밤새도록 또끼매 이페야재	게다가 떨어진 데 뭐 어디 째진 데 그런 데 또 저 밤새도록 또 꿰매어 입혀야지
사리 안 나오게 끼매 이페야재 긍깨 잠 잘 여개도 엉꼬	살이 안 나오게 꿰매어 입혀야지 그러니까 잠 잘 여가도 없고
긍깨 메트리드른 주글 이리야 주글 일 그래도 어르니라고 먼 소리를 허고 어르니라고 메느리 시기 노고 주구는 놀로 댕기고	그러니까 며느리들은 죽을 일이야 죽을 일그래도 어른이라고 무슨 소리를 하고 어른이라고 며느리 시켜 놓고 저희는 놀러 다니고
아이고 고셍헤께따	아이고 고생했겠다
예예 또  여름 삼동으로는 인자 그노믈 싹 푸렁 그걸 꺼드르머 인자 또 와서 개 가꼬	여름 겨울로는 이제 그놈을 싹 풀 한 그걸 꺼들면 이제 또 와서 개어가지고
싹 방망이르 가꼬 뚜디리야 데	싹 방망이를 가지고 두드려야 돼
예예  겨우레만 뚜드링 거예요	겨울에만 두드리는 거예요
응  그러면 여르멘안 뚜드리고	그러면 여름에는 안 두드리고
여르멘 안 뚜두디리고	예 여름엔 안두드리고
아이구 아무떼나 두드리는 줄 아라써요 저는	아이고 아무 때나 두드리는 줄 알았어요 저는
여르메느 뚜두리 노먼	여름에는 두드려 놓으면
응  구녕이 매킹깨	구멍이 막히니까
근데	그런데
따드마노먼 구닝이 매킹깨	다듬어 놓으면
모시옫 가틍 경우는 풀 메겨 가지고 이러케 뚜두리지 안나요 여르메도 모시옫	모시옷 같은 경우는 풀 먹여가지고 이렇게 두드리지 않나요 여름에도 모시옷
모시오또 인자 요리 훌터가꼬 대라 그냥	음 모시옷도 이제 이리 훑어가지고다려 그냥
여르메느 구녕 매킨다고 안 뚜드리요	여름에는 구멍 막힌다고 안 두드려요
허긴 이러케 풀 머겨 가지고 야깐 말려서 쪼끔 꾸득꾸득할 떼	하기는 이렇게풀 먹여가지고 약간 말려서 조금 고슬고슬할때
하  요리요리 인자	이리 이리 이제
아니  시방  이러케 이러케 저버서	이렇게 이렇게 접어서
저버 가꼬	접어가지고
게 가지고	개어가지고
처네다 이러케 싸서 발로	천에다 이렇게 싸서 발로
이러케 밥떠라고요	이렇게밟더라고요
그릉깨	그러니까
인자 구녕 매킨다고 방망이지른 안 해 여름오슨	이제 구멍 막힌다고 방망이질은안 해 여름옷은
여름오슨 방망이질 안 하고 겨울온만	아 여름옷은 방망이질 안하고 겨울옷만
에  혹씨 염섹 가틍 거또 헤 보셔써요 세깔 옫 세 물드리능 거	혹시 염색 같은것도 해 보셨어요 색깔 옷에 물 들이는 것
하 저네 물깜 가꼬	아무렴 전에 물감 가지고
비 비단 저구리 그렁거	비 비단저고리 그런 것
어뜨 어떠케 먿 무슨 세글 드리셔써요	어 어떠 어떻게 뭐 무슨 색을 들이셨어요
아이 부농새기랑 머 배추색	아이 분홍색이랑 뭐 배추색
그렁 거인제 물 끼리가꼬	그런 것 물 끓여가지고
물까믄	물감은
저네는 물까믄 인젇 장어 장에 가몬 모두 포라써	전에는 물감은 이제 장에 장에가면 모두 팔았어
장에서 파능 건만 물깜 쓰셔써요	장에서 파는 것만 물감 쓰셨어요
저네는 함 물 허먼 물 빠저 뿌리여	전에는 한 물 하면 물 빠져 버려요
어떵 거 물깜	어떤 것 물감
장에서 물깜 그거는	장에서 물감 그것은
인자 사 가꼬 와서 인자 그르게다 노꼬 인자 비단옫 그렁 걸 인자 적씨먼	이제 사가지고 와서 이제 그릇에다 놓고이제 비단옷 그런 걸 이제 적시면
응  인자 빨강걷 허머 빨그레 은자 부농이 데고	이제 빨간 것 하면 불그레해 이제분홍이 되고
또 배추삭 물 도라무 배추삭 물 주문 인자 또 그	어 또 배추색물 달라면 배추색 물 주면 이제 또 그
벧 베 나 이꾸 잔대로 새까를 도래가꼬	베 나 입고 싶은 대로 색깔을 달라 해가지고
인제 비단옫 씨꺼가꼬	이제 비단옷 씻어가지고
또 물 디리가 근자 저구리 그렁 거 끼미가꼬 이꼬 또 빨문 또 무른 다 날라가 뿌리고 뽀라저 뿌리고 흑해	또 물 들여가지고 이제 저고리 그런 것 꿰매어 가지고 입고 또 빨면 또 물은 다 날아가 버  리고 바래져 버리고 하얘
그레요	아 그래요
그러무 또 새로 또또또 딴 물 드리고 자문 또 딴 물 디리고 저네는 그래쪼	그러면 또 새로 또 또 또 딴 물 들이고 싶으면 또 딴 물 들이고 전에는 그랬지요
오오  물 거기서 물깜 사서 드리는 거 말고 풀 가틍 거 뜨더다가 물드려 보고 그러시기도 헨나요	물 거기서 물감 사서 들이는 것 말고 풀 같은 것 뜯어다가 물들여 보고 그러시기도 했나요
그렁 건 안 해 바써	그런 건 안 해 봤어
머 치자 따다가	어 뭐 치자 따다가
지자	
지자	치자
지자라고 지자 그거 따다가도 허고	치자라고 치자 그것 따다가도 하고
먼 무슨 세기 나와요 그러면	무슨 무슨 색이 나와요 그러면
지자 새까른 주왕색 방사하이 그래	치자 색깔은 주황색 방사하게 그래
아  지자새근	치자색은
또 다릉 거또 또 인나요	또 다른 것도 있나요
인제 또 감물	이제 또 감물
감물	아 감물
감 가믄 꺼뭉깨르잘 안 디리요	감 감은 까마니까 잘 안 들여요
지그므 점부 감물 디리가꼬 모도 여그요	지금은 전부 감물 들여가지고 모두 여기요
입떼	입데
여기선 잘 안 드려써요	여기선 잘 안 들였어요
또 또 물 엄씸 또 항투	또 물 없으면 또 황토
항투	황토
이제 도니 엉꼬 거시건 사람드른 또 항투로 파다가 또 무를 디리가꼬	이제 돈이 없고 거시기한 사람들은 또 황토를 파다가 또 물을 들여가지고
네  긍깨 방치기 요거느 한 먿 대야싸 이부머 그럼 인자 도로 씽능 거 그거 또 빨무도로 흑해저 뿌리고	그러니까 방치기 이것은 한 뭐 대엿새 입으면 그럼 이제 도로 씻는것 그것 또 빨면 도로 하얘져 버리고
그랜 그래가	그래 그래가지고
요세는 건강에 조타고 황토를 하더라고요	어 요새는 건강에 좋다고 황토를 하더라고요
저네 우리들 클 때느 항투무를 무그머 페뼁 걸린다고	전에 우리들 자랄 때는황토물을 먹으면 폐병 걸린다고
저 바테 저런 디그 가도 울 엄니허고 두리 우리 친정 어매하고 두리 가서 바츨매먼 당시느 무금성 나는 몬 무께 해	저 밭에 저런 데 가도 우리 엄마하고 둘이 우리 친정엄마하고 둘이 가서 밭을 매면 당신은 먹으면서 나는 못 먹게 해
황토를	황토를
무리 밤 매다 무리 데게 모기 갈라서 무글라먼	물이 밭매다 물이 되게 목이 갈려서 먹으려면
물 누군디 바까에 물 나는 디가 인는디	물 먹는 데 밭 가에 물 나는 데가 있는데
아드른 그렁 거 무문 페뼝 든다고몸 무께 허드마 지그믄 머 점부 항투무를 무잠 해 가꼬 따라 묵떼요 허	아이들은 그런것 먹으면 폐병 든다고 못 먹게 하더구먼 지금은 뭐 전부 황토물을 먹고 싶으면 해가지고따라 먹데요 허
응  네는 묵찌마라 절믕 거이	너는 먹지 말아 젊은 것이
혹씨나 페뼁드러노문 누 페뼁은 절문뉼 절렴덴다고 누구 헹제드간들꺼지 망신시긴다고 절때조 몸 무께해	혹시나 폐병 들어 놓으면 폐병은 젊은  전염된다고 너희 형제들까지 망신 시킨다고절대 못 먹게 해
바테 가도	밭에 가도
넨 지비 가서 차마 가 지비 가 무거라	너는 집에 가서 참아가지고 집에 가서 먹어라
이걸 어머 어매느 그래 엄마느 저네느 어매라 헝깨 어매느 왜 뭉냐 그러무 나느늘거씽깨 주거도 갠찬나	이걸 엄마 엄마는 그래 엄마는 전에는 어매라 하니까 어매는 왜 먹느냐고 그러면 나는 늙었으니까 죽어도 괜찮다
니느 지비 가서 무거라	너는 집에 가서 먹어라
음  늘거씽깨 무리 무 모메 무리 몰라서 나느 모기 몰라싸치만 누군 안중 에린디먼 무를 무거야고 함부로 몯 몸 무께 해	늙었으니까 물이 몸에 물이 말라서 나는 목이말라 쌓지만 너희는 아직 어린데 무슨 물을 먹느냐고어야는 느냐의 뜻 함부로 못 먹게 해
그런디 지그믄 머 항투무를 무장 머 해무 맨드라 뭉는디 머	그런데 지금은 뭐황토를 먹고 싶으면 뭐 해먹 만들어 먹는데 뭐
또 혹씨 파랑섹 가틍 걷또 드리셔써요 풀 비여다가 파랑섹 가틍 거또 드려짜나요 이까	또 혹시 파랑색 같은 것도 들이셨어요 풀 베다가 파랑색 같은 것도 들였잖아요 그러니까
인자 하무 어떤 사람드른 보리도 베다가	이제 아무렴 어떤 사름들은 보리도 베어다가
보리요	보리요
그먼 무슨 세기 나와요	어 그러면 무슨 색이 나와요
인잗 배추색 방사허이 그러치 그렁 거는 아니삐	이제 배추색 방사하게 그렇지 그런 것은 안 이뻐
잘몯 허무 그냥 얼루기 지고 그릉깨 몰라 우리드른 너무느 그래썬 그렁 걸 그래가 글 해도	잘못 하면 그냥 얼룩이 지고 그러니까 몰라 우리들은남은 그랬었는지 그런 걸 그래가지고 그렇게 해도
우리진 어무니는 우리 친정 어무니느 저 점부 사다주문	우리집 어머니는 우리친정어머니는 저 전부 사다 주면
디리가꼬 해 이버	들여가지고 해 입어
장에 가서 사 가지고	장에 가서 사가지고
응  그러고 우리 여여 시집 와서느 인자 또	그리고 우리 이 이 시집와서는 이제 또
인자 그 때느 실랑이재	이제 그때는 신랑이지
실랑이 장사를 헝깨	신랑이 장사를 하니까
네  인제 자파 장수를 해 농깨 인자 허고 시푸문 쫌 도라 그러무 쪼깐 가따주문 디리가야 해주고	이제 잡화 장사를해 놓으니까 이제 하고 싶으면 좀 달라 그러면 조금 가져다 주면 들여가지고 해 주고
아까 그 빨레 쌀무실 떼에	아까 그 빨래 삶으실 때에
그 젠물 만드능 거 말씀 하션는데	그 잿물 만드는 것 말씀하셨는데
제 젠물 젠물 만드능 거한번 더 말씀 헤 주세요 멀 멀로 만드러써요 젠무를	재 잿물 만드는 것 한번 더 말씀해주세요 뭘 뭘로 만들었어요 잿물을
긍깨 차나락찝	그러니까 찰벼짚
응 그냠 다릉 거 차나락찝 말고	응 그냥다른 것 찰벼짚 말고
찹쌀  긍깨 집 그어까꼬 허지	그러니까 짚 그것 가지고하지
다른 거슨 안 하고	어 다른 것은 안 하고
다릉 건 안	다른 건 안
그거시 제일 조아요	그것이 제일 좋아요
네  그거이 인자	그것이 이제
빨래문 인자 따따데니 물 데피가꼬 인자 퍼내 노코 헝깨	빨려면 이제 따뜻하게 물 덥혀가지고 이제 퍼내어 놓고 하니까
네  미테 물 데인 그 차나라그 재를 그냥 시리에다 퍼부어가꼬 거 물 디엥거 인자 퍼내나따 그노믈 자꼬 인자 퍼부움먼	밑에 물 데인 그 찰벼의 재를 그냥 시루에다 퍼부어가지고 그 물 데인 것 이제 퍼내 놨다가 그놈을 자꾸 이제 퍼부우면
인제 무리 뚝때 따따데이 그르먼 뜨근뜨근허이 그르먼 인자 거따가 인자 빨래르여코 막 주물라 가꼬 가서 씨꼬 그래찌	이제 물이  따뜻하게 그러면 뜨끈뜨끈하게 그러면 이제 거기에다가 이제 빨래를 넣고 막 주물러가지고 가서 씻고 그랬지
그걷 말고 젬물 말고 또 머 양젠물도	그것 말고 잿물 말고 또 뭐 앵잿물도
양재무른 인제 사 가꼬 와야 데고	양잿물은 이제 사가지고 와야 되고
사가꼬 하능 거	사가지고 하는 것
전 양젬무른 항상 그 누가 양젬물 마셔따고  하 그레아 젬무른 안 죽찌요	전 양잿물은 항상 그 누가 양잿물 마셨다고  하 그래야 잿물은 안 죽지요
그니까요	
그 외 양 양젬무른 주그니까	그 왜 양 양잿물은 죽으니까
양잼요요 요거이사 머 중능가	양잿이이 이것이야 뭐 죽나
양재무른 무거도 저네	양잿물은 먹어도 전에
농약또 엉꼬 그렁깨 아먼	농약도 없고 그러니까 그러면
자살허구잔 한 사람들 양재무를 무꼬	자살하고 싶은 사람들 양잿물을 먹고
마니 안 주거쏘	많이 죽었잖소
잔물보다 양젬무리 저 더 잘 빠져요	잿물보다 양잿물이 저 더 잘 빠져요
하이고 양재무른	하이고 양잿물은
전내기 안 대요	전내기 안 돼요
전내기는 바로 그 손 사리구닝이 파이삔는디	전내기는 바로 그 손 살이 구멍이 파져 버리는데
그레요 그며는	아 그래요 그러면은
전네기가 머예요 안 탕 거약 물 안 탕 거	전내기가 뭬예요 안 탄 것 약 물 안 탄 것
지금 똑 저 저그 저 저 사탕 그렁 거 쪼개농 거멩키로 막 이망썽 몽테기가 이꼬그렁 거를	지금 꼭 저 저기 저 저 사탕 그런 것 쪼개놓은 것처럼 막 이만큼씩 뭉텅이가 있고 그런 것을
망치로 가꼬 깨 가꼬 포라요	망치를 가지고 깨가지고 팔아요
울지비 저저 저넨 영감	우리집 저저 전에 영감
그러면 그렁 거를 저 저 저 저그 제우 사 가꼬 와서	그러면 그런 것을 저 저 저저기 겨우 사가지고 와서
인자 그르게다 딱 다마노코 쪼끔썩 부어가꼬 무를 부어가꼬 인자 요리	이제 그릇에다 딱 담아 놓고 조금씩 부어가지고 물을 부어가지고 이제이리
마라자머 우리지	말하자면 우리지
그래가꼬 인자 소니 요리 인자 대리바가꼬 미끌미끌허먼 인자 빨래르 주 여가꼬더머 양재무른 때 잘 지지	그래가지고 이제 손이 이리 이제 대 봐가지고 미끌미끌하면 이제 빨래를 집어 넣어 가지고 데우면 양잿물은 때 잘 지지
때 잘 지지마는 그 집까꼬 헝 그거이 먼 그거이 재물끼가 나 얼매나 나오 꺼잉고이	때 잘 지지마는 그 짚 가지고 한 그것이 무슨 그것이 잿물기가 나 얼마나 나올것인가
네  소네 소니 그러면 소니 머 겐차나요	손에 손이 그러면 손이 뭐 괜찮나요
아이고 손 안 버꺼줄 정도로 하무 쪼깐 미끌미끄래이 그래문 인자	아이고 손안 벗겨질 정도로 하면 조금 미끌미끌하게 그러면 이제
어어어  인제 요샌 똥 낙써멩키로	이제 요샌 꼭 락스처럼
똥 낙써멩키로 그래찌 그래 미끄람네	꼭 락스처럼 그랬지 그렇게 미끄럽네
네  인제 낙써느 히지능 거이 드러농깨로 히지지마느	이제 락스는 희어지는 것이 들어있으니까 희어지지마는
저네느 인자 그래가꼬 씨끄먼 때가 좀 잘 지고 그래쪼	전에는 이제 그래가지고 씻으면 때가 좀 잘 지고 그랬지요
