dialect	standard
할머이 요곡 마을출시니지예	할머니 요곳 마을 출신이지요
요 마으리 어떤마으림니까 마을이름 소개쫌 해주이소	요 마을이 어떤 마을입니까 마을 이름 소개 좀 해 주십시오
요 마으리 저접 여 펭사리지요	요 마을이 저 저 여 평사리지요
어데 펭사림니까	어디 평사립니까
하동군 아걍면 아걍멘 여 펭사리 펭사리말	하동군 악양면 악양면 여 평사리 평사리마을
펭사리 펭사리마으레는 동네가 하나바께 업슴니꺼 또 동네 자긍기 또 멕깨 더이슴니꺼	평사리 평사리 마을에는 동네가 하나밖에 없습니까 또 동네 작은 게 또몇 개 더 있습니까
여거언자 여거는 제일로 노 노푼디고 펭사리고 저 미테 미테마으레는 하펭	여기 인제 여기는 제일로 높 높은 데고 평사리고 저 밑에 밑에 마을에는 하평
우리마을미테 하펭	우리 마을 밑에 하평
또 큰지레 그 큰지레거거 믿 하펭미텐 대초니고 그러네요 동네이르미닫 다리니까	또 큰 길에 그 큰 길 길에 그 그 밑 하평 밑엔 대촌이고 그러네요 동네 이름이다 다르니까
다 이기다 펭사리예 드러감니까	다 이게 다 평사리에 들어갑니까
하모이 펭사는 펭사리지	예 아무렴 평사리는 평사리지
그래도언잗 또 여거여거 마리자먼 또이지 동매이로	그래도 인제 또 여기 여기 말하자면 동이지 동처럼
여게느 요리그만 여 펭사리고 저미테 하펭 또 저 대촌	여기는 요렇게 그냥 여기 평사리고 저 밑에 하평 또 저 대촌
대촌미테 그 큰질 뻐수댕기는 으으 큰질 너메는언자 너메 미트로는	대촌 밑에그 큰 길 버스 다니는 응 큰 길 너머는 인제 너머 밑으로는
그그는 똗 그 머이고 먼동네고 그는 소징이라허고 소징이	거기는 또 그 뭐니 무슨 동네니 거기는 소징이라 하고 소징이
소징이	소징이
소징이똥네 소징이동네 네동네고 또 욛짜그로언자 멘사무소 가는데는언자 그걷	예 소징이 동네 소징이 동네 네 동네고 또 요쪽으로 인제 면사무소 가는 데는 인제 그것
암 부황대 부황대 안뚜불 머 입썩 막  짜드러 우씁찌 동네가 마 모도 이리미 다 이싱께로	안 부황대 부황대 안두불 뭐 입석 막 웃음 많이 우습지 동네가 마 모두 이름이 다 있으니까는
그럼 할머이가 드르시거나 아시는대로	그럼 할머니가 들으시거나 아시는 대로
이동네는 운제 처음 생기슴니까 운제 생긷따고 드르셔슴니까	이 동네는 언제 처음 생겼습니까 언제 생겼다고 들으셨습니까
몰라 멘년똥고도 모리지 나느 여 오래데농께	몰라 몇 연도인지도 모르지 나는여 오래 돼 놓으니까
워 요거 머 저네부터 요 오래오래덴 동넹께로 이동네느	워 요것 뭐 전에부터요 오래 오래 된 동네니까는 이 동네는
그러 오래댇따능기 머 오뱅년 댇따든지	그러니까 오래 됐다는 게 뭐 오백 년 됐다든지
그렁께 그래야 데낀데 그랟 그걸	그러니까 그래야 될 건데 그래그걸
그렁거 드른 드런 얘기가 이스면 말슴해주이소	그런 것 들은 들은 얘기가있으면 말씀해 주십시오
그걷또 모리는데 어쩌꼬	그것도 모르는데 어찌할까
그 와 즈즏	그 왜 저 저
와 저 아레쩌녀게 그 슨생님 두분 저저저 하라부지한테 간다안핸능가요 그 정가게 정가 갇따오씯쩨	왜 저 그저께 저녁에 그 선생님 두 분 저 저 저 할아버지한테간다 했잖아요 그 정각에 정각에 갔다 오셨지
그 하라씨한테 그렁거 묻찌 여거 멘년 덴냐고	그 할아버지한테 그런 것 묻지 여기 몇 년 되었느냐고
으음 허이 그건또 그대로 하고	음 허 그건 또 그대로 하고
그런데 내는 모리는 멘년뎅거르 모리는데 우쩌꼬	그런데 나는 모르는 몇 년 된것을 모르는데 어찌할까
믿뺑년 덴능고 나아 그렁거느 머 기역 안무러바농께로 고마 고마 이리 사니까로 모르건네 나느	몇 백 년 됐는지 나는 그런 거는 뭐 기억 안 물어 봐 놓으니까는그냥 그냥 이렇게 사니까는 모르겠네 나는
멘년 내	몇 년 내
후제 무러나야 데건네	훗날 물어 놓아야 되겠네
그러므녜	그러면요
어른들한테	어른들한테
이 동네 주미드른 성씨가주로 우째 구성대 이슴니까	이 동네 주민들은 성씨가 주로 어떻게 구성돼 있습니까
강씨가 망코 강씨 강가 이 한산이씨 이씨가 망코	강씨가 많고 강씨 강가 이 한산이씨 이씨가 많고
그 사람드른 막 이 제가글 모도 막 이리 지각꼬	그 사람들은 막 이 제각을 모두막 이렇게 지어 가지고
이씨망코 강씨망코 그래요	이씨 많고 강씨 많고 그래요
그루고 머 공 고 고가도 익꼬 머 고가도 익꼬 머 여러성이지요 성은	그리고 뭐고 고 고가도 있고 뭐 고가도 있고 뭐 여러 성이지요 성은
그러 집성집성 대성이 어떵김니꺼	그러면 집성 집성 대성이 어떤 겁니까
백가도 익꼬 그기 머잉가요	백가도 있고 그게 뭣인가요
강씨 이씨가 제일 큰성임니꺼	강씨 이씨가 제일 큰 성입니까
그라므 할머이 이씨가 바로 그 이씸니까	그러면 할머니 이씨가 바로 그 이씨입니까
나는 이오이 요런 사람 이씨 아이라요	나는  요런 사람 이씨 아니라요
아하	아하
용인이씨라 용인이씨가 머잉고 용인이씨래 우리는	용인이씨야 용인이씨가 뭣인지 용인이씨래 우리는
아까	아까
근데 서울 마니 읻따네요 우리 용인이씨가	그런데 서울많이 있다네요 우리 용인이씨가
용이니 서울 미테거든녜	용인이 서울 밑에거든요
서울미테	아 서울 밑에
그라머 아까 머슨 이씨가 만타 그래슴니까	그러면 아까 무슨 이씨가 많다 그랬습니까
한산이씨라대	한산이씨라대
요사람드른 여여 미테 제각	요 사람들은 여기에 여기에 밑에 제각
요 사람들 여 제각 여 올라오는디요	요 사람들 여기에 제각 여기에 올라오는데요
으으	으응
거기 제각 크기 조키 지낟찌요 대문익꼬	거기 제각 크게 좋게 지어 놓았지요대문 있고
나무대문 익꼬	나무 대문 있고
받슴니더	봤습니다
그거	예 그것
달쏘게	속에
고거	예 고것
구인데 요요이 요사람도 이 이씬데 딴 이씨라농께로 따로언자 제가글 또요래 지각꼬	그런데 요 요 이 요 사람도 이 이씨인데 딴 이씨라놓으니까는 따로 인제 제각을또 요렇게 지어 가지고
그러모 강씨는 어데 보니 어뎅고예 어느 강씽고예	그러면 강씨는 어디 본이 어딘가요 어느 강씨인가요
차말로 그렁거르 내한테로 무르메 우째알건네 너무강씨를	참말로 그런 것을 나한테로 물으면 어찌 알겠니 남의 강씨를
너무 강씨를	남의 강씨를
나는	나는
너무 강씨를	남의강씨를
이지미 이라각꼬	이 이렇게 해 가지고
아하	아하
아라심더	알았습니다
먼이씨 강씽고몰라 마 강가라고마 알지	무슨 이씨강씨인가 몰라 마 강가라고만 알지
머 우리 그시기 아잉께 내가 머 기다마 듣따안허고 벌로득꼬	뭐 우리 그슥이 아니니까 내가 뭐 귀담아 듣지도 안하고 흘려듣고
그러먼녜 할머니	그러면요 할머니
그런데 벌채가 데각꼬 내가	그런 데무감각해 가지고 내가
이마을 그지예	이 마을 그죠
그 하라부지 내나 강씨라 마리자모	그 할아버지 내나 강씨야 말하자면
그 머이고 제가게 갇찌요	그 뭐니 제각에 갔지요
아이 그 말고 저미테제 제가 만난 부는	아니 그 말고 저 밑에 제 제가 만난 분은
그 저쪼게	그 저 쪽에
그 하라버지가 아이고	그 할아버지가 아니고
그 하라씨 아이라요	그 할아버지 아니라요
그 하라씨가 아이고	그 할아버지가 아니고
구마 어디야 기시시꼬	아 그러면 어디에 가셨을까
저미테 저 저 머꼬 범짜수짜 하라부지 범수	저 밑에 저 저 뭐니 범자 수자 할아버지 범수
범수 조신	아 범수 조씨
그 사래미 저네 여거 사란는디요	그 사람이 전에 여기 살았는데요
저네 여엳 우예 여여 찌금 우예 그 그시기 지비라	전에 여 여기에 우에 여 여기에 지금 위에 그 그식이 집이야
그 머이고 구판장 찌금 저젇 점빵 점빵이라해야겓따 그만	그 뭐니 구판장 지금 저 저 가게 가게라 해야겠다 그냥
점빵 욷쩜빵예 여 올라오는디 그 토란시머노코 욷쩜빠아 그지비 거가 그사람지비거든뇨 범수 조신	가게 윗 가게에 여 올라오는 데 그 토란 심어 놓고 윗 가게에 그 집이 거기가 그 사람 집이거든요 범수 조씨
아네 드러가데예 안쪽	예 안에 들어가데요 안쪽
지빈디 그러께 그 지빈디	집인데 그러니까 그 집인데
부사느로 이새감서로 파라비서	부산으로 이사가면서 팔아 버렸어
파라비리고 지금거트머 안파라시먼 그어가 갑씨 얼매나 마느낀데	팔아 버리고 지금 같으면 안 팔았으면 값이 얼마나 많을 건데
그래가꼬언자 그 친척땅을 어더각꼬	그래 가지고 인제 그 친척 땅을 얻어 가지고
자이가 여거 오고십따 해각꾜	자기가 여기 오고 싶다 해 가지고
그래각꼬언자 지거 지각꼬 사라요	그래 가지고 인제 자기  지어 가지고 살아요
혼차 사라 혼차 아드른 부산익꼬 할머미 주거비리농께	혼자 살아 혼자 애들은부산 있고 할멈이 죽어 버려 놓으니까
그러쿠나	예 그렇구나
술도 안잡수고 머 망구 얌전치 사람도	술도 안자시고 뭐 만고에 얌전하지 사람도
그인자 먼족가느로 오빤디	그 인제 먼 집안 사이로 오빤데
그러타 그래 드러서예 예예	그렇다 그렇게 들었어요예
제가 여와서 할머이하고 그런다캉께 우리 성자가 캄시로 마	제가 여기에 와서 할머니하고 그런다고 하니까 우리 성자가라고 하면서 마   연방 내가 오빠라 하득끼아 웃음 연방 내가 오빠라 하듯이
그러캅띠더 예예	예 그렇게 말합디다예
이 마으리 펭사리 상펭아임니까이	이 마을이 평사리 상평이잖습니까이
그 상펭이 와 상펭이지카는지 그 혹시머 이유가 이슴니까 드러  머 이유보당도 고양 고마 이리	
머 이유보당도 고양 고마 이리	뭐 이유보다도 그냥 그만 이렇게
펭사리라고 상펭이라고 이 동네 이르미 모도 상펭 하펭	평사리라고 상평이라고이 동네 이름이 모두 상평 하평
전시니 그리그리 익꺼등요	전신에 그렇게 그렇게 있거든요
대촌 머 소징이 그리딕끼	대촌 뭐 소징이 그렇듯이
그래각꼬 그리 이르미 그리 지전는갑떼요	그래 가지고 그렇게 이름이 그렇게 지어졌는가 보데요
구래가고 구루지 머 구렁거 내 모리지 재사히 자세히그래 가지고 그러지 뭐 그  런 것 내 모르지 자세히 자세히  예	예
나기마 여 나서 머 냅 내 거스게 지금 이리 사능기지	나기만 여기에서 나서 뭐내 내 거슥에 지금 이리 사는 게지
여 디예 봉께언자 여 지리산 미테아임니꺼이	여기 디에 보니까 인제 여 지리산밑에잖습니까이  예예
여 산 이름 머 이린이렁꺼 이슴니까	여기 산 이름뭐 이런 이런 것 있습니까
저거는 머 바구리봉이라 허고 저네 어른드리 저쭈게 저 강건네	저기는 뭐 바구리봉이라 하고 전에 어른들이 저쪽에 저 강 건너
파구리봉이라 허고 머	바구리봉이라 하고 뭐
절라도라 허고 지금 우리가 그러고 읻찌요	전라도라 하고 지금 우리가 그러고 있지요
또 디 여 또 산 이르믄 머	또 뒤 여기에 또 산 이름은 뭐
여거 여여 헹지봉	여기 여기에 여기에 형제봉
여 마다아 나가모 막 봄데모 꼬치	여기에 마당에 나가면 막 봄 되면 꽃이
그얻 그슥꼬치 벌거리 핀먼 비이는디 여거 마당에서	그것 그슥 꽃이 벌겋게 피었으면 보이는데 여기 마당에서
진달래	진달래
진달래	예 진달래
그 막 행사한다 아임니까	그 막 행사하잖습니까
네헹제	네헹제
헹지봉	예 형제봉
헹지봉 거 마 진달래 벌거리 피머 사머레	형제봉 거기에 마 진달래 벌겋게 피면 삼월에
사멀 얼쭈 다가몽 날로 바다각꼬 나리읻써요 그래각꼬 막 거	삼월얼추 다 가면 날을 받아 가지고 날이 있어요 그래 가지고 막 거기에
술 머 떡 막 음석마이 해가가서	술 뭐 떡 막 음식 많이 해 가지고 가서
거가서 막 지새모시고 해요 해긴해마덕	거기에 가서 마 지사 모시고 해요 하긴해마다
그러모 바구리봉이고 헹지봉이고	그러면 바구리봉이고 형제봉이고
요 고소성	요기에 고서성
어어 예	어 예
고소성 고소성 여 유명헌딘디	고소성 고소성 여기에 유명한 덴데
우째 유명함니까	어떻게 유명합니까
거가시머 그래거햐 안주 온제가 얼매안데고 거 함문 가시야데낀데 선생니미	거기에 가시면 그래 거기에 햐 아직 온 지가 얼마 안 되고 거기에 한 번 가셔야될 건데 선생님이
허 저네요 마리 어른드리 허는디	허 전에요 말이 어른들이 하는데
이 마리자마 할매드리 치매다 도를 싸각꼬	이 말하자면 할머니들이 처마에다돌을 싸 가지고
그거 말또 데다안허지마는 치매다 싸각꼬 읻 읻	그것 말도 되지도 안하지마는치마에다 싸 가지고 이 이
다무라글 싿때요 치매다 도를 싸각꼬	담벼락을 쌓았대요 치마에다 돌을 싸 가지고
돌싸가 그러타고 구리 이야글 허고 어른드리	돌을 싸서 그렇다고 이야기를 하고어른들이
지그므요 저네끼언자 쌍마 무너젇꺼등뇨 너무너무 오래대농께	지금은요 전에것이 인제 싹 마 무너졌거든요 너무너무 오래 돼 놓으니까
오래대농께 무너저각꼬	오래 돼 놓으니까 무너져 가기고
항정업시 여거서느요 암보잉께그런디 저 딱 올라가시모	한정없이  여기에서는 여기 안 보이니까 그런데 저기에 딱 올라가시면
그 정무니 익꺼등뇨 저거도 그	그 정문이 있거든요 저기도 그
가머요 항정업시 널러요 둥구룸허이 마	가면요 한정없 넓어요 둥그스름하게 마
그러구 구예 한해언자 저접	그리고 거기에 한 해 인제 저 저
펭사리상에서 정심해섣 아지그로 일꾼들	평사리상에서 점심해서 아침으로 일꾼들
싸가꼬 자기드리언자 실코가고 차에 실코가고 막 가가서 뭉는다고	싸 가지고 자기들이 인제 싣고 가고 차에 싣고 가고 막 가지고 가서 먹는다고
수리고 머이고 가가고	술이고 뭣이고 가지고 가고
그 싹 새로 고만	그 싹 새로 그냥
큰 도를 각꼬 고만	큰 돌을 가지고 그냥
저 큰 돌 저렁걸 각꼬 우찌그리 싼능고 몰라	저 큰 돌 저런 걸 가지고 우떻게그렇게 쌓았는지 몰라
너무너무고마 뺑둘러서 그냥 자리도 너린 자리예	너무너무 그냥 뺑 둘러서 그냥 자리도 너른 자리에
너무 먿찌기 싸낟서요 지금	너무 멋지게 쌓아 놓았어요 지금
저 고소성에 하문 언제 가시야데낀데	저 고소성에 한 번 언제 가셔야 될 건데
가낌니더	갈 겁니다
하문가서 구겡허시지	예 한 번 가서 구경하시지
그 너르기가 요치모 어느정도 뎀니까 요요욛 펭지로 치몬녜	그 너르기가 요기 치면 어느 정도 됩니까 요요 요 평지로 치면요
펭지로 치모막 요거막 이리막 저가이로 이거먹 가이로 이걷뽀당 이거 쫍찌	평지로 치면 막 요것 막 이리 막 저 가로 이것 막 가로 이것보다 이것 좁지
저 바꾸로 나가야지	저 밖으로 나가야지
오 그 정돔니까	오 그 정도입니가
항정업시 커요	한정없이 커요
그럼 하리종일 도라도 다 몯똘미까	그러면 하루종일 돌아도 다 못 돕니까
아이구 왜 몯또라요 도지 하리는 도지	아이구 왜 못 돌아요 돌지 하루는 돌지
하리는 돌고	하루는 돌고
스 엔나레 요 성싸	스 옛날에 요기에 성 쌓
그리 조키성	그렇게 좋게성
누가 적군하고 치드러오몬 그 싸운다꼬 그지예 성싸안데	누가 적군하고 쳐들어오면 그 싸운다고 그죠 성 쌓은 데
예 예	예예
그래 그랜는디 그기 저네꺼는 사 무너지고	그래 그랬는데 그게 전에 것은 싹무너지고
야파농께 야파농께 고만	얕아 놓으니까 얕아 놓으니까 그냥
다시 한해 언제 저네	다시 한 해 언제 전에
그 조은 돌로가꼬 고마	그 좋은 돌을 가지고 그냥
임부도 항정업시 드럳찌 그렁께 그래 싸장께	인부도 한정없이 들었지 그러니까그렇게 쌓으려 하니까
그래가꼬 멛딸로 해각꼬	그렇게 해 가지고 몇 달을 해 가지고
영 조키 싸낟써요 찌금	아주 좋게 쌓아 놓았어요 지금
그 소게는언잗 꼬사리가 나고 도리도리허이 긍게 그 꼬사리 끄느러 지금	그속에는 인제 고사리고 나고 둥그스럼하게 그러니까 그 고사리 꺾으러 지금
봄데머 사람드리 가는사람 만날 그가 끄너오지	봄 되면 사람들이 가는 사람 만날 거기에 가서 꺾어 오지
저네는 그 성에 막 꼬사리가 억수로 탐직꺼등뇨	전에는 그 성에 막 고사리가 억수로 탐스럽게 자랐거든요
그 도리도리허이 뿌리인는디 나는디	그 동그스럼하게 뿌리 있는 데 나는데
할머이 어제 또 소미이러 간다칼떼가 그어미까	할머니 어제 또 소 먹이러 간다고 하는 데가 거기입니까
소 미인는디는언자 그거 미테	소 먹였는 데는 인제 그것 밑에
미테언잗 지리 졸 읻찌 지금도	밑에 인제 길이 졸 있지 지금도
그너메막 항정업시막	그 너머에 막 한정없이 막
지그므 밤나무가 마이 시머가꼬	지금은 밤나무가 많이 심어 가지고
막 그느리고 머이막 착착허지마 저네는 하무걷또 업꼬고마 사니그마 번번해농께	막 그늘이고 뭣이 막 착착하지만 전에는 아무것도 없고 그냥 산이 그냥 펀펀해놓으니까
소를고마 몰꼬나가모고마 그따가마 지버내비리요 사람마덤	소를 그냥 몰고 나가면 그냥 거기에다가 마 내버려둬요 사람마다
지버내비리머 주구가 맏때로 대임서 뭉능기라언자 칭니파를 칭니파를	내버려두면 자기가 맛대로 다니면서 먹는 거야 인제 칡이파리를 칡이파리를
쎄떼기도 칭니파리고 저네 사네 이서농께	억새고 칡이파리고 전에 산에 있어 놓으니까
그래가 미가꼬언자 해너머가머마 세차즈러가자 해가꼬 마 온천지로언자	그래가지고 먹여 가지고 인제 해 넘어 가면 마 소 찾으러 가자 해 가지고 마 온천지로인제
소갇따 내비리머 점심묵꼬가서 그마 꼬빼이 나비리머	소 가져다 내어 버리면점심 먹고 가서 그냥 고삐 놓아 버리면
소는 주구대로언자 대임서 묵꼬 놀고	소는 자기대로 인제 다니면서 먹고 놀고
또 우리는 우리대로 놀고 콩돌죽끼허고막 바구미테서	또 우리는 우리대로 놀고공기놀이하고 막 바위 밑에서
언자콩줄둑끼노오네 아까는 암말띠 안하실라카더마는	인제 공기놀이 나오네 아까는 아무 말도 안 하실라고 하더만은
콩돌죽끼허고 소미로 가서	공기놀이하고 소 먹이러 가서
언자 그래 놀고 그래가꼬언자 해가지모 또 지베와야 뎅께 소거걷	인제 그렇게  놀고 그래 가지고 인제 해가 지면 또 집에 와야 되니까 소 그것
집쩜 소로언자 싹언자 막 차즈로가지 온천지 흐치농께	각자 소를 인제 싹 인제 막 찾으러 가지 온 천지 흩어 놓으니까
소가 온사네 흐치비리농께	소가 온 산에 흩어져 버려 놓으니까
소가 도망 앙감니꺼	소가 도망 안 갑니까
언자 어쩔라치모 고마 읍서요 소가	인제 어쩌다 보면 그냥 없어요 소가
저너머로 고만 너머사느로 가비리고	저 너머로 그냥 남의 산으로 가 버리고
그러머 찬니라고 시껍뭉능기라 정때 내 마 나낟따가	그러면 찾느라고 아주 고생하는 거야 저녁 때 내 마 놓아 놓았다가
그래가꼬 착꼬 날리로 지고 그래언자 차자가꼬언자 오고	그래 가지고 찾고 난리를 치고 그래 인제 찾아 가지고 인제 오고
그래	그랬
그 소 나뚤때 소꼬빼이는 무껃 그대로	그 소 놓아 둘 때 소 고삐는  묶어 그대로
고마 지대로 고마 나비리요	그냥저대로 그냥 놓아 버려요
말고 소꼬빼이 푸러줌니꺼 소꼬빼이 이씀니꺼	말고 소 고삐 풀어 줍니까 소 고삐 있습니까
고마 나도비리요	그냥 놓아 둬 버려요
그라모 소가 어데	그러면 소가 어디
언자 걸리고	인제 걸리고
나무걸리모 이라모 뺑뺑 감기모 크닐나는데	나무에 걸리면 이러면 뱅뱅 감기면 큰일 나는데
하 그런다고어자 그렁께 자주 보지 소를	아무렴 그런다고 인제 그러니까자주 보지 소를
직쩜 소를 요리 꼬빼이 저거머이고 어디 갱긴능가 보자 허곧똗 초차가서	각자 소를 요렇게 고삐 저것 뭐니 어디 감겼는가 보자 하고 또 쫓아가서
갱기모 요리요리요 막 요리 쪼끄만헌 나무예 요리요리 갱기거든	감기면 요리 요리 요 막 요리 조그마한 나무에 요리 요리 감기거든
요리 꼬피거등 새끼 그	요리 꼽히거든 새끼 그
그기마 요리요리 허머마 가서언자 요리 푸러주고	그게 마 요리 요리 하면 마 가서 인제 요리 풀어주고
소가 저도 어릴때언자 소를 마이 민는데	소가 저도 어릴 때 인제 소를 많이 먹였는데
예예	예 예
이넘 나뚜모 걸리뿌모 이너미 뺑뺑돌고 나중에	이놈 놓아 두면걸려 버리면 이놈이 뱅뱅 돌고 나중에
그렁께요	그러니까요
그렁께 크닐나	그러니가 큰일 나
그래가꼬 이기이게 모가지가 걸리삔다고예	그래 가지고 이게 이게 모가지가 거려 버린다고요
예예	예 예
크닐나	큰일 나
크닐남니다 그래서 우리는	큰일 납니다 그래서 우리는
그렁께로 자주 바	그러니까는 자주 봐
거서 아예 소꼬삐 요요 코뚜리예서 빼가지고	거기에서 아예 소 고삐 요 요코뚜리에서 빼어 가지고
빼가지고	아 빼어 가지고
나뚜고 그 소가 순해가이고	놓아 두고 그 소가 순해 가지고
고러머 나주 우째 차 저기 여자드리 우찌 구굴 자바 오끼라	그러면 나중에 어떻게 찾 저기 여자들이 어떻게 그걸 잡아 올 거야
에 여자들만 감니꺼 남자들도 다  가는데	에 여자들만 갑니까 남자들도 다 가는데
애드리라도 다 강께	애들이라도 다 가니까
그렁께 구래도 우리는 꼬빼이 안허고맏 꼬빼이조차 나나비릳스	그러니까 그래도 우리는 고삐 안 하고 마 고삐조차놓아 놓아 버렸어
꼬빼이조차	고삐조차
진꼬빼이 마 몰꼬 가각꼬	긴 고삐 마 몰고 가 가지고
그런데 우리는언자 그 마 사네가서 니 마음대로 띠라 이 꼬빼이꺼지 딱 푸러노코	그런데 우리는 인제 그 마 산에 가서 네 마음대로 뜯어  이 고삐까지 딱 풀어 놓고
그렁게앙 그슥허라고	그러니까 안 안 그슥하라고
안 걸리라고	걸리지 말라고
으응	응
그람 저 성은 운제 싸앋따 캅디꺼 옌나레 오새 싸응거말고 엔나레 싸은 성은	그러면 저 성은 언제 쌓았다고 합디까 옛날에 요새 쌓은 것 말고 옛날에 쌓은 성은
아이고 머 멛 뱅년뎅걷또 모리지요	아이고 뭐 몇 백 년 된 것도 모르지요
그렁걷또 나 몰라 그렁거	그런 것도 나 몰라 그런 것
그야마	그야말
그라머 거게	그러면 거기에
그리 읻따 그거마 알지	그렇게 있다 그것만 알지
산성이 읻따 그지예	산성이 있다 그죠
고소성	고소성
고스승	고소성
고소승	예 고소성
고소승 거이다 소문난딩가 아마	고소성 그게 다 소문난 덴가 아마
앙그래도젇	안 그래도 저
그 보고 내요기 이렁기 이서	아 보고 내요기에 이런 게 있었
장녀네도 안 오슴니까이	작년에도 왔잖습니까이
그렁께	그러니까
완는데도 몽가보고 이래가	왔는데도 못 가 보고 이래서
그렁께 거가 큼맘묵꼬 고마 역뿌로 쭉 가시야지	그러니까 거기에 가 큰맘 먹고그냥 일부러 죽
먿 그그 시언차이 맘묵꼬는 몬가시지	머 그 그 예삿마음 먹고는 못 가시지
아 심 신차이 마이묵꼬는 목깐다이	아 예사 예사 마음 먹고는 못 간다이
큼마으믈 묵꼬 탁고마 나서비야지	큰 마음을 먹고 탁 그냥 나서 버려야지
그라머 고소성하고	그러면 고소성하고
저 한산사하고는 머슨강게가 이슴니꺼	저 한산사하고는 무슨 관계가 있습니까
한산사 고서성 거거 성아네	한산사 고소성 거기 성 안에
아레도 얘기핻찌마는 성아네 거거 저네	그제도 얘기했지마는 성 안에 거기전에
여 이 마을 사래미 저거 머이고	여기에 이 마을 사람이 저기 뭐니
지블 조고만허이 저를 짇써요	집을 조그마하게 절을 지었어요
거 승 아네다가	거기 성 안에다가
볼래	본래
예예  성 아네다가 조고만허이 지블 지각꼬 자기가 왇따갇따언자 허고	
성 아네다가 조고만허이 지블 지각꼬 자기가 왇따갇따언자 허고	성 안에다가 조그마하게 집을 지어 가지고 왔다갔다 인제 하고
여여 요동네 사래민디 그리 허다가	여기 여기 요 동네 사람인데 그리 하다가
고마 지그믄 저머머 슨샘 사는디 머이고 마사니가 머 거 산다더냐 어쩌다 생저  네 여거 아노니까 그 사래미	그냥 지금은 저기에 뭐 뭐 선생님 사는 데 뭐니 마산인가 뭐 거기에 산다던가 어쩐다던가 생전에 여기 안 오니까 그 사람이
그 중이 데각꼬 그 사래미 거 조그만허이 지각꼬	그 스님이 돼 가지고 그 사람이 거기에 조그만하게 지어 가지고
그걸 뜨드다가 여 한산사다 똗 짇써요	그걸 뜯어다가 여기에 한산사에다 또 지었어요
그라모 요거는	아 그러면 요것은
그사래미 안헌당께	그 사람이 안 한다니까
요거는 성바끼다 그랑께 그지예	요것은 성 밖이다 그러니까 그죠
요거느 하모 믿테 내러와승께	예 요것은 아무렴 밑에 내려 왔으니까
성은 저 우게고예	성은 저 위에고요
고건 절 우에지	예 고기는 절 위에지
볼래는 절 가운데 그저 성 가운데 저리 이섣다이	본래는 절 가운데 그 어저 성 가운데 절이 있었다이
거고맘 하모 머머머 중가네 고만 거 하낟 안차각꼬 그사래미	거기에 그냥 아무렴 뭐 뭐 뭐 중간에 그냥 거기에 하나 앉혀 가지고 그 사람이
중잉께	스님이니까
기양 잉간헌 중잉께 기양 자기가 거 지블 지각꼬	그냥 웬만한 스님이니까 그냥 자기가 거기에 집을 지어 가지고
거거서 기도 디리고	거기에서 기도 드리고
믿해 읻따가 고마인잔 안헌다고 나와비리찌	몇 해 있다가 그냥 인제 안 한다고나와 버렸지
나와각꼬언자 그 절로 뜨더다가 마 여 겅기사 짇따 그러대요	나와가지고 인제 그 절을 뜯어다가 마 여기에 근기사 지었다 그러대요
하모 머 갈리는 엄써요 내나 요거요고또 머	아무렴 뭐 갈 일은 없어요 내나 요것 요것도 뭐
고소성에	고소성에
그 할머이 그라먼자 그 여페 저 흐르는 킁 강 안이슴니꺼이	그 할머니 그러면 인제 그 옆에 저 흐르는 큰 강 있잖습니까
무승 강임미꺼	무슨 강입니까
섬진강이라 허지요섬진강이라 하지요  그 섬진강에 그 머 생강나시는대로 얘기좀 해주이소 머 유멩하지마는녜	
그 섬진강에 그 머 생강나시는대로 얘기좀 해주이소 머 유멩하지마는녜	그 섬진강에 그 뭐 생각나시는 대로 얘기 좀 해 주십시오 뭐 유명하지마는요
고 저전 재츱 요요게엔잗 엳스	고 저 저 재첩 요 요게 인제 여기서
우리 큰질로 쭝내리가가꼬 그릳	우리 큰 길로 쭉 내려 가 가지고 그리
도라가먼 금 모티이 그거막	돌아가면 그 모퉁이 그것 막
갱주개 잠는다고 그 그스 머이곧 갱주개란다 내가 또	강조개 잡는다고 그 그슥 뭐니 갱주개라고 한다 내가 또
그스 재츱잠는다고 사람드리 여름데머	거기에서 재첩 잡는다고 사람드리 여름되면
오래는 차꾸 비가 싹 와쌍께로 마 앙간능가 몰라	올해는 자꾸 비가 싹 와 쌓으니까 마 안 갔는지 몰라
재츱잠는다고 그 나가거등뇨 강에	재첩 잡는다고 그 나가거든요 강에
그 섬진강에	거기에 섬진강에
그 연내나 그 하동갈라머 쭉	그  여기 내나 그 하동 가려면 쭉
모랭이 안 트는가욛 다리 다리 해 각꼬	모롱이 틀잖는가요 다리 다리 해 가지고
여거서 큰질로 쭉 가먼 모랭이 탁 토는데 읻찌요 하부동 하동가고 하개가고 막하는디	여기서 큰 길로 쭉 가면 모롱이 탁 도는 데 있지요 하동 하동 가고 화개가고 막 하는 데
예예	예 예
거거에섣 저네 감축찌헐쩌게 여 아자씨가 즈극	거기에서 전에 감 축제할 적에여기에 아저씨가 저기
새미인는디 그 파랑대문인는 그 아자씨는	우물 있는 데 그 파랑 대문 있는 그아저씨는
거거예 고맙 즈녀게 요리 감축찌허는디 오토바를 타고 요리 가다가	거기에 그만 저녁에 요렇게 감 축제 하는 데 오토바이를 타고 요렇게 가다가
궁구러지갇꼳 죽얻따임니꺼	넘어져 가지고 죽었잖습니까
생때거튼 사래미 저녁 잘묵꼬 거 귿 갑축찌헌디	생떼 같은 사람이 저녁 잘 먹고 거기 거기 감 축제 하는 데
도라가다가 과부에 거 톡 너쩌가꼬 걷	돌아가다가 커브에 거기 톡 떨어져 가지고 거기
오토바리 거기 그맏 톡 굼부리저가꼬 우쩌다가 거릳 굼부리적인능고 모르지 그래각꼬	오토바이 그게 그만 톡 넘어져 가지고 어쩌다가 그렇게 넘어졌는지 모르지그래 가지고
저젇 하동 사우랑 따랑 와각꼬 주구오매 덱꼬가고	저 저 하동 사위랑 딸이랑와 각지고 자기 어머니 데리고 가고
조구 아부지장 차예 타각꼬 가장께로	자기 아버지랑 차에 타 가지고 가자니까
사우 차타고 가장께 꼭 오토바르 타고간다더라이 그날지니게	사위 차 타고 가자니까 꼭 오토바리 타고 간다더래 그날 저녁에
그래가꼬 자기는 오토바르타고가고 장모는언자 딸차로 가고	그래 가지고 자기는오토바이 타고 가고 장모는 인제 딸 차로 가고
새보기 대도 아노더래요 사래미	새벽이 돼도 안 오더래요 사람이
사래미 아나 언자 그 그렁께 얼매나 착꼬	사람이 안 와 인제 그 그러니까 얼마나 찾고
그 날리를 지이건능가요이 사래미 안오니까 감축찌 간는데 내나	그 난리를 치겠는가요이 사람이 안 오니까 감 축제 갔는데 내나
내나 거거 섣바구 구거 올로오는데 거 그 모래깽베네 그거서언잗	내나 거기에거기 섯바위 거기 올라오는 데 거기에 그 모래강변에 거기서 인제
사람들 거거 텐트처노코 놀고 허는디 여르메	사람들 거기 텐트 쳐 놓고 놀고 하는 데 여름에
그래가꼬 차지러가고 아지게 나리 새서언잳	그래 가지고 찾으러 가고 아침에날이 새서 인제
동네사래미 가고 막 강께 거가 거갇 자빠저가꼭	동네 사람이 가고 막 가니까거기에 가서 거기에 가서 자빠져 가지고
거 주걷떠라안핸능가요 다리미테	거기에 죽었더라 했잖아요 다리 밑에
그기 운제 일	그게 언제 일
거 뺑 도라가는디	거기에 빙 돌아가는 데
그기 운제 이림니까	그게 언제 일입니까
거거 지샌 네개 지낸냐 오래네개채 다오능가 그래요	그것 제사는 네 개지냈나 올해네 개째 다가오는가 그래요
체 체근 이리다 그라모 그지예최 최근 일이다 그러면 그죠  예	
그람 아까 그언자 재첩 잠는다 안그캗슴니까	
그렁께 그귿 이약허다가 그사람 이약핻따 그그 자브로 가먼	그러니가 그것 이야기하다가 그 사람 이야기 했다 그것 잡으러 가면
사람드리 니가 주끄뜽가네 주거	사람들이 누가 죽든 간에 죽어
그 마 푹풍 모래가 가란자서 빠진다네요 사래미	그 마 푹푹 모래가 가라앉아서 빠진다네요 사람이
모리고언자 그 막 재침만 잠는다고 막 헤비파고마	모르고 인제 그 막 재첩만 잡는다고 막 뒤집어 파고 마
그리 허다가 보모 마 술술술술술 디러간대요 그런디가 있대 거가	그렇게 하다고 보면 마 술술술술술 들어간대요 그런 데가 있대 거기가
그런디 그 사람드리 여러 마롱게 댇 재츠블 잠는다고 우리 나가거든	그런데 그사람들이 여러 마을이니까 재 재첩을 잡는다고 우리 나가거든
그 재미로 고마 그 잠는다고 거 마읻따네요 재츠비	그 재미로 그냥 그 잡는다고 거기에 많이 있다네요 재첩이
우리느 머 하내 여름도 앙가바꾸마해도	우리는 뭐 한해 여름도 안 가 봤지만
그람 재처븐 그런데 아까 갱주개는 멈니까	그러면 재첩은  그런데 아까 갱주개는 뭡니까
갱주개 재츠블 가따가 내가 갱주개라	갱주개 재첩을 갖다가 내가 갱주개라 했어
그람 갱주개는 멈니까	그러면 갱주개는 뭡니까
근 조개미까	그건 조갭니까
그렁게 재츠블 갇따가 마를 그런당께 내가 마를 그리	그러니까 재첩을 갖다가 말을 그런다니까 내가 말을 그렇게
뽀니 엄시 헝께	모양 없이 하니까
아니	아니
사투리마를 헝께	사투리 말을 하니까
재처비 요말로 갱주갬니까	재첩이 요기에 말로 갱주개입니까
내가 갱주개라 해요 하모	내가 갱주개라 해요 아무렴  아니아니
거는	그것은
딴사아믄 그래안해 내마 그래	다른 사람은 그렇게 안 해 나만 그래
와 할머이마 갱주개라 그럼니까	어 왜 할머니만 갱주개라 그럽니까
몰라 백끼 고마 갱주개 소리가 나오네 연방	몰라 공연히 그냥 갱주개소리가 나오네 연방
어어	으응
재츠비라 그이 재츱	재첩이야 그게 재첩
그래 한차 어어	그래 혼자어
재첩	재첩
재츠빈디 갱주개라도 허거등뇨	재첩인데 갱주개라고도 하거든요
요동네서 글캄니까	요 동네에서 그렇게 말합니까
아이 딴사라믄 그리안디 내가 그래 그러낃	아이 다른 사람은 그래 안 하는데  내가 그래 그렇게
옌날부터 드러승께 할꺼 아임니꺼 지낸 마른 아이끼고	옛날부터 들었으니까 할 것 아닙니까 지어낸 말은 아닐 것이고
하머	아무렴
할머이가 지내서는 안한다 캐승께	할머니가 지어 내서는 안 한다고 했으니까
그렁께 지내 안허는디	그러니까 지어내서는 안 하는데
저네는 갱주개라 핻찌 하머 그런디 지 찌그믄 먿 재츠비라도 애마나이	전에는갱주개라 했지 아무렴 그런데 지 지금은 뭐 재첩이라도
근디 부다이 갱주개 소리가 나오넫 또 이베 올라가꼬	그런데 괜히 갱주개 소리가 나오네 또 입에 올라 가지고
그래서그래 그기내낟 재츠비라요 재츠빈데 갱주개	그래서 그래 그게 내나 재첩이라요 재첩인데 갱주개
우우 그 재첩뽀다 더 옌날 요마리 갱주개네 언자 보니까	으응 그 재첩보다더 옛날 요기 말이 갱주개네 인제 보니까
내나 요롱마리지예	내나 요 동네 말이지요
하모 하모 재츱	예 아무렴 아무렴 재첩
재츰막 그런디 쌕꺼등뇨	재첩 막 그런 데 많았거든요
이 그러먼자 섬진가언자 갱주개가 쌕꼬	이 그러면 인제 섬진강은 인제 갱주개가 많았고
그 다메 또 섬진강은 옌나레 거 또 머	그 다음에 또 섬진강은 옛날에 거기에또 뭐
저네 저 저 하객 넘따라 강께로	전에 저 저 화개 남 따라 가니까
즈즈 고동 걷 돌 요리 들씨고 또 도루에도 시커머이 부터꼬	저 저 다슬기거기에 돌 요리 뒤집고 또 돌 위에도 시커멓게 붙었고
저 물따라서 저우에 올라강께 하개 올라가	저 물 따라서 저 위에 올라가니까화개 올라가
하개 그런디 막 올라가마 즈즈 무레 막 강에	화개 그런 데 막 올라가면 물에 막강에
그 고동이 마니 읻떼요 고동 고동도 작꼬 막 농꼬동거틍거또 익꼬	그 다슬기가 많이 있데요 다슬기 다슬기도 잡고 막 우렁이 같은 것도 있고
우럭거틍거또 이꼬 막 그러트마 그때 한해 언제 따라가봉께 저 하객꼬레 하개꼬랑	우럭 같은 것도 있고 막 그렇더군 그때 한해 언제 따라가 보니까 저 화갯골에화개 골짜기
옌나레 저 항포똗때달고 배떠 안하보이옛날에 저 황포돛대 달고 배 안 떠안 보  받찌요 마니 받찌	
받찌요 마니 받찌	봤지요 많이 봤지
뜨고 안핻슴니까	뜨고 안 했습니까
그거 우리는 여 하 저 섬진강을 머 오기는 여러번 와도 배뜨능거는 한분도 몬바꺼등녜	그것 우리는 여기에 하 저 섬진강을 뭐 오기는 여러 번 와도 배 뜨는것은 한 번도 못 봤거든요
몬받찌요 하모	못 봤지요 아무렴
옌날배 우째핸는지 생각나시능거 보싱거 얘기좀 해 주이소	옛날 배 어찌 했는지 생각나시는 것보신 것 얘기 좀 해 주십시오
옌날배 모 저젇 응 돋때배라고	옛날 배 뭐 저 저응 돛배라고
똗때배라고 배도 와 쪼끄만허이 쪼끄만허이 요만허이 해각꼬 그 막	돛배라고 배도 왜 조그만하게 조그만하게 요만하게 해 가지고 그 막
또 야파 배도 그 똗때배는 똗때배라고	또 얕아 배도 그 돛배는 돛배라고
그래가꼬 가운데다가 이리 왁 태국끼매이러막 다라가꼬	그래 가지고 가운데다가 이렇게 왜 태극기처럼 막 달아 가지고
막 이인젇 조중을 해각꼬 조중을 해각꼬 이리막 강에 댕기고 구러데요	막 이인제 조종을 해 가지고 조종을 해 가지고 이렇게 막 강에 다니고 그러데요
돋때배라고	돛배라고
그 사라미 마이 탐니꺼	그 사람이 많이 탑니까
마이 안타요 그어는	많이 안 타요 그것은
그거느 배가 요만해각꼬 작꼬 막 이리 야푸더마	그것은 배가 요만해 가지고 작고 막 이렇게 얕더구만
이 그시기 요리 야파농께 호가 야파농께	이 그슥이 요렇게 얕아 놓으니까 호가 얕아 놓으니까
마이 몬타걷떼요	많이 못 타겠데요
지끄믄 저읻	지금은 저 이
저네	전에
저 여페가 저어뎀미까 젇 어데 진함미꺼 강냥임니꺼 어딤니꺼	저 옆에가 저 어딥니까 저 어디 진하입니까 광양입니까 어딥니까
강냥도 익꼬 머 여러동네지 그거도	광양도 있고 뭐 여러 동네지 그것도
물건너	물 건너
절라도아임니까이	전라도잖습니까이
절라도	예 전라도
그라머 지끄믄 여 다리가 나서 왇따가고 하지마는	그러면 지금은 여 다리가 놓아져서 왔다 가고 하지마는
옌나레 업슬때	옛날에  없을 때
엄슬때	없을 때
그러먼 배마 왇따 배가 왇따갈꺼아임니꺼	그러면 배만 왔다 배가 왔다 갈 것이잖습니까
큰 배	큰 배
배 그거타고 꼬사리 끄너러가곧 저네는 그 물건네 여거 아걍 아걍꼴 사래미	배그것 타고 고사리 꺾으러 가고 전에는 그 물 건너 여기 악양 악양골 사람이
여 아걍꼴 사래미 전시 물건네가서 꼬사리 끄너고 나무해오고	여기 악양골 사람이 전신에 물 건너 가서 고사리 꺾어 오고 나무해 오고
나무 구걷 죽싸리그걷 이 여자드리 얼매나 이고오낑가욕 그 먼디로 가가꼬 물건네 나무가 기해가꼬	나무 그것 죽싸리 그것 이 여자들이 얼마나 이고 올 것인가요 그 먼 데로 가 가지고 물 건너 나무가 귀해 가지고
죽싸리 그걷 쪼깜 한발띠기해서 두메세메 뭉커가꼬 안푸러지거로	죽싸리 그것조금 한 짐 해서 두 줄 세 줄 묶어 가지고 안 풀어지게
치글 떼고 새끼르 까가고 막	칡을 떼고 새끼를 꼬아 가지고 막
엉쿼가꼬 이고 막	뭉쳐 가지고 이고 막
나무를 전시 여자드리 해각꼬	나무를 전신에 여자들이 해 가지고
그 배에다가 나무꺼지 시릉께로 사람도 한차 나무도 한차	그 배에다가 나무가지실으니까 사람도 한 차 나무도 한 차
그응께 배가 영 크지요 망 요리 커컫찌	그러니까 배가 영 크지요 막 요렇게커 컸지
그래갇 보리 매상허먼 보리바드러 그 사래미 오고 저 에동 귿	그래 가지고 보리 매상하면 보리 받으러 그 사람이 오고저 외돈 그
내 혼차 안다 그 에돈 사래미 해꺼등뇨 그 저젇	나 혼자 안다 그 외돈 사람이 했거든요 그 저 저
머시고 여리 요릳 가먼 그걷	뭐니 요리 요리 가면 그것
하동 가자먼 그걷 동네 마니 엄뜽가요 젇 마으레	하동 가자면 그것 동네 많이없든가요 저 마을에
마을 마이 읻찌요 엳 나가머	마을 많이 있지요 여 나가면
예예	예 예
그 에돈마을그 외돈 마을  거오저젇 태국기 다라노코 고옫 동사 익꼬 고 가는 큰지레 가는데	
거오저젇 태국기 다라노코 고옫 동사 익꼬 고 가는 큰지레 가는데	거기에 저 저태극기 달아 놓고 그곳 동사 있고 고기에 큰 길에 가는 데
거거예언자 그걷 싸래미 즈즏 사공을 해꺼등뇨	거기에 인제 그곳 사람이 저 저사공을 했거든요
사공이 머이냐하머인자 배 요리	사공이 뭐냐 하면 배 요렇게
우리들 가머 사람 마이 모이각꼬 건네주고	우리들 가면 사람 많이 모이 가지고 건너주고
또 올때데머 또 건네오고	또 올 때 되면 또 건너오고
그렁거 핻써요 멛차로 건네조	그런 것 했어요 몇 차례로 건네줘
하리예 멛뻔써 해꺼따 그지예	하루에 몇 번씩 했겠다 그죠
두서너분 해시끼구마 네버잉가 세버잉가 해스끼구마	두서너 번 했을 것이구먼 네 번인가 세 번인가 했을 것이구먼
사래미 마이 건네가	사람이 많이 건너가
시간 정해노코	시간 정해 놓고
시간 정해노코	시간 정해 놓고
시가늘 정해야지 앙그라모 머	시간을 정해야지 안 그러면 뭐
하모 정해노코 그리 사람 모이가꼬	아무렴 정해 놓고 그렇게 사람 모여 가지고
그렁께언자 우리드리언자 멛시예 간단다 그걸 아라가꼬 가지	그러니까 인제우리들이 인제 몇 시에 간단다 그걸 알아 가지고 가지  멛씨예 가네 해가꼬언자몇 시에 가네 해 가지고 인제
언자 그리막 준비르 해각꼬 나오능기라요	인제 그렇게 막 준비를 해 가지고 나오는거예요
나와각꼬언자 고사리 끄너러도 가고 먼	나와 가지고 인제 고사리 꺾으러도 가고뭔
너물캐러도 가고마 사람드리	나물 캐러도 가고 마 사람들이
우리동네 사람만 가자내 저 하펭 대촌 소징이 마	우리 동네 사람만 가지 않고저 하평 대촌 소징이 마
저 부황대 머 저 너메가머 그 에비당인는디	저 부황대 뭐 저 너머 가면 그 예비당 있는 데
입석 막 여러 동네사라미 오니까 마나요 사람 저네	입석 막 여러 동네 사람이오니까 많아요 사람 전에
그람 그사라믈 다 태아가오몬 배가 커야 데겓따 그지예	그러면 그 사람을 다태워서 오면 배가 커야 되겠다 그죠
그렁께 크고 여러봉 가고 오고	예 그러니까 크고 여러 번 가고 오고
그러고	그러고
그러먼 그 배는 도대체 사라미 멛사라미나 탈수 이슴니꺼	그러면 그 배에는도대체 사람이 몇 사람이나 탈 수 있습니까
구렁게막 한 시무리도 타고막	그러니까 막 한 스물도 타고 막
마이 타지요 마이 타고	많이 타지요 많이 타고
그거는 그라모 똡똗똗똗때배	그것은 그러면 돛 돛 돛 돛배
똡빼 아이라	돛배 아니야
하모 그걸 각꼬 이리이리 저서요 양쪼게서 양쪼게서 마	아무렴 그걸 가지고이리 이리 저어요 양쪽에서 양쪽에서 마
그렁께 사라미	그러니까 사람이
똗 또치 업시 그냥 배만 큼니까	돛 돛이 없이 그냥 배만 큽니까
그거는 배마 커	예 그것은 배만 커
그는 양쪼게서 이리 저서예	그것은양쪽에서 이렇게 저어요
양쪼게서 적꼬 그거는 대착 얼매나 시미 세야 데건능가요 사람 마이 타제	예 양쪽에서 젓고 그것은 대체 얼마나 힘이 세야 되겠는가요 사람 많이 타지
나무 막 한쭈게 착착 재노체 직쩜나무	나무 막 한쪽에 착 착 재어 놓지 각자나무
그래가꼬언잗 배가 딱 다아서언자 째매 조요 요쭈게 서쪼게 여 우리동네 오모	그래 가지고 인제 배가 딱 닿아서 인제  매어 줘요 요쪽에 서쪽에 여기에 우리 동네 오면
여여여 강건네 오모언자 그 에돈마으란데	여기 여기 여기에 강 건너 오면 인제그 외돈 마을이라는 데
언자 귿 단는디가 이승께막 큰 쎋 지동을 이리 바가노코	인제 그 닿는 데가 있으니까 막 큰 쇠기둥을 이렇게 박아 놓고
배가 요리오모막 창창 뭉커거등뇨	배가 요리 오면 막 친친 묶거든요
그래노코언자 우리가 내리능기라 나무이고 내리고 마 사람 내리고	그래 놓고 인제 우리가 내리는 거야 나무 이고 내리고 마 사람 내리고
그러고인자 똗 또인자 그리해 건네왇따가 또 건네가는 사람 이시먼 또 건네주고	그러고 인제 또 또 인제 그리해 건너왔다가 또 건너가는 사람 있으면 또 건너주고
언자 그 사래미 만날 읻짱그마 거인능기지 그래각꼬	인제 그 사람이 만날 아예 그냥 거기에 있는 게지 그래 가지고
보리농새 지멈 보리 바드러오고 나랑농새 지먼 나락 바드러오고	보리 농사 지으면 보리 받으러 오고 벼 농사 지으면 벼 받으러 오고
그 사래미요 백가 백가 그래써요 저네는	그 사람이요 백가 백가 그랬어요 전에는
그거 보리 함말 주고 또 나락 가시레 오모 나락 함말 주고 그래 배르 타고 댕긷써	그것 보리 한 말 주고 또 벼 가을에 오면 벼 한 말 주고 그렇게 배를 타고 다녔어
그기 도이라 처넨 나락	그게 돈이랴 전엔 벼
그런네예	그렇네요
저네는 나락 보리 그걸 각꼬 구리	전에는 벼 보리 그걸 가지고 그렇게
그 사래미 바드러오고 딱 추수 해노모	그 사람이 받으러 오고 딱 추수 해 놓으면
그 매매 몰랴나앋따가 함말써 디줃 디주모 조타고	그 매 매 말려 놓았다가한 말씩 되어 주 되어 주면 좋다고
그래가꼬 그 사람 묵꼬살고	그래 가지고 그 사람 먹고 살고
그 사라미 그사라미 돈사러 가능기른 그기다 그라머이	그 사람이 그 사람이 돈 벌러 가는 길은그것이다 그러면이
우리드리 주모언자 자기드른 먿 찌묵뜽가 머	우리들이 주면 인제 자기들은 뭐찧어 먹든가 뭐
머 어째등가언잗 하이튼가네 보리 나라기 도닝께 저네는	뭐 어쨌든가 인제 하여튼간에 보리 벼가 돈이니까 전에는
도느르 도니 기허니까	돈으로 돈이 귀하니까
도니 기허니깓 보리 나락 바다가써요	돈이 귀하니까 보리 벼 받아갔어요
그러몬 사공이 내나  요게	그러면 사공이 내나  요게
사공	사공
하동사라미란 말 아임니꺼이	하동 사람이라는 말이잖습니까이  내나 그거 에돈내나 그게 외돈
그러이까이	그러니까
그 사래미라	예 그 사람이야
그렁게 요게우리 하동사라미다이	그러니까 요게 우리 하동 사람이다이
지금도 아드른살고 주가부지는 죽꼬	예 지금도 아이들은 살고 자기들 아버지는 죽고
그러몬 요 배가 절로 너머가면 그 저쪼게서도 저쪼게는 사공이 업섣슴미꺼	그러면 요 배가 저리고 넘어가면 그 저쪽에서도 저쪽에는 사공이 없었습니까
이 사람 이 사래미다	이 사람 이사람이다
이 사람만 혼자 저쪼 저쪼게서올라카메는 저쪼게서도	이 사람만 혼자 저쪽 저쪽에서 올라고 하면은 저쪽에서도
고렁께 요사람 태여오지 저쭈그로 저쭉사라믈	그러니까 요 사람 태어오지 저쪽으로 저쪽 사람을
저 물건네 사람도 태와요	저 물 건너 사람도 태워와요
태와가꼬 또 난주저 사람들 절로 건네주야 데꺼 아임니꺼	태워와 가지고 또 나중에 저 사람들 저리로 건너줘야 될 것이잖습니까
또 그 사람 또 간다먼 저 어디 여거 여 서쪼게왇따가	또 그 사람 또 간다면 저 어디 여기 여 서쪽에 왔다가
이 저젇 여거 일보고 또 간다먼 똗 건네주고	이 저 저 여기 일 보고 또 간다면또 건너주고
그렁게 모이는 사라믈인자 요리요리 쪼깐 모우곧 지다리야지	그러니까 모이는사람을 인제 요리 요리 조금 모우고 기다려야지
알겓슴니다	예 알겠습니다
그래각꼬 핻써요 저네	그래 가지고 했어요 전에
그러먼녜	그러면요
거 강을 건너야 델꺼아임니꺼이	그 강을건너야 될 것 아닙니까
근데 강이언자 흘러앙감니꺼 요쪼그로	그런데 강이 인제 흘러가잖습니까 요 쪽으로
그람 배가 가모 바로 지내감니꺼 흘러가서 쫌 비스듬하이 저쪼글 감니꺼 우째됨니꺼	그러면 배가 가면 바로 지나갑니까 흘러가서 좀 비스듬하게 저쪽을 갑니까 어찌 됩니까
고만언자 이리이리 가모막 무리막 이리 치머	그냥 인제 이리 이리 가면 막 물이막 이리 치면
요만치 내러가도 그사람드리언자 조중을 해각꼬 그자리예 갇따 댈랑께	요만큼  내려가도 그 사람들이 인제 조정을 해 가지고 그 자리에 갖다 대려니까
대조야 요쭈게도언자 그그 익꼬 쎼말뚜기 익꼬 저쭈게도 과모 쎄말뚜기 익꼬헝게포가 딱 읻따 아잉가요	대 줘야 요쪽에도 인제 그 그 있고 쇠말뚝이 있고 저쪽에도 가면 쇠말뚝이 있고 하니까 표가 딱 있잖은가요
그렁께머 자꾸 대이상께 그 사람드른 머 잘허고	그러니까 뭐 자꾸 다녀 쌓으니까 그 사람들은 뭐 잘 하고
그래가꼬 딱 건넫 또 그짜가서 새끼 뭉커주머	그래 가지고 딱 건너 또 그쪽에가서 새끼 묶어 주면
그거 뭉커주모 똗 딱 우리가 완전허이 건네고	그것 묶어 주면 또 딱 우리가 완전하게 건너고
건네고 나먼언잗 자기는 또	건너고 나면 인제 자기는 또
또 거 태가고 요리 건네올 사람 이시먼 또 빙걸로 오니 태와가오고	또 그 태워가고 요리 건너올 사람 있으면 또 빈 걸로 오느니 태워서 오고
그러컨네예	그렇겠네요
그랟서요 저넨 그리 사랃써	예 그랬어요 전에는 그렇게 살았어
그러모 그 배타고 건네가능게 시가니 얼마나 걸림니꺼 한 삼십뿐 걸림니꺼	그러면 그 배 타고 건너가는 게 시간이 얼마나 걸립니까 한 삼십 분 걸립니까
하이고 마 막 그 언 저젇	아이고 마 막 그 인 저 저
에북 걸리지 하모 한 삼십분썽 먼 그리막 앙걸리건능가요 그 그래도 에복 진디 강이	제법 걸리지 아무렴 한 삼심 분씩 뭐 그리 막 걸리잖겠는가요 그 그래도제법 긴데 강이
바래미 망 내리치고 막하머 바람 따라서 막 또 요리 내리갇따가또 올라오고 막	바람이 막 내리치고 막 하면 바람 따라서 막 또 요리 내려갔다가또 올라오고 막
할머이 그라머 그 배가	할머니 그러면 그 배가
운제까지 이서슴니꺼 오새는 업따아임니꺼	언제까지 있었습니까 요새는 없잖습니까
요새는언자 엄서젇찌요 또 타고 대이다 안허고 다리가 이싱게 차로 댕기고	요새는 인제 없어졌지요 또 타고 다니지도 안 하고 다리가 있으니까 차로 다니고
그라모 그때 고기언자 다리예	예 그러면 그때 고게 인제 다리에
그렁께모두 멘년또 멘년허다가 간능걷또 모르건네 나는 그렁거는	그러니까 모두 몇 년도몇년 하다가 갔는 것도 모르겠네 나는 그런 것은
다리노키 저이겓따 그라모	다리 놓기 전이겠다 그러면
다리노키 저네요 다리엄슬쩌게	다리 놓기 전에요 다리 없을 적에
다리 멘년 다리 논제는 멘년덴능걷또 나 모리겓따	다리 몇 년 다리놓은 지는 몇 년 됐는 것도 나 모르겠다
골채이메너 만날 그렁거 기어글 안헝께	골챙이처럼 만날 그런 것 기억을 안하니까
아까 그쪼에 나무해가지고 올때 저쪼게서	아까 그쪽에 나무 해 가지고 올 때저쪽에서
죽싸리 해곤다 그랙꺼등녜	죽싸리 해서 온다 그랬거든요
죽싸리	죽싸리
죽싸리는 어떤 나뭄니꺼	죽싸리는 어떤 나뭅니까
구렁께 저젇 고 모린 나 솔깽이에서	그러니가 저 저 그 마른 나 솔가지에서
솔깨이 큰 솔깨이나무에섣	솔가지 큰 솔가지 나무에서
주군나무가 이써요	죽은 나무가 있어요
아러께도 내 말씀디릳찌마느	그저께도 내 말씀 드렸지마는
거거에서인자 착착인자 나틀 쫑그리등가 낟 잘 가 지비서 조케 가라가까 매들거 갈라 가등가 토블 가가등가 해각꼬	거기에서 인제 착 착 인제 낫을 든가낫 잘 갈 집에서 좋게 갈아 가지고 매 들게 갈아 가든가 톱을 가지고 가든가 해가지고
거거느언자 맥끄허이인자 죽싸리 해각꼬	그것은 인제 매끈하게 인제 죽싸리 해가지고
그거는 암무겁따그지예 주군나무라서	그것은 안 무겁다 그죠 죽은 나무라서
주군마무라서 그렁께로 그 먼 지레	죽은 나무라서 그러니가 그 먼 길에
쟈기가 덜렁덜렁 둘고 이고 막 건네고 배를 해야지	본인이 덜덜덜렁 들고 이고막 건너고 배를 해야지
무거부모 그 니가 그걷 지걷또 기차는디 해주건능가요	무거우면 그 누가 그것 제것도 귀찮은데 해 주겠는가요
아니 요 디예 마이 이슬껀데 와 저 건네꺼지 가슬꼬	아니 요 뒤에 많이 있을텐데 왜 저 건너까지 갔을까
몰라 저네는 나무가 기해각꼬	몰라 전에는 나무가 귀해 가지고
여거예 너머너머 마니 사래미 살고 허니까로	여기에 너무 너무 많이 사람이 살고하니까
나무도 읍스요 요런디	나무도 없어요 요런 데
아하아	아하
음서각꼬	없어 가지고
막 푼나무 그거 즈즏 그 머이고 쎋떼기나무	막 풋나무 그것 저 저 그 뭐니 억새나무
거거 이리이리 비각꼬 막 지찌움 막 졸조리 막 느러낟따가	그것 이리 이리 베어 가지고 막 각자 막 가지런히 막 늘어 놓았다가
지 구여기 이써요 요만치는 내거 저만치는 네거	제 구역이 있어요 요만큼은내 것 저만큼은 네 것
포를해서 느러노코 와요 그래야 집찌웅걸 또 이고오제 모리마 한이틀 모리모	표를 해서 늘어 놓고 와요 그래야 각자 것을 또 이고 오지 모르면 한 이틀 모르면
그러먼녜	그러면요
비가 오몬 또 가 들씨각꼬	비가 오면 또 가 들추어가지고
올라가서 들씨가꼬 또 몰랴 가꼬 또 해서 이고오고	올라가서 들추어 가지고 또말려 가지고 또 해서 이고 오고
그라머 할머이	그러면 할머니
그동네로 사라미 살낀데 요 강건너서 하동에서 옫따카모 저 사암드리 조아함니까	그 동네도 사람이 살 것인데요 강 건너서 하동에서 왔다고 하면 저 사람들이 좋아합니까
암머래 암머렁께 우리가 갇찌 거거요 항정엄씯 사니 커거등뇨	안 뭐라 해 안뭐라 하니까 우리가 갔지 거기요 한정없이 산이 커거든요
할머이 마을사람드리얼마 엄능가베예 그라모 그쪼게는	할머니 마을 사람들이 얼마 없는가 보네요 그러면그쪽에는
그쭈게는 지그믄 봉께 마니 읻떠마는 그때는 하이튼 나무해 때래써	그쪽에는지금은 보니까  많이 있더만은 그때는 하여튼 나무 해 때라 했어
나무해 때다 암머래	나무 해 때도 안 뭐라 해
저거네 실 하리실컨해 때도 요와서 해도 갠찬타 이 마리지예	실 하루 실컷 해 때도 요기와서 해도 괜찮다 이 말이지요
하머 사니 마느니까 그느 여거느 사니 내나 요리요리 쪽꼬	아무렴 산이 많으니까 거기에는 여기는 산이 내나 요리 요리 좁고
사니 여여 어디 인능가요 내나 요런디 요리지 사니 얼마 안데거등 요느	산이여기 여 어디 있는가요 내나 요런 데 요리지 산이 얼마 안 되거든 요기는
내나 요거서 내나 요리 질쭉허이 내나 요리 고이성 내나 삔탈	내나 요기에서 내나 요렇게 길쭉하게 내나 요리 고소성 내나 비탈
그러고맏 사라믄 마이 살제 전시네 집찌방 부를 때농께 저네는	그러고 마사람은 많이 살지 전신에 집집마다 불을 때 놓으니까 전에는
부를 때농께 나무도 마이 드러요	불을 때 놓으니까 나무도 많이 들어요
그래	그래
에이고이 할무이 이 얘기가 훨씬 재미인네 아까 얘기뽀다도	아이고 이 할머니 이 얘기가 훨씬 재미있네 아까 얘기보다도
아까는 할머니 목쏘리도 안나오더마느 언자는 목쏘리가 커다나이 나오네예	아까는 할머나 목소리가 안 나오더만은 인제는 목소리가 커다랗게 나오네요
빵을 무농께 그렁가베	빵을 먹어 놓으니까 그런가 보이
까야 무농께	과자 먹어 놓으니까
몰라 아까버네는 머이 또 구런이약헝께 구런 또 이약허고	몰라 아까 번에는 뭐또 그런 이야기 하니까 그런 또 이야기 하고
그러머 할머이언자 강은 익꼬	그러면 할머니 인제 강은 있고
여게 저수지도 어데 이슴니까	여기에 저수지도 어디 있습니까
저수지가 저걷 저거 젇저 주아미라고	저수기자 저기 저기 저 저 주암이라고
증스 우예요 증서우예 말허자먼 젇	정서 위에요 정서 위에 말하자면 저
민사무수	면사무소
우예가 증서거등 증서 우예 그거막	위에가정서거든 정서 위에 거기 막
큰 귿 주아미라곧 또 산중에 우리 고무찌비 저네 이써꺼등뇨 아부지 헹지가고모 킁고모	큰 그 주암이라고 또 산중에 우리 고모집이 전에 있었거든요 아버지 형제가 고모 큰고모
그 고무갇 지금도언잗 미느리드리 아들드리 살지마는	그 고무가 지금도 인제 며느리들이 아들들이 살지마는
귿 저수지가 그가먼 억수로 무서배 요리 샏찔로 요리 저수지 여 태산거치익꼬	그 저수지가 거기에 가면 억수로 무서워 요리 샛길로 요리 저수지 여기에 태산같이 있고
이런 소앧찔로 요리 저수지로 지내갈라모	이런 샛길로 요렇게 저수지로 지나가려면
고무집 갈라먼 바 바리 어씨그씨 그도 무서배서 요리 무리 시퍼렁께	고모집 가려면 발 발이 으스스 거기도 무서워서 요리 물이 시퍼러니까
아하	아하
무리 시퍼렁께 요리 샏찔로 요리 여건 저수지고 요리 가야뎅께고모지비를	물이 시퍼러니까 요리 샛길로 요리 여기는 저수지고 요리 가야 되니까고모집에를
요리 좀 도라갈라머마 저수지가 억수로 크데요 지금도 이이끼기마 거가	요리 좀 돌아가려면 마 저수지가 억수로 크데요 지금도 있을 게야 거기에
그 저수지예 머 얼킨 이얘기는	그 저수지에 뭐 얽힌 이야기는
거머	거기에 뭐
업슴니까	없습니까
고 내나 머 저저 어떤 사라미 머 거머 빠젇따 싸코 마 그러싸테요	고기에 내나저 저 어떤 사람이 뭐 거기에 뭐 빠졌다 쌓고 마 그러쌓데요
거 우리 동네가 아이라농께 저네 우리 고무집갈때 받찌	거기가 우리 동네가 아니라 놓으니까 전에 우리 고모집 갈 때 봤지
지금도 그 이시끼거마 하도 커농께 시퍼러이 무리 마 너머너머 커요	지금도 거기에 있을 게야 하도 커 놓으니까 시퍼렇게 물이 마 너무 너무 커요
저수지가	저수지가
그러먼녜	그러면요
그 저수지가 저읻서	거기에저수지가 저기에 있어
저요쪼그마 동정호라 캐씀니꺼  동정	동정
동정호 호수 호수로  안이슴니까 요미테 몯거틍거	동정호 호수 호수로  있잖습니까 요 밑에 못 같은것
동정	동정
동 거이 동정임니까	동 거게 동정입니까
동정이라 그러지 그마 우리보통 말	동정이라 그러지 그냥 우리 보통 말
동정카능 그이 내나 혿 호수마리지예 쪼그마난 몯	동정이라고 하는 그게 내나 호호수 말이죠 조그마한 못
예 몯	예못
고거는 우째생긴김니까	고것은 어찌 생긴 것입니까
울물 우째 생기요 개인 저네 거 몰밤 따고 그래써요 몰밤 아능가요	뭘 어찌 생겨요 개인 전에 거기에 마름 따고 그랬어요 마름 아는가요
모리제	모르지
물쏘게 인는 그거	물속에 있는 그것
까보모	까 보면
까씨까씨 까뭉능거	가시 가시 까 먹는 것
그  밤매커로 꼬소하고	그  밤처럼 고소하고
예예예	예예
그걸 따각꼬 언자 통을 저넨 나무통이 이썯거등뇨 고무통이나 지금 고무통 저렁기나	그걸 따 가지고 인제 통을 전에는 나무통이 이섰거든요 고무통이나 지금 고무통 저런 것이나
저네 고묻 나무통은 무를 씨머 무걱꼬 고무통 저렁걸 각꼬 가서	전에 고무 나무통은 물을 먹으면 무겁고 고무통 저런 걸 갖고 가서
막 이리이리 밀고대임서로 이 막 까시가 쿡 찔러비리고 막 오슬 두꾹끼 이벋따이버도 양발싱꼬	막 이리 이리 밀고 다니면서 이 막 가시가 쿡 찔러 버리고 막 옷을 두껍게 입었다 입어도 양말 신고
시는 몬신는기고 벅꺼지싸서 무링께	신은 못 신는 것이고 벗겨져 쌓아서 물이니까
양발마 뚜꾸웅구 신꼬	양말 마 두꺼운 것 신고
질기 오딕꼬 아라욷또리 뚜꾸웅거 익꼬 까시가 찔러비리싸니까	길게 옵 입고아래 윗 도리 두꺼운 것 입고 가시가 찔러 버리 쌓으니까
그래각꼬 막 기리 이리이리 밀고 감서로언잗	그래 가지고 막 이리 이리 이리 밀고 가면서 인제
그 몰밤 넝크리가 막 주룽주룽중중마	그 마름 넝쿨이 막 주룽 주룽 주룽 주룽마
막 까시고 몰부바미 막 이꺼드요 요릳 디지머	막 가시고 마름이 막 있거든요요리 뒤지면
요리 디비머막 시커머이 달릳써요	요렇게 뒤지면 막 시커멓게 달렸어요
그러먼 네모재비라 네모재비 몰밤거기 그래각꼬막 이 꼭때기	그러면 네모잡이야 네모잡이 마름 그게 그래 가지고 막 이 꼭대기
이읻 풀라무예막 그기 조롱조롱조롱종 달리꺼등뇨 그러먼자	이 이 풀나무에 막그게 조롱 조롱 조롱 조롱 달렸거든요 그러면 인제
여뭉거마 여뭉거느 꺼멍거마 여뭉기거등	여문 것만 여문 것은 꺼먼 것만 여문것이거든
새파랑거는언잗 손재비라고 안여무럳따고	새파란 것은 인제 손잡이라고 안 여물었다고
그래각꼬막 이리 까무머 영 다라요 푸빵까묵뜨끼 여 푿빰까묵떼끼	그래 가지고 막 이렇게 까먹으면 영 달아요 풋밤 까먹듯이 여 풋밤 까먹듯이
그래각꼬 그거인잗 여뭉거만막 따각꼬 사람드리 따각꼬막 한다라이 따각꼬 와요	그래 가지고 그것 인제 여문 것만 막 따 가지고 사람들이 따 가지고 막 한 다랑이 따 가지고 와요
막 이리즈리 온천지 직쩜 가고전대로 마 동기이 널버농께 이리즈리즈리 막대잉스르	막 이리 저리 온 천지 각자 가고 싶은 대로 마 동정이 넓으 놓으니까 이리 저리 저리 막 다니면서
그 따각꼬 막 와가꼳 도구통에다 막 씨러각꼬	그 따 가지고 막 와 가지고 절구통에 막 쓿어 가지고
왕녀네 도구통에서 씨리각꼬 씨리모언자 껍띠이 막 까시 그렁기막 이리이리막그해지거등	왕년에 절구통에서 쓿어 가지고 쓿으면 인제 껍질 막 가시 그런 게 막이리 이리 막 그렇게 해 지거든
그래각꼬막 칼크이 또 씨처각꼬 도랑사구에다 씨꺼가꼬	그래 가지고 막 깨끗이또 씻어 가지고 도랑사구에다 씻어 가지고
몰밤무글 맨드러요 막 도구통에 캉캉 찌멈 메물묵허드끼	마름묵을 만들어요 막절구통에 쾅 쾅 찧으면 메밀묵하듯이
찌멍 허헝가리가 나오거등뇨 그 끄믕 그그 몰바메	찧으면 허연 가루가 나오거든요 그 꺼먼 그 그 마름에
긍게 그거막 체예 그리고 얼기미예 그리고 막 걸러각꼬 짜각꼬 메물묵 허드끼	그러니까 그것 막 체에 그르고 어레미에 그르고 막 걸러 가지고 짜 가지고 메밀묵 하듯이
걸러각꼬 막 소굼한주묵 바다가 이릳 문때가꼬막	걸러 가지고 막 소금 한 주먹받아서 문질러 가지고 막
끼리노몬 몰밤내가 난듣허이 참 저네 마시 이석꺼마 몰밤무기	끓여 놓으면마름 내가 난 듯하게 참 전에 맛이 있었지 마름묵이
그래각꼬 묵끼리묵꼬 몰밤 따다가	그래 가지고 묵 끓여 먹고 마름 따다가
그라머 할머이 몰밤 안 이심니꺼 그 몰바미 물쏘게 이슴니꺼 물 우게 이슴니꺼	그러면 할머니 마름 있잖습니까 그 마름이 물속에 있습니가 물 위에 있습니까
소게	속에
물쏘게	물속에
소게 막 크데요	예 속에 막 크데요
그럼 이파리는	그러면 이파리는
이파리는 시퍼러이 막 우예 요리 둥둥뜨고 긍께 그걸각꼬언자	이파리는 시퍼러니 막 위에 요렇게 둥둥 뜨고 그러니까그걸 가지고 인제
요리막 요리 디시능기라 넝커리이르 요리	요렇게 막 요렇게 뒤집는 거야 넝쿨을 요렇게
아아	아
그래해 각꼬 몰밤 그걷 따능기라요	그래 해가지고 마름 그것 따는 거예요
그람 이파리를 보고	그러면 이파리를 보고
미테그 하메느 조롱조롱 달리	밑에 그 하면은 조롱조롱 달려
예예	예예
이긍기 익꼬 안이긍기 익꼬	익은 게 있고 안 익은 게 있고
하모 안 이긍거는 또 후제 따거로 나도비리고	아무렴 안 익은 것은 또 후에 따게 놓아 둬 버리고
크라고	크라고
그걷또 나락 여무디끼 언자 그 잔잔허이 마리자머 처메 여러가꼬 그리 여물거등뇨	그것도 벼 여물듯이 인제 그 잔잔하게 말하자면 처음에 열어 가지고 그렇게 여물거든요
그러니께 그렁께로 그런능기라	그러니까 그러니까로 그런 거야
지네도 익꼬 막 그러네	지네도 있고 막 그러네
그러모 몰바미	그러면 마름이
거 거 동정에마 이슴니까 다른데는 업슴니까	거기 거기 동정에만 있습니까 다른 데는 없습니까
딴데읍서요	딴 데 없어요
고고마 읻찌	고기만 있지
동정이 그라모 거 몰바미 그래 마낟따 마리지예	동정이 그러면 거기에 마름이그렇게 많았다 말이죠
저네는	예 전에는
지그믄 음써 싹 저리그막 고만 머시로가 파서 새로 맨드러빈농께	지금은 없어 싹 저렇게 그만 그만 뭐로 가지고 파서 새로 만들어 버려 놓으니까
그러슴니까	아 그렇습니까
저네 욕 고기 고기 자받써 이 그 가릴	전에 요기에서 고기 고기 잡았어 이 그 가리를
저네 남자드리요	전에 남자들이요
가리 요리 커기 해각꼬 징가리르 해각꼬마 턱텅망 이리망 무레가서 거머머	가리 요렇게 크게 해 가지고 진 가리를 해 가지고 턱 턱 막 이리 막 물에 가서 금으면
막 누지리머 여거 누지르고 저거 누지르고 누지르머	막 눌리면 여기 누르고 저기 눌리면
거 누지릉께	누르니까
여기 몰밤 맏슴니까 우게 올라옹거	이게 마름 맞습니가 위에 올라온 게
고래 몰밤이파리매이네	그래 마름 이파리처럼 이네
이파리 몰밤도 그라모 꼬치 핌니까	이파리 마름도 그러면 꽃이 핍니까
꼳 피지요	꽃 피지요
요 꼬치 몰밤꼭거치 생긷슴니까	요 꽃이 마름꽃같이생겼습니까
궁게 이머이 나부 나리 나부 나비꼰매이러 그러네 나부	그러니가이 뭐 나비 나리 나비 나비꽃처럼 그러네 나비
그스	그슥
몰밤도 꼬츤 피지예	마름도 꽃은 피죠
패요 핑께로 구리열매가 열고	펴요 피니까 그렇게 열매가 열고
하모 그걷또 마 가사가사허니 막 그래 까시가 마나	아무렴 그것도 하게막 그래 가시가 많아
그라몬 요거넌자 물우예 올라오 인능거아임니까	그러면 요것은 인제 물위에 올라와 있는 것이잖습니까
요 물우 우예 올라가익꼬 욤미테인자 이걷  들모 뎀니까	요기에 물 위에 위에 올라가 있고 요 밑에 인제 이것  들면 됩니까
그렁께 들씨요릳 디비	그러니가 뒤적여 요렇게 뒤집어
요걷 디빈다이	아 요것 뒤집는다이
아마 지바다게서 고마 요리 디비각꼬맘 무주꾼 이겅검만 따능기라	아마 제 바닥에서 그냥 요렇게 뒤집어 가지고 마 무조건 익은 것만 따는 거야
그러고 만 이 내비리모고마 지질로 또 가라안자각꼬	그러고 마 이내버리면 마 저절로 또 가라앉아 가지고
이리 띠치저이 어퍼저각꼬 지가 또 새로언잗 자리작꼬 짝언자	이리  엎어져 가지고 제가 또 새로 인제 자리잡고 쫙 인제
또 사는기라	또 사는 거야
무리이싱게	물이 있으니까
그러먼요미테 몰바미 얼마나 부터이슴니까 킁거 이걷또 킁기 익꼬 자긍기 익꼬그럳슴니까	그러면요 밑에 마름이 얼마나 붙어 있습니까 큰 것 이것도 큰 게있고 작은 게 있고 그렇습니까
쿤나무는 아예	큰 나무는 아예
마밤바가치도 따고 함바가치도 따고 머 그래	마반 바가지도 따고 한바가지도 따고 뭐 그래
하나미테	하나 밑에
요랑인능가요 하머	대중 있는가요 아무렴
하나미테	하나 밑에
그정도로 마이 열림니까	그 정도로 많이 열립니까
하머 마이 열리능거는막 조락조락 마이열고	아무렴 많이 열리는 것은 막 다닥다닥 많이 열고
언자 요걷또 능커리가 자그머 작끼 열고	인제 요것도 넝쿨이 작으면 적게 열고
그러컨네예	그렇겠네요
마는 거는 마이 열고 그래요	많은 것은 많이열고 그래요
그라모 동정에넌자 몰바미 유멩핻꼬	그러면 동정에는 인제 마름이 유명했고
먼 이파링고도 모르걷따 나팔꼳매이다 그 꼬치	무슨 이파리인지도 모르겠다 나팔꽃처럼이다 그 꽃이
하모 여 동정에 저네언자 그랟찌 저네	
하모 여 동정에 저네언자 그랟찌 저네	아무렴 여 동정에 전에 인제 그랬지 전에
지그믄 새로 삭 긍게 저기 개잉끼거등뇨 저네 개잉꺼	지금은 새로 싹 그러니까 저게 개인 것이거든요 전에 개인 것
개인니 저 대촌사래미 하펭 다메 대촌 미테 사래미 그 어르이 지금도 살앋꾸마	개인이 저 대촌 사람이 하평 다음에 대촌 밑에 사람이 그 어른이 지금도 살아있건마는
사란는디 참 부재찌비라 해꺼등뇨 그 지비 제일로 부재라 해꺼등 대촌서 마으레서 그랜는디	살았는데 참 부잣집이라 했거든요 그 집이 제일로 부자라 했거든 대촌서 마을에서 그랬는데
즈 머이고 저네 고맏 싸기 사비링기라 말히자마 저네는 저네는 그거 니한테다가 마리자마	저 뭐니 전에 그냥 싸게 사 버린 거야 말하자면 그것 뉘한테다가 말하자면
마리자머 나라핵 이마리자머 나락낀디 그 그시기 땅이	아 말하자면 나라의이 말하자면 나라의 것인데 그 그슥이 땅이
땅이 나라낀디거마 그사래미거마 똑또개 노응께로 영도노씨이라고 노간디 영둔 이르미 영둔노씨	땅이 나라의 것인데 그냥 그 사람이 그냥 똑똑해 놓으니까는영돈 노씨라고 노가인데 영돈 이름이 영돈 노씨
그런디 그사래미요 고맏 째낀주고 고맏 싸기 사빋때요 저네	그런데 그 사람이요그냥 조금 주고 그냥 싸게 사 버렸대요 전에
그 께가 망코막 그해농께 그렁 땅을그마 거머자븡께네	그 꾀가 많고 막 그래 놓으니까 그런 땅을 그냥 검어잡으니까는
그래해가꼬언자 싸기 산는디 이부넫 즈즏 그 사래미 안폴라느거 자꾸 포라고	그래 해 가지고 인제 싸게 샀는데 이번에 저 저 그 사람이 안 팔려 하는 것 자꾸 팔라고
허구해가꼬 구네서 도늘 영 마이 주고 삳때요 나는 머 모리능기고 도이 얼맹고도	하고 해 가지고 군에서 돈을 영 많이 주고 샀대요 나는 뭐 모르는 것이고돈이 얼만지도
이약또 똑띠 듣따 안핵꼬 도늘 마이 주고 개인한테 삳때 구네서	이야기도 똑똑히 듣지도 안 했고 돈을 많이 주고 개인한테서 샀대 군에서
그래각꼬 저걸또 멛딸로 머 일려니고 이녀이고막	그래 가지고 저걸 또 몇 달을 뭐 일 년이고 이 년이고 막
호구래이르가 저리조케 안해난능가요 지금 돈 덩거리라마 저걷또	포클레인을 가지고 저렇게 좋게 해 놓았잖은가요 지금 돈 덩어리야 마 저것도
저기 널비는 얼마나 뎀니까	저게 넓이는 얼마나 됩니까
선생니미 가바야지 내가 아능가 나도 고 고게	선생님이 가 봐야지 내가 아는가나도 고 고게
아니 그 대충 그 그때 큰	아니 그 대충 그 그때 큰
구겡앙간는디	구경 안 갔는데
커기가 여 어느어느정도 뎀니까 지금 저 동정이	크기가 여 어느 어느 정도 됩니까 지금 저 동정이
항정엄시 큰디	한정없이 큰데
그리 큼니꺼 그 아네	아 그렇게 큽니까
그인 보기는 저래도	예 그건 보기는 저래도
그 배르 배도 뜸니꺼	그 배를 배도 뜹니까
동정에 배 뜨능기 이슴니까	동정에 빼 뜨는 게 있습니까
지금 배는 안 뜨고 몰밤따서 우리가 몰밤	지금 배는 안 뜨고 마름 땄어 우리가 마름
아니 배를 떼아도 놀 정도가 뎀니까	음 아니 배를 띄워도 놀 정도가 됩니까
예 지금도 그러치	예 지금도 그렇지
지금언자 배떼운다고 마리 저리헌다대	지금 인제 배 띄운다고 말이 저렇게 한다하대
동정에	동정에
섿 예	셋 예
이리 부게	이렇게 북에
동정이 저짜게 솔라무 두개 인는데 그 근처 안이슴니까	동정이 저쪽에 소나무 두 개 있는 데 그 근처 있잖습니까
고렁게 그 목까서언자 거거 보이지	그러니까 그 못 가서 인제 그게 보이지
동정허곱 마주 배링이 보이지	동정하고 마주 벼랑이 보이지
그래 동정이지금 그 무리 완저니 저수지매크 가치인능거 아임니꺼	그래 동정이 지금 그 물이완전히 저수지처럼 갇혀 있잖습니까 예예 지굼 지금 가치가 읻찌요얘 예예 지금 지금 갇혀서 있지요
그리 조키 마 항정엄시 도늘 디리각꼬 호구래이하고마 메뻘가 허고 핻땅게요 맨드럳땅게	그렇게 좋게 마 한정없이 돈을 들여 가지고 포클레인하고 마 몇 번인가 하고 했다니까 요 만들었다니까
그래가 도늘 도를 이삐기막 가이로 뺑뺑 둘럳 싸낟띠요 지금	그래 가지고 돈을돌을 예쁘게 막 가에로 뱅뱅 둘러 싸 놓았데요 지금
내 참 갈때 만타 고소성도 가야데고	내 참 갈 데 많다 고소성도 가야 되고
그렁게 그으 스 그어도 하문 읻따가 가보소	그러니까 그것 성 그것도 한 번 있다가가 보소
동정도 가야 데고 저짜게 이게 어데라캔노 주암 저짜게 저수지도 가바야 데고 가따가 갇볼떼가 한두군데가 아이다 지금	동정도 가야 되고 저쪽에 이게 어디라고 했나 주암 저쪽에 저수지도 가 봐야 되고 갔다가 가 볼 데가 한두 군데가 아니다 지금
참말루	참말로
저수지도 커요	저수지도 커요
거도 야깡 크고	그것도 좀 큰 게아니고
그때막 즈수지 그거도막 하도 나리 그슥헝게 장녀넹가 재장녀잉가막 두기 터젇따 싸코마 그래사터마	그때 막 저수지 그것도 막 하도 날이 그슥하니까 작년엔가재작년인가 막 둑이 터졌다 쌓고 마 그래 쌓더마는
나는 나도 생지네 그 앙가봉께마 저네 우리 고무집 갈때 가 받찌	나는 나도생전에 거기에 안 가 보니까 마 전에 우리 고모님 집 갈 때 가 봤지
자 그럼 할머이 지금까지 그지예 아까 산 이얘기도 드럭꼬	자 그럼 할머니 지금까지 그죠 아까 산 이야기도 들었고
섬진강 얘기도 드럭꼬	섬진강 이야기도 들었고
저 우 저수지 얘기 드럭꼬 요 동정 머 호수 얘기도 드럭꼬	저 위 저수지 얘기도 들었고 요 동정 뭐 호수 얘기도 들었고
언자는 요 아페보모 마 들 안 느럼니 이리 너른데 우리나라 참 멕깨 엄꺼든녜	인제는 요 앞에 보면 마 들 넓잖습니까 이렇게 넓은 데 우리나라에 참 몇 개없거든요
그렁께	그러니까
요언자 드레 얼킨 얘기 좀 해주이소	요 인제 들에 얽힌 얘기 좀 해 주십시오
고롱께로 저 두리 저릳 조타곧 우리 박겡니선생니미 여따가 딱 안찌건능가요	그러니까는 저 둘이 저렇게 좋다고 우리 박경리 선생님이 여기에다가 딱 찍지 않았는가요
그이니까 고언자 그 박겡니서앵니믄 디예 찌걱꼬	그러니까 그 인제 그 박경리선생님은 뒤에 찍었고
웃음	웃음
그 저네도 드른 이서이니까 박겡니 수이응 하기 저네돋	그 전에는 들은 있었으니까 박경리 선생님 응 하기 전에도
저네	전에
저네는 그렁께 저저 무디 저 둥마가낟찌요	전에는 그러니까 저 저 무데미 저둑 막아 놓았지요
여 질라고	여기에 길 나고
저 둑 저젇 비다가 말고 비다가 말고 해농게 저 포가 나네요 허허이	저 둑저 저  베다가 말고 베다가 말고 해 놓으니까 저 표가 나네요 허옇게
저 차가고 인는 저게	저 차 가고 있는 저기에
여여 아페 여거 아페	예여 여 앞에 여기 앞에
허허이 저저 나랑논여페 허허이 인는 저거는	허옇게 저 저 벼논 옆에 허옇게 있는 저것은
두긴디 인자 마리자머 푸를 베농께 깨끋허고	둑인데 인제 말하자면 풀을 베어놓으니까 깨끗하고
여페 풀 안벤디는 저 시프르고 구루네요	옆에 풀 안 벤 데는 저 시퍼렇고 그렇네요
그러네예	그렇네요
그기 두기라	그게 둑이야
아아 하	아 하
긍게 저네 둑 저거는 암마가가꼬 저리 뺑뺑 지그믕 부글 마악꺼등뇨	그러니까 전에 둑 저것은 안 막아 가지고저리 뱅뱅 지금은 둑을 막았거든요
두글	둑을
부글 저리 마가스 지금 나라글 해 뭉능기라요	둑을 저렇게 막아서 지금 벼를 해 먹는 거에요
그애스 엔나레 저 둑 안할때는	그래서 옛날에 저 둑 안 할 때는
둑 안헐때는 그만 비가 오 이번매이러막 까래매이러 오모고맏	둑 안 할 때는 그냥 비가 오 이번처럼 막 그제처럼 오면 그냥
싹 고마 무리그맏 올렁해비리모고만 나락글 몬해묵꼬 몬해묵꼬 용만보지	싹그냥 물이 그냥 잠겨 버리면 그냥 벼를 못 해 먹고 못 해 먹고 고생만 하지
몬해묵꼬	못 해 먹고
그래서 무디밈니꺼	그래서 무디미입니까
그렁께 무디미 농새 니 키우먼 니를 잘몬 키우먼 무디미농새르 짇따 그러고 그랙꺼등뇨	예 그러니까 무디미 농사 누에 키우면 누에를 잘못 키우면 무디미 농사를지었다 그러고 그랬거든요
무디미 저거	무디미 저것
그렁께 저걷 뚝 저걸 그래각꼬언자	그러니까 저것 둑 저것을 그래 가지고 인제
뺑뺑 둘러 저 노피언자 마가논니까 지금 나라글 잘해뭉능기라요 긍게 배가 부리다능기라 사람드리	뱅뱅 둘러 저 높이 인제 막아 놓으니까 지금 벼를 잘 해 먹능거에요 그러니까 배가 부르다는 거야 사람들이
양서글 마니 허니까 보리 가라묵꼬 나락 해묵꼬	양식을 많이 하니까 보리 갈아먹고 벼 해 먹고
그라모 그어는 무리 저 우서부터 내러오는 물 때무네 몬해무따 이 뜯	그러면그것은 물이 저 위에서부터 내려오는 물 때문에 못해 먹었다 이 뜻  그렁께 저네그러니까 전에
섬진강무리 차올링기 아이고	섬진강 물이 차 오른 게아니고
그으도 차 오리고	거기에서도 차 오르고
그으도 오르고	아거기에서도 오르고
디러오고	들어오고
저우 강이 또 엄뜽가요 저 우예 가모와	저 위 강이 또 없던가요 저 위에 가면왜
읻떼예	있데요
그 학쪼 인는데 그거서	그 학교 있는 데 거기에서
그또 섬진강 그 강이 이서	거기에 또 섬진강 그 강이 있어
섬진강으 흘러  가는 낵까다 그지예	섬진강으로 흘러가는 냇가다 그죠
하모 흘리가지 예낵까	아무렴 흘러가지냇가
낵가 그그도 막 고둥작꼬 그러거등뇨 사암드리 봄데머	냇가 그기도막 다슬기 잡고 그러거등요 사람들이 봄 되면
새카머이 막 도레	새카맣게 막 돌에
고딩이 마니 이써요	다슬기가 많이 있어요
그렁께 나는 만날 고만 바뿌고막 고둥 자받따가 암묵꼬 허지마는	그러니까 나는 만날 그만 바쁘고 막 다슬기 잡아다가 안 먹고 하지마는
막 여거 사람도 고둥자브러 그거 막 낵까에 마이 가거등뇨 봄데머	막 여기 사람도 다슬기 잡으러 거기 막 냇가에 많이 가거든요 봄 되면
가가꼬 막 함바가치석 자바 쌀마묵꼬 그 무레 시퍼렁 고둥무레	가 가지고 막 한바가지씩 잡아 삶아 먹고 그 물에 시퍼런 다슬기물에
즈즏 죽또 국시돋 미러여가꼬 죽또 끼리묵꼬 막 그래싸커등	저 저 죽도 국수도밀어 넣어 가지고 죽도 끓여 먹고 막 그렇게 해 쌓거든
요새치며 그거 진짜 겅강시김니더 그 시퍼렁 고동물그거	요새 치면 그것 진짜건강식입니다 그 시퍼런 고동물 그게
예예 그랟 떱떠허이 맏또 엄떠마	예 예그래도 텁텁하니 맛도 없더마는
얼매나	얼마나
웃음	웃음
재첩그어 우째 묵슴니꺼 다 조타카이 묵찌	재첩 그것 어떻게 먹습니가 다 좋다고 하니 먹지
그렁께 예	그러니까예
그걷또 그 재첩도 내나 시퍼러이 노온다아임니꺼 그걷또 으으	그것도그 재첩도 내나 시퍼러니 나오잖습니까 그것도 응
그래머 어짿뜬 요동네는 축복바든 동네네예	그래 뭐 어쨌든 요 동네는 축복 받은 동네네요
그렁게 벨게 다 읻찌	그러니까 별 게 다 있지
고둥도 저젇 낵까에 쌛쩨 머	다슬기도 저 저 냇가에 많지 뭐
마 안해무거서 그러치마 시펄핻써 시컴핻써 도레	마 안 해 먹어서 그렇지 마시퍼러했어 시커머했어 돌에
건네가머	건너가면
그러믄녜	그러면요
또언자 요 꼴짜기 이 머 이르믄 머 업슴니까 꼴짜기 얼킨이른 업슴니까	또 인제 요 골까기 이 뭐 이름은 뭐 없습니까 골짜기 얽힌 일은 없습니까
꼴창머 꼴착꼴착 저리마 온 자우예도 가모 동네 마나요	골짝 뭐 골짝 골짝 저리 마 온 저 위에도 가면 동네 많아요
그렁께 그 젤로 막빠지가 꼴착 이르미 저적 그 펭촌	그러니까 그 제일로 막바지가 골짝 이름이 저 저 그 평촌
펭촌 먼동네 먼동네망 즈즈즏 젤로 펭초니 막빠지고 꼭때기고	평촌 뭔 동네뭔 동네 막 저 저 저 제일로 평촌이 막바지고 꼭대기고
또 그귿 네러와서 그거가머 즈즈즈 머이고 먼학교고	또 그것 내려와서 그것이뭐 저 저 저 뭐니 뭔 학교니
저네 매게하꾜 매게라고 또 매게학꾜라 허고	전에 매계학교 매계라고 또 매계학교라 하고
매게학꾜 지금 먹	매계학교 지금 뭐
학쪼 아드리 업서 농께로 애기드리 안농께	학교 아이들이 없어 놓으니까는 기들이 안 놓으니까
저네는 매게학꾜 젇 축게학꾜 저건네 강건네 축게학교 여 아걍학꾜	전에는 매계학교 저 축계학교 저 건너 강 건너 축계학교 여기 악양학교
그리 세군데 영고만 날리꾸마 깁빨날렫꺼마	그렇게 세 군데 영 그냥 날렸었어 깃발 날렸었어
학조 막 마나각꼬 세군데 학꾜가	학교 막 많아 가지고 세 군데 학교가
여궁민학꾜 저 매게학꾜 저 무뤼예 올라가마 또 저 축게학꾜 저 축게학꾜가어디냐 허모 여귿	여기 국민학교 저 매계학교 저 물 위에 올라가면 또 저 축계학교 저 축계학교가 어디냐 하면 여기
여여여이 저 차오지요 차 오제 저 건네 저 또 축게학꾜 이석꺼등뇨	여기 여기 여기 이 저 차 오지요 차 오지 저 건너 저 또 축계하교 있었거든요
여그 아걍학꾜매이로 구리 세군데다 학꾜가 영 크고 조악꺼등뇨	여기 악양학교처럼 그렇게 세 군데 다 학교가 영 크고 좋았거든요
궁민학꾬니까	국민학굡니까
궁민학꾜	예 국민학교
그랜는디 지그믄 저 매게학꾜허고 여읃 동쪼게 학꾜허고는 읍스저빋따잉가요아드리 업서가꼬	그랬는데 지금은 저 매계학교하고 여기 동쪽의 학교하고는 없어져버렸잖아요 아이들이 없어 가지고
음스저 비리고언자 여 여 우리학꾜가 젤로고만 싹 합해비찌	없어져 버리고인제 여기 여기 우리 학교가 제일로 그만 싹 합해 버렸지
소히 댕기는데	소희 다니는데
소히 댕긴데	예 소희 다니는데
그 항군데뿌니 엄서요 아드리 업서각꼬 저네는 그렁께 여거 우릳	그 한 군데뿐이 없어요 아이들이 없어 가지고 전에는 그러니까 여기 우리
한날 안 허 한날만 안허머 여거 아걍학꾜 운동허먼 또 구겡간다고 저 막 축게학꾜 구겡가고 우리가 건네가고 그랟써요	한 날 안 하 한 날만 안 하면 여기악양학교 운동하면 또 구경간다고 저 막 축계학교 구경가고 우리가 건너가고 그랬어요
그랜는디 지금 아드리 항개도 업서농께로 한학꾜다 보태도 머 내나 뱅메이라란디 싹다 소히 대이는 데	그랬는데 지금 아이들이 한 개도 없어 놓으니까는 한학교에다 보태도 뭐 내나 백 명이라는데 싹 다 소희 다니는 데
뱅멩뿌이 안덴단디 긍게 일반 이반뿌이 엄땅께	백 명뿐이 안 된다는데 그러니까 일 반 이 반뿐이 업다니까
그러모 그 매게학꾜하고 축게학꾜하고	그러면 그 매계학교하고 축계학교하고
읍스저비리고 지금 머	없어져 버리고 지금 뭐
업서진지가 오래덷슴니까 제법	없어진 지가 오래 됐습니까 제법
하모 멘년 덷찌요	아무렴 몇년 됐지요
고래가꼬 저 거거는 머 머 머 개춘다더라 하이튼 즈즏	그래 가지고 저 거기는뭐 뭐 뭐 가르친다더라 하여튼 저 저
매게학꾜는 멀 새롣 학쭁응께로 교실로 싹 그해가고 새로 조키언잗 도늘 디리곤치가꼬	매계학교는 뭘 새로 학교니까는 교실을 싹 그래 해 가지고 새로 좋게 인제돈을 들여 고쳐 가지고
재장녀넹가 머 장녀엥게 득끼예 즈즌 모 추물 개춘다더냐 머 노래부른 사라믄	재  작년엔가 작년엔가 듣기에 저 저 뭐 춤을 가르친다더냐 뭐 노래 부르는 사람은
노래부르는 사라믄 머 개춘다더냐 하이튼 머이 우녕을 헌다 그래사테요	노래 부르는 사람은 뭐 가르친다더냐 하여튼 뭐 이 운영을 한다 그렇게 해 쌓데요
거도 우녕을 헌데 멀 머 헌데 거기는	거기에도 운영을 한데 뭘 뭐 한데 거기는
그엄 축게는 머함니꺼	그럼 축계는 뭐 합니까
축게도 머 축게는 저거 머이곧	축계도 뭐 축계는 저것 뭐니
그땍 공고골로자 지레 저런디 대임서 허 봉께로	그때 공공근로자 길에 저런 데다니면서 하 보니까는
우리 그어가 점심묵꼬 그러거등뇨 거어가 그거 드러가서언자 나무미테언자 그느렏 덕꼬허니까 여르메 허면서	우리 거기에 가 점심 먹고 그러거든요 거기에 가 거기 들어가서 인제 나무 밑에 인제 그늘에 덥고 하니까 여름에 하면서
드리가머 그어는 아무걷또 응꼬 비아가 읻떼 고시리 비아가 이써	들어가면 거기는 아무 것도 없고 비어서 있데 교실이 비어서 있어
저거저거로마 내가 사까	저것 저것을 마 내가 살까
사가지고 거도 거도	사 가지고 거기에도 거기에도
텅머 하나 해가지고 모두	턱 뭐 하나 가 가지고 모두
그래 구래허모 조치	그래그래 하면 좋지
그래 고는 비아가꼬 인능중아지 내가 나 여거라도 저거르 앙가니까로 머 똑띠이 모리걱꼬	그래 고기는 비어 가지고 있는 중 알지 내가 나는 여기라도여기 있어도 저기를 안 가니까는 뭐 똑똑히 모르겠고
언자 머르 허능갑지	인제 뭐를 하는가 보지
그 매게하고 축게하고 그 학교가 좀 크기는 컫슴니까 아니먼	그 매계하고 축계하고 그 학교가 좀 크기는 컸습니까 아니면
크거마 운동장	크고말고 운동장
여이 궁민학꾜매이룩 그리 커지요	여기 이 국민학교처럼 그렇게 크지요
아걍맹크로	악양처럼
아걍매이로 커요	예 악양처럼 커요
세군데 다 학쪼는 마 항정업시 널러요	세 군데 다 학교는 마 한정없이 넓어요
여 자리가 맘 터가 마나각꼬 항점시 널러	여 자리가 마 터가많아 가지고 한정없이 널러
하모 세군덷 학쪼가 마 항정업시 너리지	아무렴 세 군데 학교가 마 한정없이넓지
이나 이 아걍학꾜가 덛 쪼븡가 모르걷따 항정업시 널러요 매게도 너리고 여축게도 너리고	오히려 악양학교가 더 좁은가 모르겠다 한정없이 넓어요 매계도 넓고 여기 축계도 넓고
그러먼 매게하고	그러면 매계하고
즈즏	저 저
축게하고 요걷또 내나아걍메니지예	축계하고 요것도 내나 악양면이지요
아걍멘	예 악양면
그라멘 아걍면 매게리 축게리	그러면 악양면 매계리 축계리
예예 그렁께	예그러니까
요 우리가 펭사리하드시	요 우리가 평사리 하듯이
펭사리허고	예 평사리하고
이리미인자 그 직쩜 이르 이리 이림 이싱께 매계학쪼 여 아걍학쪼 즈즈즈  축게학꾜	아 이름이 인제 그 각자 이름 이름 이름이 있으니까 매계학교 여기 악양학교 저 저 저 축계학교
축게학꾜	축계학교
그래핻찌요	그렇게 했지요
그래해가꼬 마 차말로 사람 마낙꾸마 저네는 참말로	그렇게 해 가지고 마 참말로 사람 많았었지 전에는 참말로
진짜 마 아도 망코 마 저네는 말큼 먿 한지베 달 다서시고 머 야달비고 노코헝께로 학상도 망코헝께로	진짜 마 아이도 많고 마 전에는 모두 뭐 한 집에 달 다섯이고 뭐 여덟이고 낳고 하니까 학생도 많고 하니까는
글케 우녕을 잘허다마는 그만 대차 머 아로 안농께로머 아드리 머 읻써야제	그렇게 운영을 잘 하더마는 그만 당최 뭐 아이를 안 낳으니까는 뭐 아이들이 뭐 있어야지
이동네 머 일항년도 후년에 항개도 업시끼고 머 궁민학쪼 일항년도 항개도 업으끼라	이 동네 뭐 일학년도 내년에 한 명도 없을 게고 뭐 국민학교 일학년도 한 명도없을 거야
올해	올해
저 그라모 이 동네예그지예 음	저 그러면 이 동네에 그죠 음
저리 저 한산사 익꼬 한산사 하나 이슴니까 또 다이 또 이슴니까	절이 저 한산사 있고 한산사 하나 있습니까 또 다른 또 있습니까
한산사 그우 뿌이라요 그꼴창에는	한산사 그 뿐이라요 그 골짝에는
절 하나	절 하나
그어고 막	거기고 막
저거예 머 미륵띠이라고 익꼬 저쪼게 머 익꼬 저건네도 익꼬 막 저른 머 여러개 이찌 마 수무 안자서 그러치	저기에 뭐 미륵등이라고 있고 저쪽에 뭐 있고 저건너에도 있고 막 절은 뭐 여러 개 있지 마 숨어 앉아서 그렇지
그럼마 그런디 내 앙가니까 머 나 요 요거뿌이 모리지	그래 마 그런 데 내 안가니까 뭐 나는 요 요것뿐이 모르지
저 꼴착꼴착 읻떼요 저리 저저저 갣치 갣치 그거도 또 익꼬 올라가마	저 골짝 골짝 있데요 절이 저 저 저 곗치 곗치 거기도 또 있고 올라가면
갣치도 익꼬 머 저거도 익꼬 저 사네도 익꼬 막 꼴착꼴착 읻떼요 저리	곗치도있고 뭐 저기도 있고 저 산에도 있고 막 골짝 골짝 있데요 절이
저른 그래익꼬	아 절은 그렇게 있고
저른 마 꼴착꼴차아 익꼬	절은 마 골짝 골짝에 있고
그람 여개 성당이이슴니까	그럼 여기에 성당이 있습니까
성당이 머잉가요 에비당	성당이 뭣인가요 예배당
예비당	예배당
쎄비릳찌 여 세군데나 읻찌 여거	많지 여기에 세 군데나 있지 여기
요게예	여기에요
으으	음
여거 익꼬 저걷	여기에 있고 저기
교헤카능거	교회라고 하는 것
디헤하모	뒤에 아무렴
그거 쫌 말씀 쫌 해 주이소	그것 좀 말씀 좀 해 주십시오
머이라고 내 가다안허는디	뭣이라고 내 가지도 않는데
마 머 언 대충 머 운제 지언는지	마 뭐언 대충 뭐 언제 지었는지
요거에는 일룔 토욜 허데요	요기에는 일요일 토요일 하데요
일룔 토욜 사람드리 가 일료날 가데	일요일 토요일 사람들이 가 일요일날 가데
일료	일요
또 요거사라미 요걷 요 새미꺼리 여 미테 할매	또 요기사람이 요기 요 우물걸 여 밑에 할머니는
에는 또 하동으로 또 가데 여 정서 댕기더마 하동으로 또 태이오고 태오고 차가오고	여기는 또 하동으로 또 가데 여기 정서 다니더만 하동으로 또 태워 오고태워 오고 차가 오고
그람 동네사람드른 주로 그럼 저레는 마이 감니까	그러면 동네 사람들은 주로그럼 절에는 많이 갑니까
저레나 가지 여 안댕기 우리 동네는 아무도 안댕기저 할매마 댕기	절에나 가지 여기 안 다녀 우리 동네는 아무도 안 다녀 저 할머니만 다녀
서울서 와각꼬 여거 사라민디 여거 여 우따메 사다가 저네 우따메 여여여 지금그 머이고	서울서 와 가지고 여기 사람인데 여기 여 윗마을에 살다가 전에 윗마을에 여 여 여 지금 그 뭐니
그 술 폰다고 이리미 머이더이로 길쌩이 길쌩이 이	그 술 판다고 이름이 뭐더냐 길상이 길상이 이
그 지비 할머이가 사란는디 처메느 이 우따메 사란는디 저네 할매 하라씨	그집에 할머니가 살았는데 처음에는 이 윗마을에 살았는데 전에 할머니 할아버지
사란는디언자 우 아래따므로 이새르 가각꼬언자 지블 지각꼬 저리 사는디	살았는데 인제 윗 아랫마을로 이사를 가 가지고 인제 집을 지어 가지고 저렇게 사는데
그 서울 가서 읻따가 요리 오고마 그래각꼬언자 메느리랑 또 아드랑 여거 살로온다고 씨어매 혼차 인는디	그 서울 가서 있다가 요리 오고 마 그래 가지고 인제며느리랑 또 아들이랑 여기에 살러 온다고 시어머니 혼자 있는데
저네 노할매 머 씨아배 다 죽꼬 여거서 다 초상치고	전에 노할머니 시아버지 다죽고 여기에서 다 초상치고
아드랑 온다고 막 샏 지베다 새 저 싱크대랑 새로 또 어저께 싹 디리데요	아들이랑 온다고 막 새 집에다 새 저 싱크대랑 새로 또 어저께 싹 들이데요
아드리랑언자 서울서 살라온다고 요리 메느리가 온다고 아들메느리가 그 사람드리 지익꺼등	아이들이랑 인제 서울서 살러 온다고 요리 며느리가 온다고 아들 며느리가 그 사람들이 지었거든
메느라 아드리막 돈도 망코막 지기저 오두매이로 항개 터를 사농께로	며느리아들이 막 돈도 많고 막 저기 저 오두막을 한 개 터를 사 놓으니까는
지블 고마 조키 짇떼요 지각꼬언잗 할매 혼차 사란는디 그 할매가언자 에비다아 댕기지	집을 그냥 좋게 짓데요 지어 가지고 인제 할머니 혼자 살았는데 그할머니가 인제 예배당에 다니지
정서 댕기더마느 내나 여너멛 정수가자메 여너메 그 예비당 엄뜽가요 지레	예 정서 다니더마는 내나 여 너머 정서 가자면 그 예배당 없든가요길에
부항대	부황대
킁거하나 읻떼예	큰 것 하나 있데요
안뚜무그가 부항대 동네가 부항대라	예 안뚜물 거기가 부황대 동네가 부황대야
하모 큰질로 요리 도라가머	아무렴 큰 길로 요렇게 돌아가면
요 그때 소개해준 식땅아니 머슨식땅 캗슴니까 남해식땅	요기 그때 소개해 준 식당 하나 무슨식당이라고 했습니까 남해식당
남해식땅	남해식당
남해식땅 바로 그 근처 하나 읻떼예	남해식당 바로 그 근처에 하나 있데요
고롱께 고고 거 남해식땅 목까서	그러니까 그 그 거기 남해식당 못 가서
예 예	예 예
고고 고거이	고것 고것이
그기 머슨	그게 무슨
그기언잗 즈즏	그게 인제 저 저
안뚜무리니라 그가 동네가 부항대 부항대	안뚜물이니라 거기가 동네가 부황대부황대
부항대	부황대
부항대라도 허고 마 안뚜무른 요쭈게 차타는데그다	예 부황대하고도 하고 마 안뚜물은 요쪽에 차 타는 데 거기다
거 부항대라 허네요 마을이리미	거기 부황대라 하네요 마을이름이
그라고 저기	그리고 저기
거게 이써	거기에 있어
아까 할머이 그 저게 욷따미라 그랟찌예	아까 할머니 그 저기 웃땀이라고 그랬지요
우땀 여거	윗마을 여기
그래 우따미라능게 여게 상평 아네서 우땀이지예	그래 윗마을이라는 게 여기 상평 안에서 윗마을이죠
여거 내나 여거 대찌비 살거등 대까호 지금	예 여기 내나 여기 대여섯 집이 살거든 대여섯 가호 지금
그러머 아래땀도 이씀니꺼	그러면 아랫마을도 있습니까
아래따믄 우리 사는디 그거 새미인는디	아랫마을은 우리 사는 데 거기 우물 있는 데
그러모 여게 겔구게 상평에는 모두 멕까구가 삼니꺼	그러면여기에 결국에 상평에는 모두 몇 가구가 삽니까
육씹가구 덴다네요 지그믄	육십 가구 된다네요 지금은
그람 육십가구 중에서	그러면 육십 가구 중에서
욷따메는 얼마나 삼니까	윗마을에는얼마나 삽니까
그렁께 내낟 다섣찌빙가 사라요 요래 돌개돌개	그러니까 내나 다섯 집인가 살아요 요렇게 도리도리
저쪼게	저쪽에
저쪼게	저쪽에
내나 요거요 올로 요리 차로 올로오몬 구굳 지 민박허고 그 너메 그귿	내나 요기 요 올라 요리 차로 올라오면 그것 저 민박하고 그 너머에 그것
할매 내나 두찌비 요쪼게 와 세찝 두찌비 저거 다섣찌비 사네	할머니 내나 두집이 요쪽에 왜 세 집 두 집이 저기 다섯 집이 사네
그람 그 빼고나먼 점부다	음 그러면 그것 빼고 나면 전부 다
그이 우땀	그게 윗마을
우따미고 그 빼고나몬 점부 아래따밈니까	윗마을이고 그 빼고나면 전부 아랫마을입니까
그럼 요게는 무슨 따밈니까	그러면 여기는 무슨 담입니까
내나 여거도 우따미지 마리자모	내나 여기도 윗마을이지 말하자면
마리자우따민데 사라미 안사라서 어어 그러슴니까	말하자면 윗마을인데 사람이 안 살아서그렇습니까
요거이 너무 바치거드	예 요게 남의 밭이거든
너무 바츠 사각꼬 내나 이 삼년 댇써요	남의 밭을 사 가지고 내나 이 삼 년됐어요
그라머 욷따믄 욷따메 그라모 옌나레는 욷따메 멛찌비나 사랃슴니까 옌나레 동네 클 때는	그러면 윗마을은 그러면 옛날에는 윗마을에 몇 집이나 살았습니  까 옛날에 동네 클 때는
저네는 마이 사랃찌요	전에는 많이 살았지요
저네는 에북 마이	전에는 제법 많이
한 멛 멛찝	한 몇 몇집
삭 지블 뜨더비서 그치	싹 집을 뜯어 버려서 그렇지
저네는 여고 한 한 시무찌비나 사랃씨끼구마요	전에는 여기에 한 한 스물 집이나 살았을 것이에요
그기 요버넨자 요게 한옥 만든다고 다 뜩낀김니까	그게 요번에 인제 한옥 만든다고 다 뜯긴 것입니까
그게 아니고 구거는언자 너먹 저거 노늘 사가꼬 지금 징기고 노늘 논 그 나랑노이거등뇨 저네	그게 아니고 그것은 인제 남의 저게 논을 사 가지고 지금 지은것이고 논을 논 그 벼논이거든요 전에
나랑논 너무 쭉 도가리도가리도가리도가리 이선는디 나락 보리 을마나 잘해무건는디	벼논 남의 죽 도가리 도가리 도가리 도가리 있었는데 벼 보리 얼마나 잘해 먹었는데
언자 감나무로막 주리 숭구각꼬 이글래 감나무르 숭구곤 이 즈즌 녹차나무를싱꼬 그래해각꼬 그 임재가요 지금	인제 감나무를 막 저렇게 심어 가지고 이 근래감나무를 심고는 이 저 저 녹차나무를 심고 그래해 가지고 그 임자가요 지금
저 요리 가자머귿 그 머시곧 킁기애집 그거 머이곧 이장지비 이장점빠아몬가서 그거	저 요렇게 가자면 그 그 뭐니 큰 기와집 그것 뭐니 이장집이 이장 가게에 못 가서 그것
먼 즈즈 이름써낭능고 모르걷따 그 밥 폴고 밥짱사허는 지비 그 머이고	뭔 저저 이름 써 놓았는지 모르겠다 그 밥 팔고 밥장사하는 집이 그 뭐니
거거예 쭈욱 내리드리 다기거등뇨 한사람끼거등 이쌍시기라고 저네 이장도허고 핸는데	거기에 죽 내리들이아랫 것은 다 그것이거든요 한 사람 것이거든 이쌍식이라고 전에 이장도 하고 했는데
이쌍시기라고 그사람 절믄사람이라요 지금	이쌍식이라고 그 사람 젊은 사람이예요 지금
쌍두이	쌍둥이
쌍딩이 우찌 아능가요	쌍둥이 어떻게 아는가요
그때 얘기안해씸	그때 얘기 했잖습니까
아랜 하 쌍디이 그사래미그래도늘 거먿당께	이전에 그래 쌍둥이 그 사람이 그래 돈을 거머쥐었다니까
땅이 저 아홈마지기 그걷 배밭 녹차이써각꼬 그럭케 마이 바닫쩨 아홉마지기를	땅이 저 아홉 마지기 그것 배 밭 녹차 있어 가지고 그렇게 많이 받았지 아홉 마지기를
두가지를 마니 수하글 해무거농께	두 가지를 많이 수확을 해 먹어 놓으니까
또 여거 단마지기를 또너무노늘 사가꼬 또 녹차나무숭구고 감나무숭구고 또그래가꼬	또 여기에 다섯 마지기를 또 남의 논을 사 가지고 또 녹차 나무 심고 감나무심고 또 그래 가지고
그렁께 그사라믄 멀 아라가꼬 저리숭걷따고 쌍시기는 머를 아라가꼬	그러니까 그사람은 뭘 알아 가지고 저리 심었다고 쌍식이는 뭐를 알아 가지고
이 세상 요리 댈쭐 아라가꼬 숭걷따고 막 사람드리 동네싸라미 그러고그랟써요	이 세상 요리 될 줄 알아 가지고 심었다고 막 사람들이 동네 사람이 그러고 그랬어요
그래가꼬 또 녹차 감나무 시머가꼬 또 감나무야 할 얼매 녹차나무야 녹차나무한나무야 돈얼매얼매해가꼬	그래 가지고 또 녹차 감나무 심어 가지고 또 감나무에한 얼마 녹차 나무야 녹차 나무 한 나무에 돈 얼마 얼마 해 가지고
단마지기 아홉마지기예 도늘 막 꺼먿따해꺼등뇨	다섯 마지기 아홉 마지기에 돈을막 거머쥐었다 했거든요
그사람 땅이라 이 초가 진디가 또 조르르하이 다선마지기가	그 사람 땅이야이 초가 지은 데가 또 조르르하게 다섯 마지기가
단마지기가	다섯 마지기가
그게 옌나레 농사지은데란 마리지예	그게 옛날에 농사 지은 데란 말이지요
농사 진는 노닌디 그걸 사가꼬	예 농사 짓는논인 데 그걸 사 가지고
자기가 저리고마 감나무 녹차를 시머비릳땅게	자기가 저리 그냥 감나무 녹차를심어 버렸다니까
그럼 할머이	그럼 할머니
최참판땍 저게도 엔나레 지비 마이드러갇찌예 터가	최참판댁 저기에도 옛날에 집이 많이 들어갔지요 터가
그거는 너므 지금 서울로 이새를가서 살지마는 직꺼지 다포라비리고언자 갇찌마는	그거는 남의 지금 서울로 이사를 가서 살지마는 집까지 다 팔아 버리고 인제 갔지만
어른드리 다 죽꼬 어른드리 다그 마리자믄 재산 마이모아농걸 크나드리 싹포라묵꼬언자	어른들이 다 죽고 어른들이 다 그 말하자면 재산 많이 모아 놓은 걸큰 아들이 싹 팔아 먹고 인제
장년꺼지 직끄지 다 파라묵꼬언자 서울로 가빋찌	작년까지 집까지 다 팔아 먹고인제 서울로 가 버렸지
서울 살면서 여 왇따갇따 허더마는 지블 나두고 지블 나두고 거드만 머 직꺼지장녀네 재장녀네 파라가비러	서울 살면서 여기 왔다갔다 하더만 집을 놔 두고 집을놔 두고 그러더만 뭐 집까지 작년에 재작년에 팔아 가 버려
긍께 딴 사라미 와 사지 지블 사	그러니까 딴 사람이 와 사지 집을 사
근데 아니 최참판때기 드러선 그 널븐 땅	그런데 아니 최참판댁이 들어 선 그 넓은땅
그사람 그사람땅이라 그 하라시땅이라 최판땍지비	그 사람 그 사람 땅이야그 할아버지 땅이야 최참판댁 집이
근데 땅은	그런데 땅은
근데 싹인잗 구네서 삳찌요	근데 싹 인제 군에서샀지요
말고예 그렁께 그 땅이라능게 집터엳씀니까 논바치엳씀니까 빈텀니까	말고요 그러니까 그 땅이라는 게 집터였습니까 논밭이었습니까 빈텁니까
가송바 가송받	과수원밭 과수원밭
가수원	과수원
저네 이동네는 아무껃또 무껃또 엉꼬 막 영 가난핸는데	전에 이 동네는 아무 것도 먹을 것도 없고 막 영 가난했는데
즈즈 그짐만 부재라	저 저 그 집만 부자야
그짐만 항정업씨 부재가 대가꼬	그 집만 한정없이 부자가 되어 가지고
그하라시만	그 할아버지만
하라시 할매가 지도쿠고 무서베	예 할마버지 할머니가 지독하고 무서워
그래가꼬	그래 가지고
할머이하고 하라씨하고 두부이 계셛씀니까	아할머니하고 할아버지하고 두 분이 계셨습니까
이자 어른드리 아들키아가 다 나가고	인제 어른들이 아이들 키워 가지고 다 나가고
언자 아가 머 다서시가 너인가 머 따른 항개도엄꼬 아들만 너인가 머 그래각꼬	인제 아이가 뭐 다섯인가 넷인가 뭐 딸은 하나도 없고 아들만 넷인가 뭐 그래 가지고
그래가꼬언잗 그 하라씨땅인디 돌러더기라막 수악칸 저 채판땍지베막 돌러더기라요	그래 가지고 인제 그 할아버지 땅인데 돌너덜겅이야 막 흉악한 저 최참판댁 집에 막 돌너덜겅이예요
온 돌뿌니라 너린땅에 저저	온 돌 뿐이야 넓은 땅에 저저
집터가 아이고	집터가 아니고
집터가 아니고	집터가 아니고
돌러더러긴데언자 그걸 구네서 사가꼬 저리조키 따까가꼬 저리조키 안진능가요	돌너덜겅인데 인제 그걸 군에서 사 가지고 저리 좋게 닦아 가지고 저리 좋게 지었잖아요
긍께언자 머 을매를 바단능가도 모리지 우리는	그러니까 인제 뭐 얼마를 받았는가도 모르지 우리는
그래가꼬언잗 십삼년창가 지금그럴끼구만 집찐제가지 그런디	그래 가지고 인제십삼년 짼가 지금 그럴 거구만 집 지은 지가 지 그런데
그러믄 지금 요게는 엔나레 요게도엔나레 그라몬 돌러 돌러더김니까	그러면 지금 여기에는 옛날에 요기에도 옛날에 그러면 돌너 돌언덕입니까
요걷또 돌러더러기지 저 큰돌 저거는 모빼서 몽깨고 저거 나뚜따 아잉가요	요것도 돌너덜겅이지 저 큰 돌 저거는 못 빼서 못 깨고 저기에 놔 두었잖아요
바테 읻떵기라 박까운데 이써써요	밭에 있던 거야 밭 가운데 있었어요
저거는 앙깨고 이쓰이 존네요	저거는 안 깨고 있으니 좋네요
그렁께	그러니까
조응께로 나돈네요 그렁께 그 할매가 만날 자기 바티 또 여우게 이꺼등뇨	좋으니까 놔 뒀네요 그러니까 그 할머니가 만날 자기 밭이 또 여기 위에 있거든요
이섬서로 디리와 내가이씽께 네가 이씽께 디러온다면서 바테저리 가멘서	웃으면서 들어 와 내가 있으니까 네가 있으니까 들어온다면서 밭에 저리 가면서
바로앙가고 만날 요샌 바테안오능가 안오더만	바로 안 가고 만날 요샌 밭에 안오는가 안오더만
요리 디리와가꼬 저 도레 저 존 도레 저그머이고 만날 내가 우리바테 오믄 탁그 안자가 담배한대 피우고	요리 들어 와 가지고 저 돌에 저 좋은 돌에 저기 뭐니만날 내가 우리 밭에 오면 탁 그 앉아 가지고 담배 한 대 피우고
그 감나무가 킁 감나무가 이써꺼등	그 감나무가 큰 감나무가 있었거든
이써농께 저 감나무 저 가미 항개 여럳떠만 널쪈능가 몰라	있어 놓으니까 저감나무 저 감이 한 개 열었더만 떨어졌는지 몰라
저 감순 저기 올라오능기라 뿌리이가 이서어농께	저 감 순 저게올라 오는 거야 뿌리가 있어 놓으니까
저네 감바치대니가	전에 감밭이 되니까
큼 큼 감나무는 업서 업써직  꼬	큰 큰 감나무는 없어 없어졌고
큰 감나무가 이써농께	예 큰 감나무가있어 놓으니까
비비농께 이 거슬헐랑께	베 베어 놓으니까 이 거슥하려니까
이 짐찐는디 비지 그머 허낑가요 구네서 산는디	이 집 짓는 데 베지 그 뭐할 건가요 군에서 샀는데  음음
그래농께 아래 저 당가미 항개 여럳떼 저그 해차리예 해차리예	그래 놓으니까전에 그 단감이 한 개 열었데 저기 가지에 가지에
그래가꼬언잗 도레 안자가꼬언잗 감도 따고 저네 할매가 그랟찌 그랟따고언자만날 그럳싿치	그래 가지고 인제 돌에 앉아 가지고 인제 감도 따고 전의 할머니가그랬지 그랬다고 인제 만날 그래 쌓지
여 바테감서 디러오믄 할매가	여기 밭에 가면서 들어오면 할머니가
그러쿠나 그라먼자	그렇구나 그러면 인제
이걷또 인자 구네서상기다그지예	이것도 인제 군에서 산 거다 그죠
구네꺼 아잉가요	예 군의것이잖아요
구네서 사가꼬 이리 짇 짇찌	군에서 사 가지고 이리 지었 지었지
요거는 그 펭수가 얼마나 뎀니까 이게	요거는 그 평수가 얼마나 됩니까 이게
얼매라능기고 오백펭	얼마라는 거지 오백평
크다 그지요	음 크다그지요
오백펭이라능갑떼요	오백평이라는 것 같데요
얻 그때함번어찌 낸 넘 이약헌데 드릉께	어 그 때 한 번 어찌 내가 남 이야기하는 데 들으니까
오백펭이라	오백평이야
미테그 최참판땍 거게는 모두 메펭이나 뎀니까	밑에 그 최참판댁 거기에는 모두 몇 평이나 됩니까
아휴 몰라 그거는 메펭잉고 항정업씨 너르지요	아유 몰라 그거는 몇 평이고 한정없이 넓지요
너르지예 그거는녜	넓지요 그거는요
긍께그거는언자 나중 저 아무선생님헌테 무러바요	그러니까 그거는 인제 나중 저아무 선생님한테 물어 봐요
그 아능가	그거 아는가
여 거시기 여머이고 체영기선생니믄 알낀데 펭수를	여기 거슥 여기 뭐니 최영욱 선생님은 알 건데 평수를
누구예	누구요
아이 요 선생님 여그여그 저저 해장님	아니 여기 선생님 여기 여기 회장님
간장님간장님	관장님 관장님
관장님	아 관장님
관장니믄 아지	관장님은 알지
만날 헤장님쌍게 해깔리가지고예	만날 회장님 쌓으니까 헷갈려 가지고요
내가	내가
저네보통 저 미테 헤장니미 고방에 게셔꺼드	전에부터 저 밑에 회장님이 광에계셨거든
고바아 게심서로 내가 정시믈 만날 해디리써	광에 계시면서 내가 점심을 만날해 드렸어
그래가그때 헤장님 헤장님 해농께 그기 이베 올라가꼬 만날 헤장니미라 그러대 내가	그래 가지고 그때 회장님 회장님 해 놓으니까 그게 입에 올라 가지고 만  날 회장님이라 그렇게 돼 내가
모두 간장니미라 허드마는	모두 관장님이라 하더만
그람지끔 하녹 다 지낭걷또 구네서 징김니까	그럼 지금 한옥 다 지어 놓은 것도 군에서 지은 겁니까
아이고 구네서 짇찌요	아이고 군에서 지었지요
구네서	군에서
그람 그	그럼 그
그렁께 저인자 지논 새집 싸악요리 내리드리 읻찌요	그러니까 저 인제 지어 좋은 새 집 싹 요리 내리들이 있지요 예예
여여 요쪼게 저저 장터랑 그건인자 또너무땅을인지 사가꼬 너무땅을 사가고	여기여기 요쪽에 저저 장터랑 그건 인제 또 남의 땅을 인제 사 가지고 남의 땅을 사 가지고
인자 에스비스예서언자 이 찰령하면서 그사람드리 싸악 지써요 그 뜨든지 그걸	인제 에스비에스에서 인제 그 촬영하면서 그 사람들이 싹 지었어요 그 뜯은 집 그걸
뜨든집 그걸인제 구네서 땅만 사주고	뜯은 집 그걸 인제 군에서 땅만 사 주고
그사람드리 싸악 초가를 지가꼬 쎄룸허이 그래가꼬 찰령을 삼녀늘 안핸능가요서울써 내려대임써로	그 사람들이 싹 초가를 지어 가지고 산뜻하게 그래 가지고촬영을 삼 년을 했잖아요 서울서 내려다니면서
그라먼자 그	그러면 인제 그
그렁거 다 받찌요	그런 거 다 봤지요
집찌응거 그거는 그라몬 에스비에스에서	집 지은 거 그거는 그러면 에스비에스에서
산는디	샀는데
요게 요다가 기증을 해씀니까	여기에 요기다가 기증을 했습니까
아적 저거목쓰로 나마이씀니까	아직 자기 몫으로 남아 있습니까
그렁께그걸 지가꼬 자기드리 삼년 찰령 딱 허고 이자 구네서 바닫찌요	그러니까그걸 지어 가지고 자기들이 삼년 촬영 딱 하고 인제 군에서 받았지요
그지블 바닫써언자 상기지 도늘주고	그 집을 받았어 인제 산 거지 돈을 주고 음음
그머덕끼라 자기드리	그 뭣 할 거야 자기들이
자기들 그내나 머드라마 영하찍꼬 하고	자기들 그 내나 뭐 드라마 영화 찍고 하고
헌다고 헌다고 그 지블찌쓰	한다고 한다고 그 집을 지었어
진니라 욕빠구마 그사람들또 대목드리 막	짓느라 고생했어 그 사람들도 대목들이 막
그러믄녜 할머이 그저그때 옌나레 요게 욷 아이 우땀아래땀 상펭에	그러면요 할머니 그저 그때 옛날에 요기에 위 아니 윗동네 아랫동네 상평에
그 집뜨른 지금얼추 나마이씀니꺼 새로지블 새로지끈 우째끈가네 그 터는 좀읻	그 집들은 지금 얼추 남아 있습니까 새로 집을 새로 지었건 어쨌건 간에 그 터는 좀 있
허어 저 아래따메는 하모 그터예다 지블지니까	응 저 아랫담에는 아무렴 그 터에다 집을 지으니까
전시예막 집또막 써그릉써그릉허이막 헌지블	전부 막 집도 막 써그릉써그릉하게 막 헌 집을
제주 새로 지금다 지빙께	죄다 새로 지금 다 집이니까
제주	죄다
우리짐만 몬짇꼬 지금 내가곤치가꼬 고만사능기지	우리 집만 못 짓고 지금 내가고쳐 가지고 그냥 사는 거지
전시 새로 다 안진는가요	전부 새로 다 짓지 않나요
그러모 엔날집 그기뜩끼가꼬 머언자 다른데 드러간건 이씀니까 업씀니까	그러면 옛날 집 그게 뜯겨 가지고 뭐 인제 다른 데 들어 간 건 있습니까 없습니까
고만 거거예서 살고 거거예서 지 터예서 직꼬직꼬 막 그러고	그냥 거기에서 살고거기에서 제 터에서 짓고 짓고 막 그러고
근데	그런데
그엔나레 집터는 벨로 뜩낀	그 옛날에 집터는 별로 뜯긴
언자집터는 여 뜩낑거 마나요 오두매기	인제 집터는 여기 뜯긴 거 많아요 오두막
오두배기 이 기고날고막 요리기고날고 방에드러갈라믄 방항칸짜리 여거도 여대받인는디 여올로오는디 거도 오두매이막 기고날고막 거거두개씩 이 키우고그리사랃써요	오두막 이 기고 날고 막 요리 기고 날고 방에 들어 가려면 방 한 칸짜리 여기도 여기 대밭 있는 데 여기 올라 오는 데 거기도 오두막 막 기고 날고 막거기 아이 두 명씩 이 키우고 그렇게 살았어요
터가 엄써가꼬 집터가 엄써가꼬 조깬허이 지가꼬	터가 없어 가지고 집터가 없어 가지고 자그맣게 지어 가지고
여거도 턴디 집턴디 뜨더빋쩨 저 막 군데군데 마이뜨더써 사던지블	여기도터인데 집 턴데 뜯어 버렸지 저 막 군데군데 많이 뜯었어 살던 집을
마 오두매기 그렁거는 마이 뜩낃써요 하	뭐 오두막 그런 거는 많이 뜯겼어요응
가이루막 밴두루로막 마리자먼 부상거트모 변두리막 인는 그런지븐 싸악 뜩낀 테기지	가장자리로 막 변두리로 막 말하자면 부산 같으면 변두리 막 있는 그런 집은싹 뜯긴 셈이지
사래미막 죽꼬 이새가비리고 엄씨니까	사람이 막 죽고 이사 가 버리고 없으니까
긍께 여거예 대밭인는디 여거 대박까온데 큰 부잳찌비 참말로 참말로 공간디공부재라고 성이 공간디	그러니까 여기에 대밭 있는 데 여기 대받 가운데 큰 집 부잣집이 참말로 참말로 공가인데 공부자라고 성이 공가인데
진짜 부재찌비 여 사랃꼬마 저네	진짜 부잣집이 여기 살았구면 전에
오호	오호
지금인잗 마사느로 이새를 가비리고 이잗 아들 딸드리 싸악인자 그리 나가비서그러치 저네 어른드리 살쩌게 어른들 다 도라가시고	지금 인제 마산으로 이사를 가버리고 인제 아들 딸들이 싹 인제 그리 나가 버려서 그렇지 전에 어른들이 살 적에어른들 다 돌아 가시고
그 할무이는 마산 지금 게시느마느	그 할머니는 마산 지금 계셔
그 여인자 대바치 드러서빋찌 요 지블 뜨더삐농께	그 여기 인제 대밭이 들어서버렸지 요기 집을 뜯어 버려 놓으니까
요기가 옌날 집텀니까	아 요기가 옛날 집텁니까
여거 저네 집터가큰 집터 참 피야구만 그지비도	아 여기 전에 집터가 큰 집터 참  그 집에도
할머이 기억하심니까	할머니 기억하십니까
하모 여거 만날 여거 사라농께 언자 그건알지 그 집터는	아무렴 여기 만날 여기살아 놓으니까 인제 그건 알지 그 집터는
그 대바치 디빋찌요 집 학 뜨더비리농께	그 대밭이 돼 버렸지요 집 확 뜯어 버려 놓으니까
그 지븐	아 그 집은
뜨더낸	뜯어 낸
그라몬	그러면
부재찌비라저네	부잣집이야 전에
그지베 다릉기 드러성기 아이고 이르마 대바트로 바낃뿌서	그 집에 다른 게 들어 선 게 아니고 이거 뭐 대밭으로 바뀌어 버렸어
예대바치 대삗찌	예 대밭이 되 버렸지
그람 이 대바튼 그	그럼 이 대밭은 그
공부재찝 그 뒤예 이떵김니까 볼래	공부잣집 그 뒤에있던 겁니까 본래
요집	요 집
말고 요 대바튼	말고 요 대밭은
찌금	지금
볼래는어디이떵김니까 대밭	본래는 어디 있던 겁니까 대밭
대바치언자 여거 좀 이써꼬 가예 요리 익거꼬	대밭이 인제 여기 좀 있었고 가장자리에 요리 있었고
그리 고게 공부재찝 뒤예	그리 그게 공부잣집 뒤에
이써씀니까	있었습니까
아페 이써씀니까	앞에 있었습니까
디예 읻찌요	뒤에 있지요
그람 공부	아 그럼 공부
디예도익꼬 여페도 익꼬 막 대바치	뒤에도 있고 옆에도 있고 막 대밭이
긍께 가운데 쏘옥 드러안잗썯찌 그예 부재찌비	그러니까 가운데 쏙 들어 앉았었지 거게 부잣집이
부잳찌비	부잣집이
그래가꼬 막	예 그래 가지고 막
근데인자 그집터까지자 그대아무가 다 컫뿓따 이마리지예	그런데 인제 그 집터까지 인제 그대나무가 다 커 버렸다 이 말이지요
주 뭐 지블 탁 뜨더비농께	저 뭐 집을 탁뜯어 버려 놓으니까
사래미 안사니까	사람이 안 사니까
그러몬 저 그 공부잗찝 그	그러면 저 그 공부잣집 그
여페	옆에
뜯뜨 땅은 아직또 부잗찝 땅인갑네 그러모	뜯 뜯 땅은 아직도부잣집 땅인가 보네 그러면
그인자 파라무걷찌	그 인제 팔아 먹었지
어데 구네다가예	어디에 군에다가요
구네는 내나 요 감나무 요기요리요리 구네끼고	군에는 내나 요 감나무 여기 요리요리 군의 것이고
저거는 너무 사라미끼라요 너무사람	저거는 남의 사람의 것이에요 남의 사람
저 대촌마을하고	저 대촌 마을하고
또 부재 노부재지비서	또 부자 노부잣집에서
사농기라	사 놓은 거야
노가	노가
노가 부잳찌비 또 이썯꺼등뇨	노가 부잣집이 또 있었거든요
그집대바치래요 그어는	그 집 대밭이래요 그것은
노가	노가
딴사랑기라	딴 사람 거야
그런네예	그렇네요
구넫꺼는 요리요리요리요리인자 자은대 자근대 요리는기지	군의 것은 요리 요리 요리 요리 인제 작은 데 작은 데 요리는 그것이지
이 감받이거 다 기고	이 감밭 이거 다 그것이고
그렁게 거도 항정엄씨 커요 이리 베기는 요래도	그러니까 거기도 한정없이 커요 이리 보기는 요래도
그러몬여게도 언젠가는 감 머 드러서건네예 그러모	그러면 여기에도 언젠가는그럼 뭐 들어 서겠네요 그러면
그렁께 아래 우리데모허고 그랟써요 하동가서	그러니까 그제 우리 데모하고 그랬어요 하동 가서
와예	왜요
구네 살빠아 가서	군에 대문에 가서
와그래냐하면 여거 즈즏 마리잠 공부잳찌비 텅가 머 미테 믿 쫌 미테 비끼스 미텡가	왜 그랬느냐 하면 저저 말하자면 공부잣집의 터인가 뭐 밑에 밑 좀 밑에 비껴서 밑에인가
저거 저저 중이 마리자믄 중이라고 마마 말도 몬헝께 중이라 해야지	저거 저저중이 말하자면 중이라고 마마 말도 못 하니까 중이라고 해야지
중 사래미 이 땅을 삳따네요 사낟때	중 사람이 이 땅을 샀다네요 사 놨대
노 노부잳찝한테서	노 노부잣집한테서
그거는 따로 익꼬	그거는 따로 있고
또 읻꼬	아 또 있고
또 딴지비 저 여러 피리거든	또 딴 집에 저 열어 필이거든
그래가꼬언자 그 집껄 사난는디	그래 가지고 인제 그 집 것을 사 놓았는데
그사래미 자꾸 엳따가 머 그 머이고 절거치 마리자먼 난 이약헐쭐 모링께	그사람이 자꾸 여기다가 뭐 그 뭐니 절같이 말하자면 난 이야기 할 줄 모르니까
절거치 진는다고 어트케 그만	절같이 짓는다고 어떻게 그만
주가 자기가 이길라고 막 우리한테고막 덤비들고 동네싸라믈고마 깨물테빌래마리자믄	자기가 자기가 이기려고 막 우리한테 그냥 막 덤벼들고 동네 사람을 그냥까뭉개 버리려 해 말하자면
그래서막 우리가 그래도 이긷쓰요	그래서 막 우리가 그래도 이겼어요
막 그가서 막 그 거석 살빠게 가서 군 살빠게 가가꼬	막 거기 가서 막 그 그슥대문에 가서 군 대문에 가 가지고
막 머이고 그거 이리 막 내리노코 그거 글씬거	막 뭐니 그거 이리 막 내려놓고 그거 글 쓴 거
이 들고	이리 들고
그걸 들고 부치고 고만 동네 고만 다 가고 쌔리 막 군수님저거 머이고	그걸 들고 붙이고 그냥 동네 그냥 다 가고 쌔리 막 군수님 저거 뭐니
그래 영안댇 내가 또 아이고 참말로 그소리 헝께 너무다 안댇따 내가 헌단 소리가 해 가티 해노코는	그래 영 안됐 내가 또 아이고 참말로 그 소리 하니까 너무 다안 됐다 내가 한다는 소리가 해 같이 해 놓고는
그래농께 아이고 똑 그소로가꼬 날로 건디리고 사람드리	그래 놓으니까 아이고똑 그 소리를 가지고 나를 건드리고 사람들이
저 군수님 물 물러가라고 막 아글씨고 사람드리 동네사래미	저 군수님 물 물러가라고 막 악을 쓰고 사람들이 동네 사람이
거서 날리 낟써요 세분내려 가가꼬	거기서 난리 났어요 세 번 내려 가 가지고
그렁께 십께 마래서 요게인자 저리 하나	그러니까 쉽게 말해서 요기에 인제절이 하나
걷따가 절매이로 진는다고	거기다가 절처럼 짓는다고
저를하나  지을라캉께 동네사라미 반대핻따	절을 하나 지으려고 하니까 동네 사람이 반대했다
몯찓꾸로	못 짓게
몯 근데 구네서는이자 허라글 해줟따 이마림니까	못 근데 군에서는 인제 허락을 해 줬다 이 말입니까
그렁께 마리자면 허라글	그러니까 말하자면 허락을
할라꼬	하려고
해줄라고 헌데 마리자머	해 주려고 하는데 말하자면
우리만 지라하먼	우리만 지으라 하면
근데 택또 움써	근데 턱도 없어
거 지먼 안댄대요 여 마으리 안댄대	거기 지으면 안 된대요 여기 마을이 안된대
크닐난대 그래서 절때로 반대를 해꺼등	큰 일 난대 그래서 절대로 반대를 했거든
긍께 그사래미 땅만 그거 사가꼬 지금 저래가 인능기라	그러니까 그사람이 땅만그거 사 가지고 지금 저래 가지고 있는 거야
몬지꾸로 가망도 엄는디 머	못 짓게 가망도 없는데 뭐
자기는 그걸언자 땅그걸 사가꼬 버젇허이언자 절매이로 지가꼬	자기는 그걸 인제 땅 그걸 사 가지고 버젓하게 인제 절처럼 지어 가지고
인자 사람끄디린다 그기라인잗	인제 사람 끌어 들인다 그거야 인제
알겓씀니다	예 알겠습니다
절 그러고 여이 긍기사절도 익꼬헌디 하모 그사람드리 오머 안댄대	절 그러고 여기 근기사 절도 있고 한데 아무렴 그 사람들이오면 안 된대
아랃씀니다 할머이 오늘 마 여기까지 하고	예 알았습니다 할머니 오늘마 여기까지 하고
또 뒤예 또 제가 더하께예 아이 고맙씀니다	또뒤에 또 제가 더 할게요 아이 고맙습니다
그 반농사로 진는 곡시게는 어떤 것들이 읻슴니꺼	그 밭농사로 짓는 곡식에는어떤 것들이 있습니까
참깨 들깨 머 여러 종뉴지요	참깨 들깨 뭐 여러 종류지요
콩 폳 머 녹뚜	콩 팥 뭐 녹두
막 그렁거 허지요 고구마도 숭구고	막 그런 것 하지요 고구마도 심고
그러믄녜 콩부터 함 시작해 보께예	어 그러면 콩부터 한번 시작해보겠습니다
콩은 운제 파종함니까	콩은 언제 파종합니까
즈즈 아레 오워래요	저저 그제 오월에요
모 시믈 때	모 심을 때
즈 드레 모 시믈 때	저기 들에 모 심을 때
모 시믄 막 콩을 시 또 우리도 숭굴라고 준비를 허지	모 심으면 막콩을 심 또 우리도 심으려고 준비를 하지
그러믄자 콩을인자 시머야 댈꺼 아임니꺼	그러면 인제 콩을 심어야 될 것 아닙니까
그러몬 고 심어가지고 나제 그다 드릴 때까지	그러면 그 심어서 나중에 거두어들일 때까지
우째 이를 하는지 그지예	어찌 일을 하는지 그지요
시머노먼인자 바츨언자 매야지 바츨	심어 놓으면 인제 밭을 매야지 밭을
바츨 안매모 고마 데다 안해요 콩받또	밭을 안 매면 그냥 되지도 않아요 콩밭도
반매고 매고언자 꼬치막 피데요	밭 매고 매고 인제 인제 꽃이 막 피데요
꼬치피믄 또 야글 처야대고	꽃이 피면 또 약을 쳐야 되고
야글 안 치믄 옹기 항개도 업써요	약을 안 치면 온 것이 하나도 없어요
장녀넨 또 여그 야글 안처농께 거스기머이곧 개이꼬 야글 안처농께로	작년에는또 여기 약을 안 쳐 놓으니까 거슥이 뭐니  약을 안 쳐 놓으니까는
어쩌다 옹거 하나익꼬 전시네 고만 벌그지가 무가꼬	어쩌다 온 것 하나 있고 전부 그냥 벌레가 먹어 가지고
아무끼라도 지금 약 안 치믄 아무껃도 안 데요	아무 것이라도 지금 약 안 치면 아무 것도 안 돼요
감도 약 치믄 안 데고	감도 약 안 치면 안 되고
다 떠러저비리고	다 떨어져 버리고
말씀하이소 그래	예 말씀하십시오 그래
고롬 바테이 머 폳또 싱꼬 콩도 싱꼬 머 녹뚜도 싱꼬	고놈 밭에 뭐 팥도 심고콩도 심고 뭐 녹두도 심고
그러믄자 우선 콩임니더이	그러면 인제 우선 콩입니다이
예예	예예
그러믄인자 콩이 한참 클 때 은자 열매가 달릴 때 우째 보면 옌나레 그 콩 익싸리도 띠가꼬	그러면 이제 콩이 한참 클 때 이제 열매가 달릴 때 어찌 보면 옛날에그 콩 이파리도 떼어 가지고
오파 이 즈 모옹거 모가지를 싹 떼야데요	이 저 모은 것 모가지를 싹 떼야돼요
그 케가 커지거마 이리 바래미 불고 허믄 이 자빠저비링까	그 키가 커지면 이리 바람이 불고 하면 이 자빠져 버리니까
쪼껜허라고언잗	조그만하라고 인제
두문두문 숭구가꼬	드문드문 심어 가지고
콩도 두문두문 숭구가꼬 배믄 고마 콩이 안여러요 써거비리고	콩도 드문드문심어 가지고 배면 그냥 콩이 안 열어요 썩어 버리고
그렁깨로	그러니까
그러믄언자 콩이언자 난주 다 안 달림니꺼이	그러면 인제 콩이 인제 나중에 다달리지 않습니까
그 다메언자 콩타작 거 거다 들이가꼬 타작도 해야 델꺼 아임니꺼	그 다음에인제 콩타작 거둬 들여서 타작도 해야 될 것 아닙니까
그는인잗 이그모 콩입싹 떠러지고 가으레 저 나락 벨 쩌게	그것은 인제 익으면 콩잎 싹 떨어지고 가을에 벼 벨 적에
나락 베모언자 또 콩도 익꺼등뇨	벼 베면 인제 또 콩도 익거든요
그러믄자 콩 이그모인자 나트로 끄너 몰랴가꼬 베테	그러면 인제 콩 익으면 인제 낫으로 끊어 말려 가지고 볕에
베테 몰랴가꼬언잗 작때르 가 막 투디지 우리드른	볕에 말려 가지고 인제 작대기를 가지고 막 두드리지 우리들은
남자들 인는 사람드른 이 도리깨로 가꼬 언자 투디리고	남자들 있는 사람들은이 도리깨를 가지고 인제 두드리고
도리깨로 가꼬 막 마다 짝 페 노코 뚜디리고	도리깨를 가지고 막 마당에 쫙펴 놓고 두드리고
우리드른 바테 그마 즈즈 몽까고 그마 허니까 헐띠도 억꼬	우리들은 밭에 그냥 저저 못 가고 그냥 하니까 할 데도 없고
바테닫 그 가빠를 페 노코 마 쪼께스 쩨께스 마 뚜디능기지	밭에다 그 가빠를펴 놓고 마 조금씩 조금씩 두드리는 거지
쩨께이 숭구고 끼양	조금 심고 그냥
이녁 이녀키나 뭉는다 쪼까이 수머	우리 우리나 먹는다고 조금 심어
그라모	그러면
바치나 인능가요 너머 바테다가 쩨껜 해나 해낟찌	밭이나있는가요 남의 밭에다가 조금해 해 놓 해 놨지
그 다으메 그언자 콩은 그리 하고	그 다음에 그 인제 콩은 그렇게 하고
요게는 멀캄니꺼 자잘한 거 노란 걸 조 조라캄니꺼	여기에는 뭐라고 합니까자잘한 거 노란 걸 조 조라고 합니까
서수기라 캄니꺼	서숙이라고 합니까
아이먼	아니면
서 조라도 허고 서수기라도 허고	서 조라고도 하고 서숙이라고도 하고
주로 무어슬가 씀니까	주로 무엇으로 씁니까
보통 고마 서숙	보통 그냥 서숙
나는 고만 서수기라 그래비지요	나는 그냥 서숙이라 그래 버리지요
그러믄 서숙	음 그러면 서숙
쑤수 쑤씨도 이꼬 쑤씨	수수 수수도있고 수수
말고 언자 그람	말고 인제 그럼
서숙가꼬 또 얘기 함 해봄니다이	조를 가지고 또 얘기 한번 해 봅니다이
서숙또 우째 뿌리가지고 우째 거다가지고 거다드리는 거	조도어찌 뿌려 가지고 어찌 거둬 가지고 거둬 들이는 것
고마 니 골내 가꼬	그냥 이 고랑을 내 가지고
바테다가언자 풀 엄씨 골 내가꼬	밭에다가 인제 풀 없이 고랑을 내 가지고
언자 씨만 요리요리 뿌리노먼 씨가 나먼언잗 또 배믄 안대니까	인제 씨만 요리요리 뿌려 놓으면 씨가 나면 이제 또 배면 안 되니까
이자 싹 소까 조야데요 두문두문 세아 노코	인제 싹 솎아 줘야 돼요 드문드문세워 놓고
그래야언잠 그 서숙 모가지가 국꺼등뇨	그래야 인제 그 조 이삭이 굵거든요
배믄 고맏 잔잔하이 요막쓱 해가꼬 데다 안허고	배면 그냥 잔잔하게 이만큼씩해 가지고 되지도 않고
머이라도 드물게 해야 뎅께	무엇이라도 드물게 해야 되니까
그리 해가꼬 그래노모 고마 풀마 매주모 커요 커서 대능기고	그렇게 해서 그렇게 해 놓으면 그냥 풀만 매 주면 커요 커서 되는 것이고
그람 나중에 또 거다드리야 델꺼 아임니꺼	그러면 나중에 또 거둬 들여야 될것 아닙니까
고언자 이그먼언자 이그먼언자 또 곡서기 이그먼언잗	그 인제 익으면 인제 익으면 인제 또 곡식이 익으면 인제
모가지만 요리 목만 요리요리요리 따 가꼬	이삭만 요리 이삭만 요리요리요리따 가지고
언자 마 방매로가 뚜디리모 잘 몯 몰랴가꼬	인제 뭐 방망이를 가지고 두드리면 잘 말 말려 가지고
방매 뚜디림 잘 떠러져요	방망이 두드리면 잘 떨어져요
그람 서수근 그래하고	그러면 조는 그렇게 하고
그 다으메	그 다음에
쑤시	수수
쑤시또언자	수수도 인제
쑤시도 또	수수도 또
고만그리 즈 그슥매이로 염방	그냥 그리 저 그슥처럼 연방
서숙매이로 고마 그릭 흐처가꼬	조처럼 그냥 그리 뿌려 가지고
또 두문두문 해 가꼬 그걷또	또 드문드문 해 가지고 그것도
두문두문 해야 이 모가지가 국꺼등뇨	드문드문 해야 이 이삭이 굵거든요
그래가꼬 내나	그래 가지고 내나
또 이그머 어느 정도 이그먼언자 이그따 허면언자 비가 또 모감지만 요리 베 가꼬	또 익으면 어느 정도 익으면 인제 익었다 하면 인제 베어 가지고 또 이삭만 요리 베어 가지고
그 대가 항정엄씨 킁께요 그거뜨른	그 대가 한정없이 크니까요 그것들은
모감지만 비 가꼬언잗 또 막 요리	이삭만 베어 가지고 인제 또 막 요리
간지때 즈 빨래쭈레 간지때매로 요리 해노코 요리 막 너러나요	장대 저 빨랫줄에 장대처럼 요리 해 놓고 요리 막 널어 놔요
뭉크가꼬 대가리 뭉크가코 요리 가랑테이 타 가꼬 뭉커노모	묶어 가지고 이삭 묶어 가지고 이렇게 가랑이 타 가지고 묶어 놓으면
이자 모리믄 또 그거또 가빠나 페 노코언자 방매로 가 뚜디리고	인제 마르면또 그것도 가빠나 펴 놓고 인제 방망이를 가지고 두드리고
고마 고래요	그냥 그래요
그럼 그거는언자 그 쑤시다 그지예	그럼 그것은 인제 그 수수다 그렇지요
쑤시	수수
감 감자는 안 키앋슴니꺼	감 감자는 안 키웠습니까
감재는 또 보메 시머가꼬	감자는 또 봄에 심어 가지고
사머레	삼월에
이워레 이월 그믐께 숭구지 만날	이월에 이월 그믐께 심지 만날
이워레언잗 이리 골 처가꼬	이월에 인제 이렇게 골 쳐 가지고
바테언자 숭굴 때언자 골 처 가꼬언잗 고마 이리 쪼개가꼬	밭에 인제 심을 때인제 골 처 가지고 인제 그냥 이리 쪼개 가지고
감재 그 누니라고 이찌요	감자 그 눈이라고 있지요
그걸언자 쪼개가꼬	그걸 인제 쪼개 가지고
쪼개가꼬 마 이리 쿡쿡 숭거노모	쪼개 가지고 뭐 이렇게 쿡쿡 심어 놓으면
비료나 마니 거르믄 마니 허고	비료나 많이 거름은 많이 하고
숭거노믄 언잗 데고 거름 안하믄 또 데다 안해요 그걷또	심어 놓으면 인제 되고 거름 안하면 또 되지도 않아요 그것도
그럼	그럼
테비를 허고	퇴비를 하고
그걷또언자 또 거라야 델꺼 아임니꺼	그것도 인제 또 걸워야 될 것 아닙니까
하모 그리 골 처가꼬 시머노몬 고마 거름만 해노몬 풀만 메주몬 뎅께로	그럼그렇게 고랑을 쳐 가지고 심어 놓으면 그냥 거름만 해 놓으면 풀만 매 주면 되니까
나기만 나모언자 감재 알이 들지	나기만 나면 인제 감자 알이 들지
그라모 감재는 메덜따레 캠니까	그러면 감자는 몇 월달에 캡니까
즈 모 시믈때요	저 모 심을 때요
유워래	유월에
오워래	오월에
저네 즈즈 모 숭구고 막 밥해주고 허믄언자 그그 감재 캐가꼬 막 덴장꾹도 끼리가고 막 저네는그랜는디	전에 저저 모 심고 밥 해 주고 하면 인제 그그 감자 캐 가지고 된장국도 끓여 가고 전에는 그랬는데
그 감재 캐다가	그 감자 캐다가
요게서는 고구마라 캄니꺼 고구매라 캄니꺼	여기서는 고구마라고 합니까 고구매라고 합니까
고구마	고구마
고구마	고구마
고구마라고 예삐게 허는 사라믄 고구마라 허고	고구마라고 예쁘게 하는 사람은고구마라고 하고
나는 고마 고구매	나는 그냥 고구매
그르고 그르지머	그렇게 하고 그렇게 하지 뭐
그라믄 고구매도 처음부터언자	그러면 고구마도 처음부터 인제
고구매는	고구마는
골 처 가꼬	예 고랑 쳐 가지고
아니 줄로 먼저 내야 델꺼 아임니까	아니 줄을 먼저 내야 될 것 아닙니까
즈그언잗 고구마는은잗 요리 골 처가꼬 짱아리를 바가노몬 수니나와요	저기 인제 고구마는 인제 요리 고랑을 내서 종자 고구마를 박아 놓으면 순이 나와요
수니 나오고 그노믈 떼가꼬 하모 심지	순이 나오고 그 놈을 떼 가지고 아무렴심지
그래 고걷또언자	그래 그것도 인제
그러믄 아까 짱아리라 캐씀니꺼	그러면 아까 짱아리라고 했습니까
짱아리	예 짱아리
처으메는언잗 이워레언잗 그글 땅에다 바가야데요	처음에는 인제 이월에 인제  그걸 땅에다 박아야 돼요
바가 나따가	박아 놓았다가
언자 수니 요리 나모언자 그걷또 거르믈 해가꼬언잗 고구매륻 바가서 또 얼릉 나라고	인제 순이 이렇게 나면 인제 그것도 거름을 해서 인제 고구마를 박아서 또얼른 나라고
마 나리 추꼬 이워레는 허니까로	뭐 이월에는 날이 춥고 하니까는
그 비누루를 딱 요리 페 가꼬	그 비닐을 딱 요리 펴 가지고
무더노코 비누룰 페가 더퍼나요 조그만허이 요리	묻어 두고 비닐을 펴 가지고덮어 놔요 조그만하게 요리
더퍼노모언자 흐클 양쪼게 그르 더퍼노모	덮어 놓으면 인제 흙을 양쪽에 긁어덮어 놓으면
언재 이 수니언잗 나지요	인제 이 순이 인제 나지요
나모언자 요리고마 찍 째노머 고무 종우를	나면 인제 이렇게 그냥 찍 째 놓으면 고무 종이를
우를 요리 째노먼	위를 요리 찢어 놓으면
언자 올로오지	인제 올라오지
그그를 안 째노모 볼라노코 안째먼 그이 그슥헝께	그것을 안 째 놓으면 발라놓고 안 째면 그것이 그슥하니까
즈즈 몰라저 비링께로	저저 말라져 버리니까는
수니 베치 뜨그븡께	순이 볕이 뜨거우니까
지금 지그믄 머 감재도 막 비누루로 헝께	지금 지금은 뭐 감자도 막 비닐로 하니까
그라믄자 수늘 끄너 가지고	그러면 인제 순을 끊어 가지고
골 처가꼬 바테다가	고랑 쳐 가지고 밭에다가
골 처가꼬언잗 막 이리이리이리 숭거노치	고랑 쳐 가지고 인제 뭐 이리이리이리 심어 놓지
모디모디	마디마디
고거는 메덜따림니꺼	그것은 몇 월달입니까
두덜	두 달
고구매는언자 즈즈 여르메언잗 지금 시머나찌요	고구마는 인제 저저 여름에 인제 지금 심어 놨지요
시머나써 여그 항고랑 숭거난는디	심어 놨어 여기 한 고랑 심어 놨는데
그 종자르 어더가꼬	그 종자를 얻어 가지고
그라믄자 또	음 그러면 인제 또
언자 가으레 또 나락 즈거즈 거다디리고 콩 거다디리고 막 헐쩌게	인제 가을에또 벼 저거 저 거둬들이고 콩 거둬들이고 막 할 적에
그때언자 가치인자 막 캐요	그때 인제 같이 인제 막 캐요
축끼 저네	춥기 전에
그러몬자 고구마 그 캘 때보몬 잘몬하몬 머 진도 나오고 이리 안함니꺼	예 그러면 인제 고구마 캘 때 보면 잘못하면 진도 나오고 이러잖습니까
찐 나와요	진 나와요
찍찍 잉기지 사레	찍찍 엉기지 살에
고구매 요리 케가꼬 막 요리 거슥 끄네키 그 뗀다고 요리허믄 허허이 뜨무리막 나와요	고구마 요리 캐 가지고 그 끈 뗀다고 요리 하면 하얗게 뜨물진이 막 나와요
고구매 찌니	고구마 진이
글 뜨무리라 캄니꺼	그걸 뜨물이라고 합니까
찌니라 허지 찌니라호	진이라고 하지 진이라고
고구매 찐	고구마 진
그라고언자 또 꼬치 농사도 지쓸꺼 아임니꺼	그러고 인제 또 고추 농사도 지었을 것 아닙니까
꼬치도 하모 지찌요	고추도 아무렴 짓지요
모중 사가꼬 지그므	모종을 사 가지고 지금은
옌나레예	옛날에는요
저네는언자 이 마 또 고를 처가꼬	전에는 인제 뭐또 고랑을 쳐 가지고
비로 좀 헉꼬	비료 좀 흩고
거름 좀 헉꼬 그래가꼬언잗	거름 좀 흩고 그래 가지고 인제
씨를 꼬치씨 그거 꼬치 요리 짱글기믄 씨가 나오거등뇨	씨를 고추씨 그것 고추요리 자르면 씨가 나오거든요
그 씨를 바다나따가	그 씨를 받아 놨다가
그 바테다가 막 이리 졸졸 가라노모	그 밭에다가 이렇게 졸졸 갈아 놓으면
가라노코 또 그걷또 두문두문 세아나요	갈아 놓고 또 그것도 드문드문 세워 놔요
그러믄자 가재이가 버르가꼬언자 저네는 그래 해 해가꼬 묻찝	그러면 인제 가지가 벌어 가지고 인제 전에는 그리 해 해 가지고 먹었지
봉갈하고	봄갈이하고
봉가리	봄갈이
그 이르믈 가따 봉가리라고 해	그 이름을 갖다가 봄갈이라고 해
봄 머라고예	봄 뭐라고요
봉가리 봉가리	봄갈이 봄갈이
봄가리	봄갈이
보메 요리 마 씨를 뿌리가꼬	봄에 요리 뭐 씨를 뿌려 가지고
그리 그리 해가 문는데 지그믄 전시 모종을 사가꼬	그리 그리 해 가지고 먹었는데 지금은 전부 모종을 사 가지고
넘 해농걸 사가꼬 와서언자 시머가꼬 고치를 따지	남이 해 놓은 걸 사 가지고와서 인제 심어 가지고 고추를 따지
그람 고치는 심어나머 바로 따짐니까	그럼 고추는 심어 놓으면 바로 따집니까
어디요 그걷또 마이 키아야지	아니오 그것도 많이 키워야지
거르믈 해가꼬 키아야지	거름을 해 가지고 키워야지
그 우쩨 키아는지 운제 따는지 고거 말씀 좀 해주이소	그 어찌 키우는지 언제따는지 그것 말씀 좀 해 주십시오
지금 막 뿔근고치 따데요	지금 막 붉은 고추 따데요
지금 딴 사람 우리는 머	지금 다른 사람 우리는 뭐
우리는 즈즈 맫피 여여 요지베 숭거농거언자 푸꼬치 따물라고 시뭉기고	우리는저저 몇 포기 여기여기 여기 집에 심어 놓은 것 인제 풋고추 따 먹으려고 심은 것이고
뿔근꼬치를 따요 지금	붉은 고추를 타요 지금
지금 사람드리 즈 딴 데는 마이 따따느마 딴데는	지금 사람들이 저기 딴 데는많이 땄다더만 딴 데는
꼬치버리허는 사람드른	고추 벌이하는 사람들은
저 구레로 막그런디는	저기 구례로 그런 데는
마니 머 메펭	많이 뭐 몇 평
오백페잉가 메페이고 숭거가꼬언자 그래가꼬언자 장에 나오니까	오백 평인가몇 평인가 심어 가지고 인제 장에 나오니까
그러몬자 꼬치도 그리 해꼬	그러면 이제 고추도 그리 했고
마알 농사는 안 지씸니꺼	마늘 농사는 안 짓습니까
마늘 안 지도 사람드리인잗	마늘 안 지어도 사람들이 인제
그거또언자 요리 쪼가리쪼가리 내가꼬	그것도 인제 요리 쪼가리쪼가리 내 가지고
거르믈 마이 해가꼬	거름을 많이 해 가지고
바테다가	밭에다가
그래가꼬언자 두두그로 허는 사라믄 두두그로 허고 골로 요리 고랑치는 사암 고랑하고	그래 가지고 인제 두둑으로 하는 사람은 두둑으로 하고 고랑을 요리 고랑치는 사람은 고랑하고
마이 숭구데요 이 동네도 자기들 뭉는다고	많이 심데요 이 동네도 자기들 먹는다고
그래가꼬 막 미테다인자 야글 치고 그리 마느를 시머요	그래 가지고 막 밑에다인제 약을 치고 그리 마늘을 심어요
그래 안 야글 안 치므 막 곤자리가 무거비리고	그래 안 약을 안 치면 막 곤자리가 먹어 버리고
곤자리라고 무그비리고 마느리 안데요	곤자리라고 먹어 버리고 마늘이 안 돼요
그릉께 지그므 약 안치므 암꺼또 안데	그러니까 지금은 약을 안 치면 아무것도안 돼
그러모 지금까지 말씀하싱거는언자 콩	그러면 지금까지 말씀하신 것은 인제콩
그다메 아까 서숙	그 다음에 아까 조
쑤시	수수
쑤시 감자 꼬치 마늘	수수 감자 고추 마늘
그거 말고 또 반농사 또 어떵기 더 이써씀니까	그것 말고 또 밭농사 또 어떤 게더 있었습니까
구렁기지요 머 녹띠 녹뚜고	그런 거지요 뭐 녹두 녹두고
녹뚜도 내나 콩매이로 시머노코 고마	녹두도 내나 콩처럼 심어 놓고 그냥
시머노모 고마 반만 메주모 여능기고	심어 놓으면 그냥 밭만 매 주면 여는 것이고
잔잔헌 녹뚜	잔잔한 녹두
그 죽 끼리 뭉능거	그 죽 끓여 먹는 것
그라몬 또 또 녹뚱가 녹띵가	그러면 또 또 녹두인지 녹디인지
녹띠	아 녹두
녹띠 말고는 또 얻 반농사 또 어떵기 이씀니꺼	예 녹두 말고는 또 어떤밭농사 또 어떤 것이 있습니까
폳 폰뇨	팥 팥요
퐅 이썬네예	아 팥 있었네요
콩 포	예 콩 팥
콩은 아까 해꼬	콩은 아까 했고
폰농사 그걷또언자 우찌 진는지	팥농사 그것도 인제 어찌 짓는지
포또 내나 시머 고마 콩매로고마	팥도 내나 심어 그냥 콩처럼 그냥
숭거노코 풀마 매주므	심어 놓고 풀만 매 주면
풀마 매주고 꼳피믄 또 야글 처야데고	풀만 매 주고 꽃 피면 또 약을 처야 되고
야글 안치모요 싹 벌레가 무거비리고	약을 안 치면요 싹 벌레가 먹어 버리고
옌나레도 그리 야글 마이 처씀니꺼	옛날에도 그렇게 약을 많이 쳤습니까
저네는 안 처써요	전에는 안 쳤어요
근딛	근데
저네 얘기 쫌 해주이소 요새꺼 말고	전의 이야기 좀 해 주십시오 요즘 것 말고
저네는 시머가꼬 풀만 매고	전에는 심어 가지고 풀만 매고
고마 이그므 이 끄너다가 마 똑똑 뚜디리가꼬	그냥 익으면 이 끊어다가 뭐 똑똑두드려 가지고
빼그리 포치 나오고 콩이 나오고 그랟찌요	뺄거리 팥이 나오고 콩이 나오고 그랬지요
내나 칙	내나 칙
시머가꼬 풀마 매줌 데니까	심어 가지고 풀만 매 주면 되니까
잠깐 폰농사도 읻꼬 또 빠진 거 머가 이쓸꼬예	잠깐 팥농사도 있고 또 빠진 거뭐가 있을까요
몰라 까지도 싱꼬 꼬추예	몰라 가지도 심고 고추에
꼬치바테까지도 시머가꼬 반찬허고 따다가	고추밭에 가지도 심어 가지고 반찬하고 따다가
그러니 까	그러니 가지
호박 호박 싱꼬	호박 호박 심고
내나 그리치요 머인자	내나 그렇지요 뭐 인제
그래 그런 거를 우째 시머가꼬 우째 딴다카는까지를 함번 생각나시는 대로 말씀해 달라는 검니다	그래 그런 것을 어떻게 심어서 어찌 딴다고 하는 것까지를 한 번생각나시는 대로 말씀해 달라는 겁니다
고만 보메 다 그렁거 다 보메 마 호박도 숭거가꼬 지금 머 열고	그냥 봄에다 그런 거 다 봄에 뭐 호박도 심어 가지고 지금 뭐 열고
언자 누룽디이 망 누러이 마 이그모언잗 지금 여러가꼬	인제 누런덩이 막누렇게 마 익으면 인제 지금 열어 가지고
언자 가으레 막 그릉거 다 거다디리요	이제 가을에 막 그런 거 다 거둬들여요
응 함뽀네 다언자 고마	응 한 번에 다 인제 그냥
보메 막 싱꼬	봄에 막 심고
그리 시머노모 전시 가으레 다 추수를 안능가요 가으레	그렇게 심어 놓으면전부 가을에 다 추수를 하잖나요 가을에
가으레언자 싹 주어 디리	가을에 인제 싹 주워 들여
만 어어 안 추어저서언자 호박도 따고 머	만어 안 추워져서 인제 호박도 따고 뭐
다 마무리를 하능기지	다 마무리를 하는 게지
그러고 또 바테 보리드르 숭거찌예	그리고 또 밭에 보리들을 심었지요
저네는언자 바테 보리도 시믄는데 지그믄 전시 녹차를 시므농께	전에는 이제밭에 보리도 심었는데 지금은 전부 녹차를 심어 놓으니까
녹차는인제 빼고	녹차는 인제 빼고
그람 보리말고 밀도 숭구쓸끼고	그럼 보리말고 밀도 심었을 것이고
밀허는 사람 밀갈고	밀 하는 사람 밀 갈고
보리가는 사람 보리갈고 그래써요	보리가는 사람은 보리를 갈고 그랬어요
그라고 밀하고 보리하고는 중요항기라서 쪼꼼언자 뒤에 다시 여쭤보께예	그리고 밀하고 보리는 중요한 것이라서 조금 인제 뒤에 다시 여쭤 볼게요
그라모 먼저언자 보리미더이	그러면 먼저 인제 보립니다이
보리는 그도 여러 종뉴가	보리는 그것도 여러 종류가
보리도	보리도
이쓸꺼 아임니꺼 머 봄보리도 이꼬 가을보리도 이꼬 머이렁기 이쓸꺼 아님니꺼 우뜨씀니꺼	있을 것 아닙니까 뭐 봄보리도 있고 가을보리도 있고 뭐 이런 게 있을 것아닙니까 어떻습니까
케 짜린거또 이꼬	키 작은 것도 있고
케 큰거또 이꼬 보리도언자 그러치요	키 큰 것도 있고 보리도 인제 그렇지요
그런디 봄보리라허고 머 저네	그런데 봄보리라하고 뭐 전에
저네 봄보리 두벌 가능그이 봄보링가 머	전에 봄보리 두 번 가는 게 봄보린가뭐
가으레 뿌리노코 다으메 거둬드링거는 그는 봄보리가 아이지예	가을에 뿌려놓고 다음 해 거둬 들이는 그것은 봄보리가 아니지요
그라모 그기 아마 제일 마이 숭구쓸까튼데	그러면 그게 아마 제일 많이 심었을 것 같은데
가으레	예 가을에
그걸 마이 숭구지	그걸 많이 심지
그걸언자	그걸 인제
가실라고 하하	가시려고 응
할머이 그아까 그거 말씀하시등거 가으레언자 보리가라가지고	할머니 그 아까그거 말씀하시던 것 가을에 인제 보리 갈아 가지고
그담 다음해언자여름 초여름 되면 보리 거다드릴꺼 아임니꺼	그 다음 다음해 인제 여름 초여름되면보리 거둬 들일 것 아닙니까
거 보리 우째 심어가지고 우째 또 농스 그 머 거름도 하고 풀도 매고 할꺼 아임니꺼	그거 보리를 어찌 심어 가지고 어찌 또 농사 그 뭐 거름도 하고 풀도 매고 할것 아닙니까
그래 나중에 크모 나까가꼬 비가지고 타작하낀데	그래 나중에 크  면 낫 가지고 베 가지고 타작할 건데
그 과정에 대해서 함번 쭉 생각나시는대로 말씀해주이소	그 과정에 대해서 한 번 쭉 생각나시는대로 말씀해 주십시오
보리를언자 보리가능거또	보리를 인제 보리 가는 것도
보리가능거또언자 고만 이리 농가라가 골 내가꼬	보리 가는 것도 인제 그냥 이리 논 갈아 가지고 고랑 내 가지고
고를 그 큰 배미 막 쭉 가라가꼬언잗	고랑을 그 큰 배미 쭉 갈아 가지고 인제
마 씨 흐꼬 비료 흐꼬 막 그래만 노믄 그래가꼬 은자 사라므로 더꼬 기계로도더꼬	뭐 씨 흩고 비료 흩고 막 그리만 놓으면 그래 가지고 인제 사람으로도 덮고기계로도 덮고
저네는 소느로 깽이로가꼬 싹 더퍼찌요 고랑고랑	전에는 손으로 괭이를 가지고 싹 덮었지요 고랑고랑
그 고랑고랑 싹다 더퍼찌	그 고랑고랑 싹 다 덮었지
깔쿠릴때로 가꼬덕꼬 머 깽이로가꼬 덕꼬	갈쿠리를 가지고 덮고 괭이를 가지고 덮고
그래노몬언자그맏 쭈우 올라와요 씨가	그래 놓으면 인제 그냥 쭈욱 올라와요씨가
씨가 올로오모언자 고래가꼬마	씨가 올라오면 인제 그래 가지고 마
또인제 이따가 우삐료 허고	또 인제 이따가 웃비료 하고
우삐로언자 짱 나모언자 어느 정도 요리나모언자 사사사살 해노모언자 언자 커지고	웃비료 인제 쭉 나면 인제 어느 정도 요리 나면 인제 살살살살 해 놓으면 인제 커지고
그아노모 지가언자 또 아라서언자 모가지 올라오고 패가꼬	그리 놓으면 자기가인제 또 알아서 인제 이삭 올라오고 패 가지고
뽈록뽈록 패가꼬언자 올라오고 팰때데믄	볼록볼록 패 가지고 인제 올라오고팰 때가 되면
그래가꼬머 보리도 데고마	그래 가지고 뭐 보리도 되고 마
보리도 종뉴가 쫌 이쓸꺼 아임니꺼	보리도 종류가 좀 있을 것 아닙니까
쌀보리카능거또 이써찌예	쌀보리라고 하는 것도 있었지요
그릉께 슨생님 다 아라삐는데 머 내는 모리고	그러니까 선생님이 다 알아 버리는데 뭐 나는 모르고
쌀보리	쌀보리
하모 쌀보라요 쌀보리고 늘보리고	아무렴 쌀보리에요 쌀보리고 늘보리고
그 쌀보리하고 늘보리는 내 이르믄 드런는데 영 잘 모르거든녜	그 쌀보리하고늘보리는 내 이름은 들었는데 영 잘 모르거든요
거 좀 설명 좀 해주이소	그거 좀 설명 좀 해 주십시오
쌀보리는인잗	쌀보리는 인제
고만 여 모감지가 올라오몬 톡톡 요리 볼가지고	그냥 여기 이삭이 올라오면 톡톡 요리 불거지고
톡톡 볼가지게인자 올라오고 늘보리는즈즈 질쭉질쭉허니 마 그리 생기쓰요 늘보리느	톡톡 불거지게 인제 올라오고 늘보리는 저저 길쭉길쭉하게 뭐 그리 생겼어요  늘보리는
그래가꼬언자 해가꼬 바테서언잗 해가꼬 와서언자막 베테 몰랴가꼬	그래 가지고 인제 해 가지고 밭에서 인제 해 가지고 와서 인제 막 볕에 말려 가지고
인자 즈 매상허고	이제 저 매상하고
저네는언자 찌무굳찌 요새 매상허지	전에는 인제 찧어 먹었지 요새매상하지
찌스언자 양석핻찌 양석	찧어서 인제 양식했지 양식
지금 머 기게나 인능가요 도구통에 도구통에 그	지금 뭐 기계나 있는가요 절구통에 절구통에 그
전시 도구통에 소니 불키도록 찌가꼬	전신 절구통에 손이 부르트도록 찧어 가지고
쳉이로 까불고 제 까불고	키로 까부르고 겨 까부르고
그래가꼬 두번세번 찌가꼬 또 도구통에다가머 그 도를가 몽돌로가꼬가라가꼬	그래 가지고 두 번 세 번 찧어 가지고 또 절구통에다가 뭐 그 돌을 가지고몽돌을 가지고 갈아 가지고
사구에다가 막 메뻔을 문때씩꼬 새메 가가꼬	사구에다가 막 몇 번을 문질러 씻고 우물에 가 가지고
그래가꼬 퍼자가꼬언자 해찌	그래 가지고 애벌 삶아 가지고 인제 했지
그러믄 늘보리하고 꺼뽀리가 우째 다른지 고거쫌 설명 좀 해주이소	그러면 늘보리하고 겉보리가 어떻게 다른지 그것 좀 설명 좀 해 주십시오
내나 쌀보리허고	내나 쌀보리하고
꺼뽀리허고 내나 두 종뉴해가꼬	겉보리하고 내나 두 종류 해 가지고
꺼뽀 쌀보리는 똥글똥글허이	겉보 쌀보리는 동글동글하게
이자 마리자믄 예뿌고	인제 말하자면 예쁘고
꺼뽀리는언자 질쭉질쭉해요 막 이리 지러	겉보리는 이제 길쭉길쭉해요 막 이렇게 길어
지러 그렁께 꺼뽀라하고	길어 그러니까 겉보리라 하고
늘보리 꺼뽀리	음 늘보리 겉보리
쌀보리 거뽀리	아 쌀보리 겉보리
쌀보리	쌀보리
쌀보리 꺼뽀리	쌀보리 겉보리
그라몬요게 언자그는 가을에 숭구는 보리아임니꺼	그러면 여기에 인제 그거는가을에 심는 보리 아닙니까
이잗 하모 봄 즈즈 보메 숭거가꼬	인제 아무렴 봄 저저 봄에 심어 가지고
보메 숭거가꼬 볼써 타작 다허고 모 심어따아잉가요 지금	봄에 심어 가지고 벌써 타작 다 하고 모 심었잖아요 지금
자 그람 그건 보리고그지예	자 그러면 그건 보리고 그지요
보리	예 보리
그러몬 미 미레도 머 종뉴가 이씀니까	그러면 밀 밀에도 뭐 종류가 있습니까
밀도 내나 항께 보리허고 가치 가라가꼬	밀도 내나 함께 보리하고 같이 갈아서
가치 또 타작허고	같이 또 타작하고
미른 똑가태요 한 종자라 가튼 항거시기라	밀은 똑 같아요 한 종자야 같은 한그슥이야
그러믄자 이렁거는 그냥 맨 땅에 나믄 안델꺼 아임니꺼 요기 골로 재야 델꺼아임니꺼	그러면 인제 이런 거는 그냥 맨 땅에 놓으면 안 될 것 아닙니까 여기 고랑을 만들어야 될 것 아닙니까
골망 고만 마 두둑허는 사라믄 또요리 넙쩍허이 두두글 맨드러가꼬 또 씨를 뿌리고	고랑만 그냥 뭐 두둑하는 사람은 또 넙적하게 두둑을 만들어 가지고 또 씨를 뿌리고
고를 언자 물 노네 저런디는 저 무디미 노네 저런디언자	고랑을 인제 물 논에저런 데는 저 무디미 논에 저런 데 인제
무리 찡께로 무리 찌므 곡스 그 나라기고 보리 나락 보리가 안데거등뇨	물이끼니까 물이 끼면 곡식 그 벼고 보리 벼 보리가 안 되거든요
안뎅께로언자 그른 노네는 보리가 갈고 시픙께로언자 두두글 지가꼬 흐꼬	안되니까 인제 그런 논에는 보리가 갈고 싶으니까 이제 두둑을 지어 가지고 뿌리고
인잗 물 안 찌는 노는언자 고를 처가꼬	이제 물 안 끼는 논은 인제 고랑을 쳐가지고
고를 처가꼬 마 칠칠흐꼬 그러데요	고랑을 쳐 가지고 마 철철 뿌리고 그러데요
그래가꼬언자 받대고	그래 가지고 인제 밭 되고
옌나레언자 또 해동할 무렵데며는 그 날이 안춥슴니까 아직도	옛날에 인제 또해동할 무렵 되면은 그 날이 춥잖습니까 아직도
예예	예예
그때인자 보리도마 볼꼬	그때 인제 보리도 뭐 밟고
보리도언자 겨우레언자 겨우레언자 보리도 봅꼬	보리도 인제 겨울에 인제 겨울에 인제 보리도 밟고
그 와 볼씸니까	그 왜 밟습니까
그언잗 소신다고요	그 인제 솟는다고요
그 어러중는다고 어러능는다고 뿌리이그 보리 뿌리이 깍 여무러지라고	그얼어죽는다고 얼어죽는다고 뿌리 그 보리 뿌리 꽉 여물어지라고
다지라고 인자 땅에 다지라고	다져지라고 인제 땅에 다져지라고
다지라고 막 저네 봅꼬 그래꺼든	다져지라고 막 전에 밟고 그랬거든
그 다지가꼬 보리가언자	아 그 다져져 가지고
예예	예예
뿌레이가 들뜨지 마라고 하능김니까	뿌리가 들뜨지 말라고 하는 겁니까
예예	예예
보리를 언제 가냐하믄 지금	보리를 언제 가냐 하면 지금
언자 나락 즈그 해묵꼬 나락 가으레 해무꼬 또 보리를 가는디는 갈거등뇨	인제벼 저거 해 먹고 벼 가을에 해 먹고 또 보리를 가는 데는 갈거든요
두철 해뭉는 사라믄	두 철 해 먹는 사람은
두분해뭉는 이자 논 조은데는 보리 나락 해 묵꼬	두 번 해 먹는 인제 논 좋은데는 보리 벼 해 먹고
또 보리 갈고	또 보리 갈고
즈 지금 물 들고 저런디는 허고자도 몽깡께	저 지금 물 들고 저런 데는 하고싶어도 못 가니까
몽깡께 몬허능기고 나락 한 철만 해묵꼬	못 가니까 못 하는 게고 벼 한 철만해 먹고
그러먼자 그 보리 그 요는 머머 김맨다캄니꺼 지심맨다캄니까	그러면 인제그 보리 그 요기에는 뭐 뭐 김 맨다고 합니까 지심 맨다고 합니까
지심도 맨다허고 풀도 매로 간다 허고 마 그러지요	지심도 맨다 하고 풀도 매러간다 하고 뭐 그러지요
그거는	그것은
풀 풀 맨다고	풀 풀 맨다고
그거는 매뻐니나 맴니까	그것은 몇 번이나 맵니까
즈즏 세버는 매야데요	저저 세 번은 매야 돼요
하문 매고 두번 매고 세번	한 번 매고 두 번 매고 세 번
함번 처음 매는거를 가따가 뭐	한 번 처음 매는 거를 갖다가 뭐
아시 아시맨다캄니까	아시 아시맨다고 합니까
보리 보리를요 보리	보리 보리를요 보리
보리	예 보리
보리노는 머 또 지스믄 두벌도 매는 사라믄 부지런 사라믄 매고 하무만 매는사라믄 매고 그래가꼬 해무거요	보리 논은 뭐 또  짙으면 두벌도 매는 사람은 부지런한 사람은 매고 한 번만 매는 사람은 매고 그래 가지고 해 먹어요
지그믄 머 안 허지마는	지금은 뭐 안 하지만
저네는 난나치 그 호맹이로 깽이로 막 파고 푸마시르 해각꼬	전에는 낱낱이 그호미로 괭이로 막 파고 품앗이를 해 가지고
이 지비 가서 아지껄로는 엉께로 땅이 어니까 몬맹께	이 집에 가서 아침 무렵에는 어니까 땅이 어니까 못 매니까
정때로마	저녁 때로만
이 오후예 오저네마 오후예마	이 오후에 오전에만 오후에만
이직꺼 이지베 허믄 또 내일 저지베허고 내일 저지베허고	이 집 거 이 집에하면 또 내일 저 집에 하고 내일 저 집에 하고
다서시등가 여리등가언자 푸마시르 허니까 저네는	다섯이든가 열이든가 인제품앗이를 하니까 전에는
저네는 푸마시르 허능께로	전에는 품앗이를 하니까
한나 아즉낄레는 마 땅이 어러가꼬 그 안 페잉께로 호메이로	한낮 아침 무렵에는 뭐 땅이 얼어 가지고 그 안 파지니까 호미로
반매로 가므 긍게 정때로마 똑 한 나잘쓱인자 이집허고 저집허고 날마당인자 내일 저집허고 내일 저집허고 마 그리 푸마시르 해써요	밭 매러 가면 그러니까 저녁때만 꼭 한 나절씩 인제 이 집 하고 저 집 하고 날마다 인제 내일 저 집 하고 내일저 집 하고 뭐 그리 품앗이를 했어요
옌나레 그 저 초네서 클때 보몬 밀 그튼그는 익으몬 아들이 싹 좀 비가꼬	옛날에 그 저 촌에서 클 때 보면 밀 같은 거는 익으면 아이들이 전부 좀 베서
베다가 베다가 꾸 묵꼬	베다가 베다가 구워 먹고
고거 머한다 캐씀니까	그것을뭐한다고 했습니까
고거언자 부레다가 이리 꾸가꼬	그거 인제 불에다가 이리 구워 가지고
막 밀 찜디기 해뭉는다허고	막 밀 서리 해 먹는다고 하고
밀 써리한다 캐씀니까	밀 서리한다고 했습니까
밀써리	예 밀 서리
고 밀써리 해 봉 그 기어기 이씀니까	그 밀서리 해 본 그 기억이 있습니까
아이 꾸무찌요 마	아이 구워 먹었지요 마
모두 친구들허고 베다가	모두 친구들하고 베어다가
거 해보고	그거 해보고
직쩜노네마 베다가 그래가꼬마 이리 막 부레 끄실러가꼬마 이리이리 비비노모 소니고머이고 새깜허고	각자 논에 뭐 베다가 그래서 이리 막 불에 그을려 가지고 마 이리 이리 비벼 놓으면 손이고 뭣이고 새까맣고
막 그래찌요	막 그랬지요
그러먼자 그거 밀써리라케찌예 밀써리	그러면 인제 그거 밀 서리라고 했지요 밀서리
예예	예예
그라몬 콩도 그래바씀니꺼	그러면 콩도 그리 해 봤습니까
콩도 그리 저네는 꾸무따아임니꺼	콩도 그리 전에는 구워 먹었잖습니까
무우끼 엄씽께 저네는	먹을 것이 없으니까 전에는
저네는 무끼 엄씽께로 보쌀도 보쌀도 그리 끼리가꼬 여 바구리에 해가꼬 여 신다고 이리 다라노모 어른드리	전에는 먹을 게 없으니까 보리쌀도 보리쌀도 그리끓여 가지고 여기 바구니에 해 가지고 여기 쉰다고 이리 달아 놓으면 어른들이
다라노모 그거또 이 아무꺼또 무끼 엄씽께로 그걸 퍼무꼬	달아 놓으면 그것도이 아무것도 먹을 것이 없으니까 그걸 퍼 먹고
어른드 일 까머	어른들 일 가면
그걸 이리 막 한중발 퍼가꼬 그걸 오독오독 씨버묵꼬 보쌀끼리 농걸 밥해뭉는 보쌀 끼리농걸	그것을 이리 막 한 중발 퍼 가지고 그걸 오독오독 씹어 먹고 보리쌀끓여 놓은 걸 밥 해 먹는 보리쌀 끓여 놓은 걸
저네는 그리 안 사란능가요 우리때는	전에는 그리 살지 않았나요 우리 때는
간혹 또 초네서 겨울데머 너머지베 닥도 싹 훔치가꼬 닥써리카능거또 이써는데	간혹 또 촌에서 겨울 되면 남의 집에 닭도 싹 훔쳐 가지고 닭서리라고 하는 것도 있었는데
그거르즈즈 남자드른 마니 했지요 우리 여자드른 몬 허지	그것을저 저 남자들은 많이 했지요 우리 여자들은 못 하지
남자드른 사랑방이 이써가꼬	남자들은 사랑방이 있어 가지고
이 사랑방 사랑방에 이리 니지베언잗 사랑이라고 해가꼬언자 한방에 요리 나리나쿠지머	이 사랑방 사랑방에 이리 누구 집에 인제 사랑이라고 해 가지고 인제 한방에 요리 날이 잡혀지면
날 구꼬 머 추꼬 헐 쩌게	날 궂고 뭐 춥고 할 적에
모여 안자 놀면서 궁금헝께	모여 앉아 놀면서 출출하니까
막 닥 집 저네는 집찜마다 다클 키웅께 지그믄 다클 안 키우지마느	막 닭 집전에는 집집마다 닭을 키우니까 지금은 닭을 안 키우지마는
키웅께 막 살짝살짝 가가꼬 너므 다클  자바온다 댄나제 자바가꼬와서	키우니까 막 살짝살짝 가 가지고 남의 닭을  잡아 온다 대낮에 잡아 가지고 와서
쌀마가꼬 막 무꼬 대리 그걸 대리라허고	삶아 가지고 막 먹고 대리 그것을 대리라 하고
대리	대리
대리헌다 하고	대리한다 하고
대리한다는 거는 그라먼자 닥도 대리를 하지마는 또	대리한다는 것은 그럼 이  제 닭도 대리를 하지마는 또
밥 해가꼬	밥 해 가지고
또 쌀로 또 한 중발쓱 또 직쩜 싸를 가와가꼬 또 니지베언자 가가꼬	또 쌀을또 한 중발씩 또 각자 쌀을 가져와 가지고 또 누구 집에 인제 가 가지고
밥해가꼬 또 김치 내다가 김치 또 직찜 지비 이씅께	밥 해 가지고 떠 김치 내다가 김치는 또 각자 집에 있으니까
가온 상 가오고 막 그래가꼬	가져 온 사람 가져 오고 막 그래 가지고
그래가꼬 저녀그로 밥해묵꼬 저네는 배가 고프니까	그래 가지고 저녁으로 밥해 먹고 전에는 배가 고프니까
그 저녀게 바블 해가무모 어찌그리 마신능고	그 저녁에 밥을 해 가지고 먹으면어찌 그리 맛있는지
그러먼자 대리한다능거는 어쩜니까 지줌 뭐 하나씩	그러면 인제 대리한다는거는 어찌합니까 각자 뭐 하나씩
인자 싸를인자마 쪼께쓱 가오능기라요	인제쌀을 인제 뭐 조금씩 가져 오는 거예요
인자 하 한집	인제 하 한 집
어느 한 지베 하능기 아이고	어느 한 집에하는 게 아니고
한증발썩 이리막 가 와가꼬 대리헌 대리허자 온 저녀게	한 주먹씩 이렇게 막가져와 가지고 대리한 대리하자 오늘 저녁에
쌀좀가와 그래가꼬 언자 친구들허고	쌀 좀 가져와 그래 가지고 인제 친구들하고
그래가꼬언자 머이리 가오모언자 그 싸를 가꼬언자 바블 안치고 머인자 그래가꼬	그래 가지고 인제 뭐 이리 가져 오면 인제 그 쌀을 가지고 인제 밥을 안치고 뭐 인제 그래 가지고
머 인는 고마 가으레 짐치 다마나씽께 머 싱근치를 가오등가	뭐 있는 그냥 가을에 김치 담아 놨으니까 뭐 물김치를 가져 오든가
배추지를 가오등가 그래가꼬 막이리막 찌저가꼬 마	배추김치를 가져 오든가 그래 가지고 막 이리 막 찢어 가지고 마
배추지 막 온가다그로 이리 막 대가리만 문질고	배추김치 막 온가닥으로 이리막 대가리만 썰고
찍 찌저가꼬 막 걸치가 무꼬 그 밥 해가꼬	찍 찢어 가지고 막 걸쳐 가지고 먹고 그 밥 해 가지고
그러믄 므 마시찌요 대리헌다고	그러면 뭐 맛있지요 대리한다고
그러믄 대리하믄인자 밥 해 뭉는건만 대림니까	그러면 대리하면 인제 밥 해 먹는 것만 대리입니까
아이며는 머	아니면 뭐
밥해묵찌 여자드른 머 술도 몬무꼬 허니까로	밥 해 먹지 여자들은 뭐 술도 못먹고 하니까는
그어는 머 찌짐도 꾸고 이렁거는 거는 대리하능거 아임니까	그거는 뭐 전도굽고 이런 거는 대리하는 게 아닙니까
그거또 기라요 찌지미도언자 꾸물 때는 꾸무꼬인자 모이머	그것도 맞아요 전도 인제 구울 때는 구워 먹고 인제 모이면
그러먼자 대리한다칼때예	그러면 이제 대리한다고 할 때에
대리헐 때예 그 머 주로언자 밥	대리할 때에 그 뭐 주로 인제 밥
밥 머 김치고 내나 그러치요머 초네서	밥 뭐 김치고 내나 그렇지요 촌에서
망꼬 요런데는 살 때도 에럽고 하동을 내라가야데고	해 봐야 요런 데는 살 데도어렵고 하동으로 내려 가야 되고
그러닝까로	그러니까
그라몬 짐 요게가 펭사리아임니꺼	그러면 지금 여기가 평사리 아닙니까
펭사리 그 반농사 중에서 특별하게언자 엔나레 요즘 그트므는 아까머 녹 머 차나무를 머 심어따캐씀니까	평사리 그 밭농사 중에서 특별하게 인제 옛날에 요즘 같으면 아까 뭐 차나무를 뭐 심는다고 했습니까
예예	예예
옌나레는	옛날에는
지금잉께 차가 저넨 차가 업찌요	지금이니까 차가 전에는 차가 없지요
그럼그때머 특별히 마이 시믕거언자 우리가 말하는 트굥장물카는 혹시 그렁기 이써씀니꺼	그럼 그때 뭐 특별히 많이 심은 거 인제 우리가 말하는 특용 작물이라고하는 혹시 그런 게 있었습니까
내나 머 염방 말한대로 콩 폳 내나 그렁거 내나 직쩜 바테 쪼께씅쪼께씅언자숭거가꼬	내나 뭐 연방 말한 대로 콩 팥 내나 그런 것 내나 각자 밭에 조금씩 조금씩 인제 심어 가지고
어잗 지그밍께리 이리 막 해가꼬 이 강강지대가 데농께 이마으레	인제 지금이니까는 이리 막 해 가지고 이 관광 지대가 되어 놓으니까 이 마을에
즈 포라뭉는다고 망 느므 바테라도 시머가꼬	저 팔아 먹는다고 막 남의 밭에라도 심어 가지고
한대라도 포라 뭉는다고 그래싸치	한 대라도 팔아 먹는다고 그래 쌓지
저네는 내나 이녁 바테 해가꼬 자기드리인잗 장 다마 뭉는다고 메주씨고	전에는 내나 자기 밭에 해 가지고 자기들이 인제 장 담아 먹는다고 메주 쑤고
내나 자기들 묵꼬 그래써요	역시 자기들 먹고 그랬어요
이녁 바치라는 거는누 바침니꺼	이녁 밭이라는 것은 누구 밭입니까
이녁 바츤 자기 바치지	이녁 밭은 자기 밭이지
자기 바츨 이녁 바치라 그럼니까	자기 밭을 이녁 밭이라고 합니까
그러모 요게 차나무가 머 요새 트굥작무리라캐도 뎀니까	그러면 요기에 차나무가 뭐 요새 특용 작물이라고 해도 됩니까
마이 심슴니까	많이 심습니까
지그믄 마이 시머가꼬	지금은 많이 심어가지고
돈 마니 핸는디언자 지금은 고마언자 또 그 차 그미 엄서농께	돈 많이 했는데인제 지금은 그냥 인제 또 차 금이 없어 놓으니까
그미 엄써노응께로 그래도 올 보메끄지머 해멍는다 아잉가요	금이 없어 놓으니까 그래도 올 봄에까지 뭐 해 먹지 않습니까
그 차나무는 언제부터 숭구씀니꺼	그 차나무는 언제부터 심었습니까
차나무 숭근제 오래 데찌요 여그도	차나무 심은 지 오래 됐지요 여기도
저네 저 하개서 막 씨를 막 이 킁 가마이로 마 이러케 막 삼마너이고 머 오  마너이고 주고	전에 저 화개에서 막 씨를 막 이렇게 큰 가마니로 막 이렇게 막삼만 원이고 오만 원이고 주고
우리도 오마넌 주고 항 가마이 사 즈 친정 바테다 시먼는디	우리도 오만 원주고 한 가마니 사 저기 친정 밭에다 심었는데
머 항개도 따도 몬허고 고만 풀만 지스가꼬 갈리를 안헝께 지금 이래가꼬	뭐하나도 따지 못하고 그냥 풀만 짙어 가지고 관리를 안 하니까 지금 이래 가지고
나무만 서가 이찌요	나무만 서서 있지요
생지네 따도 몬허고	생전에 따지도 못하고
보므로 따야데는디고마	봄에 따야 되는데 그냥
고마 이렁거 해가꼬 번다고	그냥 이런 거 해 가지고 번다고
이렁기 해가꼬 번다고마	이런 거 해 가지고 번다고 그냥
그는 갈리도 안허고 헝께 친정바테	그거는 관리도 안 하고 하니까 친정 밭에
나무마 서 가꼬 이찌 지금	나무만 서 가지고 있지 지금
할무이도 직쩝그러몬 차나무를	음 할머니도 직접 그러면 차나무를
시머찌요 항 가마이 사가꼬	심었지요 한 가마니 사 가지고
너미 숭궁께언자 따라서	남이 심으니까 인제 따라서
너미 숭궁께언자 새메언잗 친정바치라도 이씽께로	남이 심으니까 인제 샘에 친정 밭이라도 있으니까는
시머난는디 해녹코 나는 해 묵따 몬해찌	심어 놨는데 해 놓고 나는 해 먹지도못 했지
한 머 멘녀이 데도	한 뭐 몇 년이 돼도
그 푸미 마이 듬니까	그 품이 많이 듭니까
보메 언자 그걷 잔잔허이 두모 두모디쓱 그거 두 이파리쓱	봄에 인제 그거 잔잔하게 두 마 두 마디씩 그거 두 이파리씩
똑 두 이파리쓱 따야데거등요 그글	꼭 두 이파리씩 따야 되거든요 그걸
그래가꼬 즈 폴로 가야데	그래 가지고 저 팔러 가야 돼
그러믄 보드락께 따가꼬 가믄 쩨껨 도늘 더 주고	그러면 부드럽게 따 가지고가면 조금 돈을 더 주고
언자 나므모 며빼거이라도 더 주고	인제 남으면 몇 백 원이라도 더 주고
언자 세이파리쓱 따감 도니 또 고만 자가비리고 그래요 그렁께로언자	인제 세이파리씩 따가면 돈이 또 그만 적어 버리고 그래요 그러니까 인제
그라모 그기 다 이르미 이씀니까 두 이파릴 때는 무슨 차 세 이파릴 때는	그러면 그게 다 이름이 있습니까 두 이파릴 때는 무슨 차 세 이파릴 때는
녹 그거언자	녹 그거 인제
처메 젤로 처메 날쩌게는 우즌	처음에 가장 처음 날 적에는 우전
우즌	우전
그거는언자 육마넌 오마넌허데요 여 해장	그거는 인제 육만 원 오만 원 하데요여기 회장
육마넌 오마넌은 얼마언마얼마마다	육만 원 오만 원은 얼마 얼마 얼마마다
그스 즈즈 배꾸라메 배꾸람	그게 저저 백 그램에 백 그램
내나 요만헝거요 요만허이 내나 여그 헤장님	내나 요만한 거요 요만하게 내나  여기 회장님
헤장님도 어뜨게 녹차를 잘 멘드시능고	회장님도 어떻게 녹차를 잘 만드시는지
사가꼬 느므 이플 사가꼬	사 가지고 남의 잎을 사 가지고
봄데먼 만날 안 맨드능가요	봄 되면 만날 만들지 않나요
즈 하개 올라가는디 그	저기 화개 올라가는 데 거기
그라몬	그러면
노리터가 이꺼등요	놀이터가 있거든요
관장님도 직접 그라믄 차농사를 지씀니꺼	관장님도 직접 그러면 차농사를 짓습니까
진능기 아이라 할매드리 따서 즈 하개 할매드리	짓는 게 아니라 할머니들이따서 저기 화개 할머니들이
따스 주는 거는 따 오모언잗 헹수 따오세요 허면 따 오거등뇨 고렁게언자 메키로메키고 고마	따서 주는 그것은 따 오면 인제 형수 따 오세요 하면 따 오거든요 그런 게 인제 몇 킬로 몇 킬로고 그냥
사가꼬 고리 잘 맨드데요	사 가지고 그리 잘 만들데요
그래가꼬 여그 와서인자 학상들 머 머 마치믄 또 그거 하나쭈고 마	그래 가지고여기 와서 인제 학생들 뭐뭐 마치면 또 그거 하나 주고 뭐
만든다는 거는 차를 만든단 마림니꺼	만든다는 거는 차를 만든단 말입니까
예 차를 이리막 덕꼬	예 차를 이리 막 덮고
그라몬 차 이파리는 사가와서	그러면 차 이파리는 사와서
이파리만 사가꼬	이파리만 사 가지고
집쩝 고마 손수로	직접 그냥 손수
손수로 맨드라요 기게로가꼬 허능기 아이고	손수 만들어요 기계를 가지고 하는 게 아니고
이 관장니믄	이 관장님은
어디서함니꺼 그러모	어디서 합니까 그러면
저저 하개 가는 화개 올라가는디 지그 그 사 이꺼등뇨 사무시리 또 하나 이써요	저기 저 화개 가는 화개 올라 가는 데 지금 그 사 있거든요 사무실이 또하나 있어요
그래가꼬 그그 와따가 여그 와따가 그 와따가	그래 가지고 거기 왔다가 여기왔다가 거기 왔다가
또 저녀그론 으베 내리 이녁 지베 내러 가시고 그래요	또 저녁으론 읍에 내려 자기 집에 내려 가시고 그래요
그그 또 여그 온 손님 그 게시믄	거기 또 여기 온 손님 거기 계시면
관장니미 그 게시믄인자 여그 와따고 허믄 또 그리 또 오란 사라믄 또 오래가꼬또 또 노다가 또 오고	관장님이 거기 계시면 인제 여기 왔다고 하면 또 그리 또 오라는 사람은 또 오라고 해 가지고 또 또 놀다가 또 오고
그러믄녜	그러면요
아까는 주로언자 우리가언자 곡식 종뉴로 안해씸니까이	아까는 주로 이제 우리가 이제 곡식 종류를 하지 않았습니까이
그 머 보리 밀 꼬치 머 서숙 이렁거 핸는데	그 뭐 보리 밀 고추 뭐 조 이런 걸 했는데
그거말고인자 수바기나 차메 복쑹 머 이른그는 안해씸니까	그고 말  고 인제 수박이나 참외 복숭아 뭐 이런 것들은 안 했습니까
그렁거는 안해찌요	그런 거는 안 했지요
그렁거는 머	그런 거는 뭐
수박또 함번도 노 봉거 엄씀니까	음 수박도 한 번도 놓아 본 것 없습니까
아이고 그기 머 베끼 데능가요 그거또 야글 얼매나 치고언자 저릳 포라 물라고언잗 특뻬리 허는 사람 허지 이 동네는 그렁거 안해요	아이고 그게 뭐 공연히 되는가요 그것도 약을 얼마나 치고 인제 저리 팔아 먹으려고 인제 특별히 하는 사람하지 이 동네는 그런 거 안 해요
수박 그른거는 안해	수박 그런 것은 안 해
언자 배농새에 이리 절믄 사람들언잗자 서너찌비 세찌비 진능가베	인제 배농사에 이리 젊은 사람들 인제 서너 집이 세 집이 짓는가 보네
요 올라오는디 요거 저 머 어즈껟께 쌍시기 부재라는 사람 그 사람 쌍시기 그사라미언자 또 배바츨 저쩌젇	요기 올라오는 데 요기 저기 뭐 어저께 쌍식이 부자라는 사람 그 사람 상식이 그 사람이 인제 또 배 밭을 저쪽에 저 저 저
또 너므 노늘 사가꼬 또 배바치 엄씽께로 너므너므노늘 사가꼬 또 그리허고	또남의 논을 사 가지고 또 배 밭이 없으니까 남의 남의 논을 사 가지고 또 그리 하고
언자 옌나레 농사를 지따가 보메는 바뚝이나	예 인제 옛날에 농사를 짓다가 보면은
들 또는 그 사네 풀 마이 날꺼 아임니꺼	들 또는 그 산에 풀이 많이 날 것 아닙니까
푸른 말도 몬허지요	풀은 말도 못하지요
그렁께 풀이름 기억 나시능거 이씀니꺼	그러니까 풀 이름 기억 나시는 것이 있습니까
띠뿌리이 막 띠뿌리이 바테 띠	띠 뿌리 띠 뿌리 밭에 띠
띠라고 막 사람 막 여리 쑤시거등 띠뿌리 그기	띠라고 막 사람 막 요리 쑤시거든 띠 뿌리 그게
띠뿌레이 그거 막 파고 디러오지 바테 바츨 안 매고 막 허믄	띠 뿌리 그게 막파고 들어 오지 밭에 밭을 안 매고 막 하면
논뚜르게 풀료 뻐뻗헌 그거	논두렁에 풀요 뻣뻣한 그것
삐비 삐비 나는 거	삘기 삘기 나는 것
삐비 아능가요	삘기 아는가요
까뭉는 그그 고고 함 말씀해주이소 그거 재미뜬데예	까먹는 그것 그것 한번말씀해 주십시오 그것 재미있던데요
삐비 삐비라허지	삘기 삘기라하지
그거언잗 뻐뻗헌 푸레 그 즈즈 막 그기언자 고만 막 그 푸리 논뚜르게 요리 줄이써가꼬	그거 인제 뻣뻣한 풀에 그 저저 막 그게 인제 그냥 막 그 풀이 논두렁에요리 줄 있어 가지고
논뚜르게 이쓰가꼬언자 바츨 안 매모 그글 자꾸 해녀네 해마다 파 조야덴다 논뚜르글	논두렁에 있어 가지고 인제 밭을 안 매면 그걸 자꾸 매년 해마다 파 줘야된다 논두렁을
안 파주모마 여 바까운데끄지 디러와비리요	안 파주면 뭐 여기 밭 가운데까지들어와 버려요
그럼 곡시기 마 안 데비리요	그럼 곡식이 뭐 안 돼 버려요
긍께 푸를 어떠틍가 매야데	그러니까 풀을 어떻게든지 매야 돼
푸를 안 매모 아무거또 안데요	풀을 안 매면 아무 것도 안 돼요
그게 므슨푸리라고예	그것이 무슨 풀이라고요
띠 띠	띠 띠
그럼 띠기 크먼	그럼 띠가 크면
삐비	삘기
삐비	삘기
이래 안뎀니꺼이	이렇게 되잖습니까
예예	예예
고거는 나주 비가지고 어디 씀니까	그것은 나중에 베 가지고 어디에 씁니까
머 고만 바테언자 머 여 토라니나 시머노머	뭐 그냥 밭에 인제 뭐 여기 토란이나 심어 놓으면
요리 해가꼬 막 질머언자 토랑꼬랑에다가언자 나 노모	요리 해 가지고 막 길면 인제 토란 고랑에다가 인제 놔 놓으면
그기 써그면 그름 덴다고 고마 기양	그것이 썩으면 거름이 된다고 그냥
요게서는	요기서는
그름 덴다고 깔고	거름 된다고 깔고
그 띠풀 그 가지고 엔나레 초가지붕 이아고 이러진 아내씀니까	그 띠 그것 가지고 옛날에 초가 지붕을 이고 이러진 않았습니까
그기 그거 아니고 또 즈 사네 가머	그게 그게 아니고 또 저기 산에 가면
또 지붕 인능거는 그 이꺼등뇨	또 지붕 이는 것은 거기 있거든요
머 새	뭐 억새
크기	크게
그 즈즏	그 저저
샏때카능거	억새라고 하는 거
쎄쎄 쎄쎄쎄 쎄	억새 억새 억새 억새 억새억새
쎄 그렁거 하믄 저네는 그렁가따가 또 마	억새 그런 거 하면 전에는 그런 거갖다가 또 뭐
마구 그 염세이 마구 그런디를 마 이고 그래찌요 지피 기헝께네 또	마구 그 염소 마구 그런 곳을 막 이고 그랬지요 짚이 귀하니까 또
그거는 빠빧하고 대가 이찌예	그거는 빳빳하고 대가 있지요
예예	예예
그거또 말씀쫌 해주이소	그것도 말씀 좀 해 주십시오
고기언자 쎋떼기푸리라허지 쎋떼기 쌔떼기	그것이 인제 억새 풀이라고 하지 억새 억새
쌔떼기 그거 나중에 가실 데머 꼬또 막 하야케 피고 그렁거 아임니꺼	아억새 그거 나중에 가을 되면 꽃도 막 하얗게 피고 그런 거 아닙니까
저 가예 동정까예 저런디도 쎄가 이씨믄 그 막	예 저기 동정 가에저런 데도 억새가 있으면 그 막
그그 즈즈 한들한들허이 마	그거 저저 한들한들하게 뭐
그그 빼다가 막 비짜리도 매고	그거 빼다가 막 빗자루도 매고
여 방 지금 방 씨는 비짜리	여기 방 지금 방 쓰는 빗자루
때매이로 그리 올로오데요 그	대처럼 그렇게 올라오데요 그
띠예 띠뿌리이예	띠에 띠뿌리에
그라모 그거하고 또 갈때라는 거 이써찌예	그러면 그것하고 또 갈대라는 거 있었지요
갈때도 익꼬	갈대도 있고
갈때하고 그건 다른 기지예	갈대하고 그건 다른 거지요
그라몬 갈때하고 쌛때하고 쌔때기라케씀니까	그러면 갈대하고 샛대하고 샛대기라고 했습니까
쎋때기	샛대기
바테는언자 그 쎄떼기고	밭에는 인제 그 억새고
삐비 나는 쎋 쎋떼이고	삘기가 나는 억 억새고
근 그거는	그건 그거는
말고 삐비나는 그거는 아까	말고요 삘기가 나는 그것은 아까
띠풀	띠
띠푸리고	띠풀이고
그 다메 저 아까 머 얌생이 머	그 다음에저 아까 뭐 염소 뭐
지붕 에아는 그거는 쌔떼기고	지붕 이는 그거는 억새고
그거는 또그거는 또 다리고	그것은 또그것은 또 다르고
그 다으메 또 갈때 또 따로 이꼬	그 다음에 또 갈대 또 따로 있고
갈때는또 따로 그 갈때익꼬	갈대는 또 따로 그 갈대 있고
그글언자 빼다가 또 비짜리매고	그걸 인제 빼서 또 빗자루 매고
부지른 사람 그글 빼다가언잗	부지런한 사람 그걸 빼다가 인제
돈 주고 즈 사야뎅게로	돈 주고 저 사야 되니까
어뜬 사암드른 그너믈 막 빼다가	어떤 사람들은 그놈을 막 빼다가
어디 마니 인는 중을 알아가꼬	어디에 많이 있는 데를 알아 가지고
빼다가 비짜리를 매가꼬	빼다가 빗자루를 매 가지고
그 여문 즈 끄내키로 가꼬 막 매가꼬	그 여문 저 끈을 가지고 막 매 가지고
방 씰고 그리허고 막 그러데요	방 쓸고 그리 하고 막 그러대요
그러먼자 또 그거 말고 또 풀 또 다른거또 마이 이쓸꺼 아임니꺼	예 그러면 인제 또 그것 말고 또 풀 또 다른 것도 많이 있을 거 아닙니까
받 여페	밭 옆에
엔나레 와 그 짠대기짠대기 머라캄니꺼 그	옛날에 왜 그 잔디잔디 뭐라고 합니까 그
그 머이고	그 뭐니
푸리 함 마 여러 종뉴지	풀이 아무렴 마 여러 종류지
그 머이고 즈즈즈즈	그 뭐니 저 저 저 저
여프로 에 요 여프로 기가꼬 와가꼬 뿌래이 내리고 하능거	옆으로여기옆으로 기어 가지고 와 가지고 뿌리 내리고 하는 거
납짜거이마 기능거	납작한 게 뭐 기는 것 예
그걸 머라캄	그걸 뭐라고 합니까
그 바래기 바래기	그 바랭이 바랭이
바래기 참	어 바랭이 참
바래기풀	바래기풀
고거 말씀 좀 해 주이소	그것 말씀 좀 해 주십시오
바래이풀 그	바래기풀그
바래이풀 그그는 막 쯔리노머 영 반매이가 여 납짝허이 납짝허이 고마 퍼징께	바랭이풀 그것은 막 엉겨 놓으면 영 밭매기가 납작하게 납작하게 그냥 퍼지니까
반매이가 영 더디고 사납찌	밭매기가 영 더디고 사납지
또 감나무푸리라고 요리 미쭉허이 올라가는 감나무푸리라고	또 감나무풀이라고요리 미쭉하게 올라가는 감나무풀이라고
감나무풀	감나무풀
감나무푸리라고 이써	감나무풀이라고 있어
머꼬 감나무 나문데 그이 와 푸림니꺼	뭡니까 감나무 나문데 거게 왜 풀입니까
바테	밭에
감나무 쪼껜허이 푸리 저 어디 이씨끼구마	감나무 자그만한 풀이 저기 어디 있을 거구만
감나무 요리	감나무 요리
언자 막 그걸 감 나무라고 따가꼬	이제 막 그것을 감나무라고 따 가지고
감꼬 올라가능거	감고 올라가는 것
강꼬 올라가는거또 이꼬 머 여러 푸리 막	감고 올라가는 것도 있고 뭐 여러풀이 막
말고 감나무풀카능거는 감꼬 올라감니꺼	아니고 감나무풀이라고 하는 거는 감고 올라갑니까
그그는 아이고 즈즈 여 쭈욱 올라와가꼬	그것은 아니고 저저 여기 쭈욱 올라와가지고
뺄거리 짜잘하이 감매이로 여러요	빨갛게 자잘하게 감처럼 열어요
그기 열매가	그게 열매가
긍께 그글 감나무푸리라허고	그러니까 그것을 감나무풀이라고 하고
그렁거는 마 이리이리 빼머 잘 빼지고 빼이가 좋은디	그런 것은 뭐 이렇게 이렇게 빼면 잘 빠지고 빼기가 좋은데
그 납짝허이 아까 퍼지능거 머이고 바래이풀 그그는 반매이가 바테 그 이씨먼 제일로 파이라요	그 납작하게 아까 퍼지는 것 뭐니 바랭이풀 그것은 밭매기가 밭에그게 있으면 제일 나빠요
그 담	음 그 다음
그 뿌리이가 짝 퍼저가꼬	그 뿌리가 쫙 퍼져 가지고
감나무풀카는 그그는 쪽 올라감니꺼	감나무풀이라고 하는 그거는 쪽 올라 갑니까
바로 올라가비리	예 바로 올라가 버려
아니면 여페 조 이파리 막붇꼬 이라지예	아니면 옆에 저 이파리들에 막 붙고 이러지요
인잗	인제
그거또 하모 가재이가 벌지 요리 올라오머	그것도 아무렴 가지가 벌어지지요리 올라오면
가재이가 처으메는 자잘헐때는언잗 올라와도	가지가 처음에는 작을 때는 인제올라와도
그라먼 끄티예는언자 요런 요래 쪽 요런 요런 데가	그러면 끝부분에는 인제이런 이렇게 쭉 요런 요런 데가
잔잔허이 열매가	자잘하게 열매가
열매가 한두 개 분능기 아이고	예 열매가 한두 개 붙는 것이 아니고
예예	예예
조락쪼락 여러 감매이로	다닥다닥 열어 감처럼
그렁께 감풀	그러니까 감풀
감매이로	감처럼
감나무풀 캐씀니까	감나무풀이라고 했습니까
감나무풀	예 감나무풀
또 그 말고 어떤 푸리 이써씹니까	또 그것 말고 어떤 풀이 있었습니까
언자 저	인제 저
띠푸리고 머 바래기고 내나 감나무푸리고	띠고 뭐 바랭이고 내나 감나무풀이고
머 구렁기지요머 또 머머인가 모리걷따	뭐 그런거지요 뭐 또 뭐 뭐인가 모르겠다
쑤근 풀 아임니꺼	쑥은 풀 아닙니까
쑤근 풀 아니지요	쑥은 풀 아니지요
쑥 우리가 무그 캐뭉께	쑥 우리가 먹어 캐 먹으니까
그 나무림니까 그거는	그 나물입니까 그거는
치너무리고	취나물이고
치너무리고 꼬사리고 머	취나물이고 고사리고 뭐
지금까지 말씀해 주싱거는예 반농사를 지을 때하고 관련되는 김니더이	예지금까지 말씀해 주신 것은 밭농사를 지을 때와 관련되는 것입니다이
지금 제가 여쭈어 보능거는 언자 그 가을데면언자 다 거다 드리야델꺼 아임니꺼	지금 제가 여쭈어 보는 것은 인제 그 가을되면 이제 다 거둬 들여야될 것 아닙니까
그래 아까 머언자 머 콩타작 머이런 말씀도 해 주션는데	그래 아까 뭐 인제 뭐콩타작 뭐 이런 말씀도 해 주셨는데
쪼옴 더 자세하게 함 여쭈어 보겠습니다	좀 더 자세하게 한 번 여쭈어 보겠습니다
요즘 말고 엔나림니더이	요즘 말고 옛날입니다이
옌나레 그 탈곡하덩거 트키인자 나락	옛날에 그 탈곡하던 것 특히 인제 벼
하모 나락	아무렴 나락
나락 탈곡하는 방법하고	벼 탈곡하는 방법하고
어떠케 탈곡하는 기계가 이쓸꺼 아임니꺼이	어떻게 탈곡하는 기계가 있을 것 아닙니까
그렁거로 대해서 먼저 나락을 비가꼬	그런 거에 대해서 먼저 벼를 베 가지고
베가꼬언자 잔잔허이 뭉커가꼬	베 가지고 인제 잔잔하게 묶어 가지고
잔잔허이 지플 가꼬 집다늘 가가가꼬 잔잔허이 요막쓱허이 뭉커요	잔잔하게짚을 가지고 짚단을 가져 가지고 잔잔하게 요만큼하게 묶어요
뭉커가꼬 이리 뭉커서마 매 안 풀리고로	묶어서 이렇게 묶어서 뭐 매 안 풀리게
어떠틍가네 안풀리거로 기게에다 오옹 헝께	어떻든지 안 풀리도록 기계에다 옹옹 하니까
그 기게 저네는 발로 볼바가꼬	그 기계 전에는 발로 밟아 가지고
그리 타자글허기땀세 어쩨라도마 매 뭉커야데거등 그 나락	그렇게 타작을 하기때문에 어떻게 해서든지 뭐 매 묶어야 되거든 그 벼
나락따늘	볏단을
실찌기 뭉커노모 고만	살짝 묶어 놓으면 그냥
이 따라가서 막 학 풀리비리모 그거 싹 흐치즈비리머	이 따라가서 막 확 풀려버리면 그것 싹 흩어져 버려
나라기 훌터지도 안허고 그 바다게 훌터지도 안허고	볍씨가 훑어지지도 않고 그바닥에 훑어지지도 않고
또 새로 막 개리가꼬 뭉커야데고 그러니까	또 새로 막 가려 가지고 묶어야 되고그러니까
그 여러 사람 푸마시르 해가꼬마 여러 사람 뭉끄머	그 여러 사람이 품앗이를해 가지고 여러 사람이 묶으면
이 우리드른 매 뭉큰다고 매 뭉크지마는	이 우리들은 단단하게 묶는다고 매묶지만
어떤 사람드름 마 비시기 해가꼬 얼르얼르 뭉커가꼬 넘 아페 나갈라고	어떤 사람들은 뭐 허술하게 해 가지고 얼른얼른 묶어 가지고 남 앞에 나가려고
마 나락따늘 막 고마 안 돌리고 고마 실쩍실쩍실쩍 뭉커서 고마 나따 나뚜고마	뭐 볏단을 막 그냥 안 돌리고 그냥 슬쩍슬쩍슬쩍 묶어서 그냥 놔두 놔두고
이 푸마시르 허머 막 아페 서로 아페 갈라고	이 품앗이를 하면 막 앞에 서로 앞에 가려고
아페 갈라고	앞에 가려고
아페 뭉커서 마 항 고랑쓱 졸졸하이 자바서 나가기땀세 직쩜 고랑이 이써가꼬	앞에 묶어서 뭐 한 고랑씩 줄졸하게 잡아 나가기 때문에 각자 고랑이 있어 가지고
고마 비슥비슥 뭉커가꼬 마 힉 해노코 가비리고 가비리고	그냥 대충대충 묶어놓고 뭐 휙 해 놓고 가 버리고 가 버리고
디에 가씸 디에 가찌 우리드른 어째도 그걸 안 풀리그로 기게에 그 안 풀리그로매 뭉커줄랑께	뒤에 갔으면 뒤에 갔지 우리들은 어떻든지 그걸 안 풀리도록 기계에 그 안 풀리도록 단단하게 묶어 주려니까
더디지요 더디	더디지요 더뎌
저언자 다늘 뭉는다케찌예	저 이제 단을 묶는다고 하셨지요
다늘	단을
단도 자근기 이꼬 큰기 안 이씸니꺼	단도 작은 것이 있고 큰것이 있지 않습니까
예예	예예
그렁께	그러니까
그 단 종뉴에 대해서 말씀쫌 해 주이소	그 단 종류에 대해서 말씀 좀 해 주십시오
잔잔허이 보통 고마 요리 뭉커야지	잔잔하게 보통 그냥 이렇게 묶어야지
느무 자라도 또 기게 허는 사래미 노락질거따고 안 조타허고	너무 잘아도 또 기계 하는 사람이 장난 같다고 안 좋다고 하고
또 이 보통 고만 여물기만 뭉크머 덴데요 그 기게재이드리	또 이 보통 그냥여물게만 묶으면 된대요 그 기계쟁이들이
여물기마 안 풀리고로	여물게만 안 풀리도록
하이튼가네 이 따라감서 이리 옹옹 발로가꼬 이리 볼바가꼬 옹옹허기 땀세 타자글 허기 땀세	하여튼 이 따라가면서 이리 옹옹 발을 가지고 이리 밟아 가지고 옹옹하기 때문에 타작을 하기 때문에
쪼깐 노락따니 커도 안 풀리그로만 해주라능기라 저네 사람드른	조금 볏단이커도 안 풀리게만 해 달라는 거야 전에 사람들은
근데 지끔 할머니 말씀하싱거는	그런데 지금 할머니 말씀하신 거는
기계가꼬 볼릉거 아임니꺼	기계 가지고 밟는 것 아닙니까
볼바	예 밟아
근데 그 봅기 저네는 이래 훌릉기 안 이씀니꺼	근데그 밟기 전에는 이렇게 훑는 것이 있지 않습니까
써리홀태	그네
그러니까 고거부터 좀 얘기를 해 주이소	그러니까 그것부터 좀 얘기를 해 주십시오
고거부터 허능기 아이라언자 기게예	그것부터 하는 것이 아니라 인제 기계에
마니 농사를 진는 사라믄 머 너믈	많이 농사를 짓는 사람은 뭐 남을
기게 그 가 오래가꼬	기계 그거 가져 오라고 해 가지고
언자 염방 여 방에 자드끼 자능거매이로 이 여러 동네가 마느니까	인제 연방여기 방에 자듯이 자는 것처럼 이 여러 동네가 많으니까
봅는 사라믄 기게는 자꼬	밟는 사람은 기계는 적고
즈즏 이 그스글 해요	저저 이 그슥을 해요
이자 오늘 정때는 니가 헌다 내일 정때는 니가 헌다 딱딱 그거 순서를 매기게해요	인제 오늘 저녁에는 누가 한다 내일 저녁에는 누가 한다 딱딱 그거 순서를매기게 해요
그는 기게예 매기능 기지예	그건 기계에 매기는 거지요
하모 그 임재한테	그럼 그 임자한테
인자 볼바주는 기게 가꼬 데이는 사람한테	이제 밟아주는 기계 가지고 다니는사람한테
그래가꼬인자 내일 정때는 여그 오고 모레 정때는 내일 오고 그리해야 또 노불얻찌 아라서 그그 기게가 온다므	그래서 이제 내일 저녁에는 여기 오고 모레 저녁에는 내일 오고 그리 해야 또 일꾼을 구하지 알아서 그그 기계가 온다면
노불 어더야 데니까	일꾼을 구해야 되니까
긍께 그래가꼬	그러니까 그래 가지고
노블 언는다는 마른 인자 일꾸늘	놉을얻는 다는 말은 이제 일꾼을
푸마씨	품앗이
일꾼	예 일꾼
푸마씨르언자 허능기라요	품앗이를 인제 하는 거예요
저네는 그기 이링께 따니리 응꼬	전에는 그것이 일이니까 딴 일이 없고
망고 돈뻐리도 엄꼬 허니까로	아무데도 돈 벌이도 없고 하니까는
저네는언자 그걸가 푸마씨르 해가꼬언자 그리허능기라요	전에는 인제 그걸 가지고 품앗이를 해 가지고 인제 그리 하는 거예요
나랑 뭉크고	벼를 묶고
또 비고머	또 베고 뭐
베로 나락베로 가자 머 보리베로 가자 머 저네는 전시 소느로 해농께	베러  벼 베러 가자 뭐 보리 베러 가자 뭐 전에는 전부 손으로 해 놓으니까
지그먼자 기게로 허지	지금은 인제 기계로 하지
그래가꼬언자 해찌요 나라글	그래 가지고 인제 했지요 벼를
그러니까언자 아까 써리홀태라캐씀니까	그러니까 이제 아까 써리홀태라고 했습니까
써리홀태	그네
써리홀태로 가꼬 하능거	그네를 가지고 하는 것
그거는얼매나 더디요	그것은 얼마나 더뎌요
그거는 쩨께쓱 요리 하나가 요리 나락 요리 나 가따 노 간조로이 나노코	그것은 조금씩 요리 하나가 요리 벼 요리 놔 갖다 놓고 간조롬하게 놔 놓고
또 이 끈 푸러가꼬	또 이 끈 풀어 가지고
요리 쪼께쓱 한 주먹쓱 떼 주머언자 요리 하나는 서가꼬 업치가꼬 막 이리 훌틀랑께	이렇게 조금씩 한 주먹씩 떼 주면 인제 요리 하나는 서 가지고 뒤집어 가지고 막 이리 훑으려니까
훌꼬 하나는 떼 주고 또 하나는 그그스 또 나락 요리 훌터주머언자	훑고 하나는 떼 주고 또 하나는 거기서 또 벼를 이렇게 훑어 주면 인제
요리 진태미 그 껍 그 입 나라깁 그넘 추리내야데	요리 볏잎 그 껍 그 잎 볏잎 그것을 추려 내야 돼
추리 내야데고 일도 마나요	추려 내야 되고 일도 많아요
일도 마나 써리홀태야 훌터라	일도 많아 그네에 훑어랴
아까 머 진태미라케씀니꺼	아까 뭐 진태미라 했습니까
그기 멈니꺼	그게 뭡니까
그 나라깁 나라깁	그 볏잎 볏잎
그걸 진태미라케씀니꺼	그것을 진태미라고 하셨습니까   하머 저네는  아무렴 전에는
그렁기 중뇨함니다	아 그런 게 중요합니다
나락입 그거 싹 추리내고	볏잎 그거 싹 추려 내고
나랑 난만 해가꼬 또 챙이로 까불고	벼 낟만 해 가지고 또 키로 까부르고
그래가꼬 이 느러 덕써게다가 너러가 몰류고	그래 가지고 이거를 널어 멍석에다가 널어 가지고 말리고
그래가꼬 또 도구통에다 찌코	그래 가지고 또 절구통에다 찧고
도구통에 찌가꼬 찌노먼 세벌로 찌도 함먼 찌가꼬 껍데기언자 이리 베끼가꼬	절구통에 찧어 가지고 찧어 놓으면 세 번을 찧어도 한 번 찧어 가지고 껍질을 인제 이리 벗겨 가지고
챙이에다가 까불고 또 찌가꼬 또 까불고 또 찌가꼬 까불고 세벌로 해도요	키에다 까부르고 또 찧어 가지고 또 까부르고 또 찧어 가지고 까부르고 세 벌을 해도요
세벌로 해도 도구통에 해도	세 벌로 해도 절구통에 해도
한 바가치쓱 여 가꼬 세 벌로 해도 싸리 눌해요	한 바가지씩 넣어 가지고 세번을 해도 쌀이 누래요
지금 헤미쌀 사가꼬 모두 잡수고 그러대 그거	지금 현미쌀 사 가지고 모두 잡숫고 그러대 그것
조은 바비라고	좋은 밥이라고
그러믄 그지예	그러면 그죠
그래가꼬 바블 해무꼬 안 사란능가요	그래서 밥을 해 먹고 살지 않았나요
저 써리홀태하고	저 그네하고
기게 기게는 머 그냥 기게라케씀니꺼 머 기게는 써리홀태 딴 이르미 이씀니꺼	기계 기계는 뭐 그냥 기계라고 했습니까 뭐 기계는 그네 딴 이름이 있습니까
기게언자 이거는 써리홀태고 그거는 오옹허는 기게라 허고	기계 인제 이것은 그네고 그것은 옹옹 하는 기계라고 하고
그래 오옹하는 기계라캐씀니까	그래 오옹하는 기계라고 했습니까
다른 이르미 업써씀니까	다른 이름이 없었습니까
그거 그거 머이 항가지 인는디	그것 그것 뭣이 한 가지 있는데
모리걷따	모르겠다
머 탈고끼 이런 말 써씀니까	뭐 탈곡기 이런 말 썼습니까
탈고끼 하	탈곡기 응
탈구끼라 핻따	탈곡기라고 했다
탈곡기라캐씀니꺼	탈곡기라고 했습니까
예예	예예
그러믄언자 탈고끼는 디예 나왇꼬	그러면 인제 탈곡기는 뒤에 나왔고
요즈미야 완전 기게지만 말고 요즘 말고	요즘에야 완전 기계지만 말고 요즘 말고
예예예 긍께 저네	예예예 그러니까 전에
탈고끼 그 아페 써리홀태가 이써쓸끼고	탈곡기 그 전에 그네가 있었을 것이고
그 두 가지	예 그 두 가지
그 담 써리홀 써리홀태 이저네는 머 다릉건 업써씀니까	그 다음에 그네 그네 이전에는 뭐 다른 건 없었습니까
그 써레홀태 그기고	그 그네 그것이고
그거또 저네 우리지베 이써꼬	그것도 전에 우리 집에 있었고
언자 차나락거틍거 그그 쪼까니언자 여페 숭거노머	이제 찰벼 같은 거 그거조금 인제 옆에 심어 놓으면
세낀다고 그 타작허는디	섞인다고 그 타작하는 데
그 세낀다고 따로언자 베다가	그 섞인다고 따로 인제 베다가
세낀다고가 머하능김니꺼	세낀다가 뭐하는 겁니까
그슥 보태진다고	그슥 보태진다고
메나락허고 차나락허고 보태진다고	메벼하고 찰벼하고 보태진다고
그기 머하 그기 우찌데능기 세낀다고 함니꺼	그것이 뭐하 그게 어떻게 되는것 세낀다고 합니까
보태지먼 안뎅께로 그 찹싸리 메싸리 메싸리 찹싸리 세끼먼 찰바비 안 찰징께	보태지면 안 되니까 그 찹쌀이 멥쌀이 멥쌀이 찹쌀과 섞이면 찰밥이 찰지지 않으니까
안 찰깅께인자	안 차지니까 인제
이 따로 시머가 포가 나그로 시머가꼬	이 따로 심어 가지고 표가 나도록 심어가지고
이 꼬쟁키나 꼬자 노코 논빼미다가	이 꼬챙이나 꽂아 두고 논배미에다가
따로 요리 시머노코언잗 이그먼 베다가 몰랴가꼬	따로 요리 심어 놓고 인제익으면 베다가 말려 가지고
언자 훌터요 써리훌태에 후틍가 머 마는 사라믄 또 그 기게예 얼릉 그거버텅 아페 훌터노코	인제 훑어요 그네에 훑든가 뭐 많은 사람은 또 그 기계에 얼는 그것부터 앞에 훓어 놓고
또 맨나라글 디에 훌꼬 막 그래써요	또 메벼를 뒤에 훑고 막 그랬어요
그래도 세키	그렇게 해도 섞여
그 그거 옌나레 어떤 동네가머는 써리홀태 나오기 저네	그 그거 옛날에 어떤동네에 가면 그네 나오기 전에
요게	여기에
머이꼬 써리홀태가	뭘까 그네가
그 대나무 요렁거 두 개 가꼬	그 대나무 요런 것 두 개 가지고
요게 나락 하나 여가꼬 쏙 홀때니 요렁거 손홀태도 이써꺼등녜	여기에다 벼하나를 넣어 가지고 쏙 훑는 요런 거 벼훑이도 있었거든요
아아	아아
손홀태하모 요리 즈즈	벼훑이 아무렴 요리 저 저
대로가꼬 두개	대를 가지고 두 개
두개르 가꼬 요리 아이고 얼매나 더디다고	두 개를 갖고 이렇게 아이고 얼마나 더디다고
그거또 보셔씀디꺼	그것도 보셨었습니까
바찌요	봤지요
해 보셔씀디까	해 보셨었습니까
그거는언자 써리홀태가꼬 훌꼬해도언자 보기는 바찌	그것은 이제 그네를 가지고 훑고 해도 인제 보기는 봤지
보기는 봗찌	보기는 봤지
그렁거또 함니더 슨생니미 더 잘 아는디머	그런 것도 합니다 선생님이 더 잘아는데 뭐
그러니까 요래 생깅거 마씀니까	그러니까 이렇게 생긴 것 맞습니까
예예예예	예예 예
그래 요거는언자 써리홀태지예	그래 이것은 인제 그네지요
금 요고 직쩝 안해보싣따 해도	그럼 이것을 직접 안 해보셨다고 해도
요렁거 가지고 머 예기드른 거라든지 보신거라든지 고 손홀태에 대해서 아시메는 말씀 좀 해 주이소	이런 것을 가지고 뭐 얘기 들은 것이라든지 보신 것이라든지그 벼훑이에 대해서 아시면 말씀 좀 해 주십시오
고 보기만 바찌 으으 손홀태	그것을 보기만 봤지 응 벼훑이
머 말씀허끼 인능가요 말허끼 머인능가요 내낟	뭐 말할 것이 있나요 말할 것이 뭐 있는가요 내나
그 어떤 사람드른 즈리 즈글가꼬 하모 이리이리 할매드리 막 훌터싸테 나라글	그 어떤 사람들은 저리 저걸 갖고 아무렴 이리이리 할머니들이 막 훑어 쌓대 벼를
그는 얼매나 더딩가요 저거는 드러가도 안허고 똑 한 모가지쓱 해야데는디	그거는 얼마나 더딘가요 저거는 들어 가지도 않고 꼭 한 모가지씩 해야 되는데
모감지 똑 항개를 가꼬 요리요리 노락찔매이로	이삭 꼭 한 개를 가지고 요렇게요렇게 장난처럼
그 모감지 하나씩 해야데지예	그 이삭 하나씩 해야 되지요
예예	예 예
써리홀태는 이리 한주먹 자꼬 요리 허지마는	그네는 이리 한 주먹 잡고 요리하지마는
잘 알게씀니더	예 잘 알겠습니다
저넫 써리홀태는 저네 하모 우리도이써찌	전에 그네는 전에 아무렴 우리도 있었지
이썬는데 지그믄 고만	있었는데 지금은 그냥
니가 빌리가가가 가따주고 안허고	누가 빌려가서 갖다 주지도 않고
언자 이래가지고 그러먼자 옌나레는 요 손홀태도 이썩꼬 그 다으메 써리홀태이꼬 탈고끼	인제 이래 가지고 그러면 인제 옛날에는 이렇게 벼훑이도 있었고 그 다음에 그네도있고 탈곡기
그라문자 우째뜬 곡시글인자 나라글언자 터러씀니더이	그러면 인제 어쨌든 곡식을 인제 벼를 인제 털었습니다이
그래가꼬	그래 가지고
그람 터러가꼬 마다아 나뚤낌니꺼 아이지예	그럼 털어 가지고 마당에 놔 둘겁니까 아니지요
막 두진는 사암 두지예 해노코	막 뒤주 있는 사람 뒤주에 해 놓고
그렁께고거 운제 우째	그러니까 그거 언제 어찌
갈무리를 우찌하는지 그거 말씀 좀 해주이소	갈무리를 어떻게 하는지 그것을말씀 좀 해 주십시오
인자	인제
물 그걸인자 해서 나라글 어떠틍가네언자 매 몰랴야 데요	뭘 그걸 인제 해서벼를 어떻든 간에 인제 매 말려야 돼요
베치 나는 날	볕이 나는 날
이 마다아다 덕써글 페노코	이 마당에다 멍석을 펴 놓고
매매 몰랴가꼬	매 매 말려 가지고
언자 막 저네는 지플 또 어떤 사람드른 즈그 머이고 지플언자 지플 이리 날개를 영커가꼬 집 이능거 매이로	인제 막 전에는 짚을 또 어떤 사람들은 저게 뭐니짚을 인제 짚을 이리 이엉을 엮어 가지고 집 이는 것처럼
언자 요리 동그람허이 요리	인제 요리 동그랗게 요리
마당에다가언자 나 노코	마당에다가 인제 놔 놓고
마다아다 요리 빠빧허이언자 해노코 그따가언자 또	마당에다가 요리 빳빳하게인제 해 놓고 거기다가 인제 또
나라글 이 몰랴가꼬 그언자 비 안 마끄로 막 야무게 해가꼬언자	벼를 이렇게 말려 가지고 그 인제 비가 안 맞게 막 야무지게 해서 인제
그리해가꼬 또 나락두지라고	그리 해 가지고 또 벼 뒤주라고
나락두지라고 요리 또 해노코 똗	벼 뒤주라고 요리 또 해놓고 또
내가꼬 쪼껜쓱 해 무꼬	내 가지고 조금씩 해 먹고
그래가꼬	그래 가지고
그 날개만 가꼬 나락두지가 뎀니꺼 어데	그 이엉만가지고 쌀 뒤주가 됩니까 어디
그 즈 소게언자 그거 머 양처리나 멀 여가꼬언자 단다이	그 저기 속에 인  제 그 뭐 양철이나 뭘 넣어 가지고 인제 단단히
단다이 비가 안 막꺼로 해야지 이 비가 싹 오머 싹다 마즈먼 내비리야뎅께	단단히 비가 안 맞게 해야지 이 비가 싹 오면 싹 다 맞으면 내 버려야 되니까
그러믄 그거는언자 말하자몬 두지 아임니꺼 쌀 나락뚜지지예	그러면 그건 인제 말하자면 뒤주 아닙니까 쌀 벼 뒤주지요
싸 나락뚜지 나락뚜지	예 싸벼 뒤주 벼 뒤주
나락 나락뚜지는언자 마당에 할꺼 아임니꺼이	벼 벼 뒤주는 인제 마당에 할 것아닙니까
저네 마다아 마이 해찌요	예 전에 마당에 많이 했지요
그러머 마다할때 쪼금저네 말씀하싱것처럼	그러면 마당에 할 때 좀 전에 말씀하신 것처럼
양처를 가꼬	양철을 갖고
아네 시믈 세아나코	안에 심을 세워 놓고
그래 허고 예예	그리 하고 예예
가예는 머로 두른다꼬예	가에는 뭐를 두른다고요
날개로 가꼬	이엉을 가지고
날개로 가꼬	이엉을 가지고
두리는 사람도 익꼬 또 머 또 나락 이리 즈그 머이고	예 두르는 사람도있고 또 뭐 또 벼 이리 저것 뭐니
그 머이고 나무로가꼬 요런 나무로 가꼬 또 이리 막 짜가꼬언자	그 뭐니 나무를 가지고 요런 나무를 가지고 또 이리 막 짜 가지고 인제
짜가꼬 또 그리 두지를 맨드라노코 나락	짜서 또 그렇게 뒤주를 만들어서 쌀
그라몬 그는 나무 나무두짐니꺼	그러면 그건 나무 나무 뒤주입니까
나무두지	예 나무 뒤주
그람 양철을 하능거는 양철두짐니꺼 머꼬 이름이 멈니꺼	그러면 양철을 하는거는 양철 뒤주입니까 뭐지 이름이 뭡니까
웃음	웃음
그는마 나락뚜지 맨드런네 막 그러고 마 그래찌요 머 고마	그거는 뭐 쌀 뒤주만들었네 막 그러고 뭐 그랬지요 뭐 그냥
그렁께 나락뚜지를 만들모 양철가꼬도 만들고	그러니까 쌀 뒤주를 만들면 양철 갖고도 만들고
소게 소게다가언자 그리 여가꼬	속에 속에다가 인제 그리 넣어 가지고
우에랑 단다이 해야 그 비가 마지먼 안데니까	위랑 단단히 해야 그 비가 맞으면 안 되니까
크일나지 일련 농산데	큰일나지요 일 년 농산데
크닐나그렁께요	큰 일 나 그러니까요
큰닐나지 그러고마 우리드른 저네	큰 일 나지요 그리고 뭐 우리들은 전에
쭉따메다가 고만 줄주리 나락까마이로 고마 재노코	댓돌에다가 그냥 줄줄이벼 가마니를 그냥 재 놓고
또 비가 오모 고무 고무 그 그스글 가꼬	또 비가 오면 고무 고무 그슥을 갖고
비 안 마끄로 덕꼬	비가 안 맞게 덮고
막 그래가꼬도 묵꼬 머 그리저리 머 그리해찌요	막 그래 갖고도 먹고 뭐 그리저리 뭐 그리 했지요
지금 말씀하신거는인자 나락 타작해 가꼬 갈무리하능기고예	지금 말씀하신 거  는 인제 벼 타작해 가지고 갈무리하는 거고요
또 보리도 밀도 그래쓸꺼 아임니꺼	또 보리도 밀도 그랬을 거 아닙니까
그라먼자 보리타자글 우찌 해씀니꺼	그럼 인제 보리 타작을 어찌 했습니까
보리타작 도리깨로	보리 타작 도리깨로
도리깨로 남자드리 해찌요 이런 마다다가 이리	도리깨로 남자들이 했지요 이런 마당에다가 이리
저네는 마당이 이리 또 즈 세메니 세메늘 또 해가꼬	전에는 마당이 이리 또 저시멘 시멘트를 해 가지고
세멘 안 헌 지베는 막	시멘트 안 한 집에는 막
또 머 덕써글 멀 페고 가빠로 페고	또 뭐 멍석을 뭘 펴고 가빠를 펴고
그래가꼬언자 막 저네는 지금잉께 드레 막 모두 콩타자글허고	그래서 이제 막전에는 지금이니까 들에 막 모두 콩타작을 하고
으 허지 저네는 제주 즈즈 마당에 지고 와가꼬	어 하지 전에는 죄다 마당에지고 와 가지고
직찜 지비 마다아지고 와가꼬 콩타작허고	각자 집에 마당에 지고 와 가지고콩 타작하고
콩타작 해가꼬 저리 치우고 또 나락타작 허고	콩 타작 해 가지고 저리 치우고또 벼 타작하고
그 우리 쪼은 마당이라도 지금 내 사는 친청찌비	그 우리 좁은 마당이라도 지금내가 사는 친정 집이
즈즈 쪼은 마당이라도 나랑 나라글	저저 좁은 마당이라도 벼 벼를
언자 남자드리 막언자 두 마지기를 지뜽가 머 서 마지기를 지뜽가	인제 남자들이 막 인제 두 마지기를 짓든지 뭐 세 마지기를 짓든지
지믄 나락 요만치쓱 망 뭉커가꼬 남자들 지고 와서 막 수북허이 재거등뇨 막우예	지으면 벼 이만큼씩 막 묶어 가지고 남자들이 지고 와서 막 수북하게 재거든요 막 위에
수북허이 나락따늘 재 재가꼬	수북하게 볏단을 재 재 가지고
그언자 기게 그기 오옹허는 그기 마당에 여 와가꼬	그거 인제 기계 그게 옹옹하는 그게 마당에 여기 와 가지고
그걸인자 뜨더서 이리 가따주고 막	그걸 인제 뜯어서 이리 갖다 주고 막
뜨더서 가따주고 아사주고 그래가꼬 타자글 안는가요	뜯어서 갖다 주고 앗아주고 그래 가지고 타작을 하지 않나요
그러믄자 고게 보리타작 아임니꺼이	그러면 인제 그게 보리 타작 아닙니까
보리타작도 그러고 나락타작도 그러 남자드리 노네서	보리 타작도 그러고 벼타작도 그러고 남자들이 논에서
베서 노네 논빠다게 몰랴가꼬	베서 논에 논바닥에 말려 가지고
요리 또 끄늘 가가서 뭉커가꼬	요리 또 끈을 가져 가서 묶어 가지고
뭉커가꼬언잗 나라글언잗 지게로 가꼬 질머지고 와요	묶어 가지고 인제 벼를 인제 지게를 가지고 짊어지고 와요
질머지고	짊어지고
질머지고 와가꼬	짊어지고 와 가지고
금언잗	그러면 인제
지베서 타 투드리고 막	집에서 탁 두드리고 막
다 해찌요	예 다 했지요
보리타자근 머 머로 뚜드림니꺼	보리 타작은 뭐 뭐로 두드립니까
보리타작 즈즈 마다아 페노코 나짜거이 페노코 졸조러이 이가 마꼬로	보리타작 저저 마당에 펴 놓고 납작하게 펴 놓고 졸졸하게 이가 맞도록
요리 대가리만 대가리만 모감지를 보리를	요리 대가리만 대가리만 이삭을 보리를
보리를 요거또 요거또 보리 저거또 보리언자 모감지만 요리 졸조리 대가꼬	보리를 요것도 요것도 보리 저것도 보리 인제 모가지만 요리 졸졸히 대 가지고
그스글 가꼬 그거 기게록	그슥을 갖고 그거 기계로
그 머이고 도리깨 도리깨로 가 뚜디리지요 남자드리	그 뭣이냐 도리깨 도리깨를 갖고 두드리지요 남자들이
그인자 보리타자근 도리깨가 할꺼 아임니꺼	그 인제 보리 타작은 도리깨로 할거 아닙니까
그러몬 밀타작도 도리깨가 함니꺼	그러면 밀 타작도 도리깨 가지고 합니까
밀타작또 도리깨로 허지요 바짝 몰랴가꼬	밀 타작도 도리깨로 하지요 바짝 말려 가지고
보리나 나락 즈 미리나 가트니까	보리나 쌀 저 밀이나 같으니까
고거는언자 나라근 가시레 할끼고	그거는 인제 쌀은 가을에 할 거고
보리하고 미른 여르메 할꺼 아임니까	보리하고 밀은 여름에 할 것 아닙니까
보리허고 밀허고	보리하고 밀하고
그러치예	그렇지요 음
그러먼자 아까는자 나락또 타작해가주고 두지 만드러가꼬 그 하드끼로	그러면인제 아까는 인제 쌀도 타작해 가지고 뒤주 만들어 가지고 그거 하듯이
그라먼자 보리나 밀도 또 갈무리해야 델꺼 아임니꺼 그는 우찌함니까	그 인제보리나 밀도 또 갈무리해야 될 거 아닙니까 그것은 어떻게 합니까
갈무리를 언자 타자근 해씀니다이	갈무리를 인제 타작은 했습니다이
타 보리 나라 보리 밀	타 보리 쌀 보리 밀
고렁께 미른 머 저네 마니 안해찌 즈즏	그러니까 밀은 뭐 전에 많이 안 했지저 저
지금잉께 마니 해가꼬 막 즈 매상을 허고 허니께 그러지마는	지금이니까 많이해 가지고 막 저 매상을 하고 하니까 그러지마는
미른 미른 즈즈즏	밀은 밀은 저 저 저
그 밀타자근 허먼 뚜디리머 막 까불라가꼬 조케 까불라가꼬 티 엄씨	그 밀 타작은 하면 두드리면 막 까불러 가지고 좋게 까불러 가지고 티 없이
새메 가서 막 사람마둥 집집마둥 미를 해가꼬	우물에 가서 막 사람마다 집집마다 밀을 해 가지고
막 사구예다 씨쳐가꼬언자 카카리 씨꺼가꼬언자 자기 무끼라농께	막 사구에다 씻어 가지고 인제 깨끗이 씻어 가지고 인제 자기 먹을 것이라 놓으니까
그래가꼬언자 방아까네가 찌와요	그래 가지고 인제 방앗간에 가 찧어 와요
가리를 해 밀까리를	가루를 만들어 밀가루를
그래가꼬 해무꼬 사라써요	그래 가지고 해 먹고 살았어요
근데 보리는자	그런데 보리는 인제
보리는 찌가꼬 도구통에	보리는 찧어서 절구통에
말고예 그거는 찌가꼬 뭉능기고	말고요 그것은 찧어서 먹는 것이고
그 보리를 또 일딴 보가늘 쫌 해야델꺼 아임니꺼	그 보리를 또 일단 보관을좀 해야 될 것 아닙니까
그그 망 가마니예 해가꼬 직가마니예	그것 막 가마니에 해 가지고 짚 가마니에
집가마이 저네는 집가마이 망넙쩍허니 막 이써꺼등뇨	짚 가마니 전에는 짚가마니 막 넙적하게 막 있었거든요
그따 다마가꼬 지그믄 참 머 조은 세상이지마는	거기다 담아 가지고 지금은 참뭐 좋은 세상이지마는
가마니에 해가꼬 비 안 맞는기다언자 막 재놓능기지 재놓고언자 매매 몰랴가꼬	가마니에 해 가지고 비 안 맞는 거다 인제 막 재 놓는 거지 재 놓고 인제 매 매 말려 가지고
그래가꼬언자 일련내 또 무꼬	그래 가지고 인제 일 년 내 또 먹고
그러믄자 그 나락또 타작해가꼬 갈무리가 덱꼬	그러면 인제 그 쌀도 타작 해가지고 갈무리가 됐고
보리 밀 데꼬	보리 밀 됐고
언자 콩하고 폳하고	인제 콩하고 팥하고
고롱거느	그런 거느
이거또 우째 타자글 하고 우째 갈무리를 핸는지	이것도 어찌 타작을 하고 어찌 갈무리를 했는지
그거또요 내나 베다가	그것도요 내나 베다가
이그머 매매 바테서 이그머	익으면 매 매 밭에서 익으면
베다가 고마 베치 조으먼 타악 마 하리나 몰랴가꼬 이트나 몰랴가꼬	베다가그냥 볕이 좋으면 탁 뭐 하루나 말려 가지고 이틀이나 말려 가지고
마 투드림 도로깨로 뚜디든가 소느로 뚜디든가 허면 잘 뚜디러저요	뭐 두드리면도리깨로 두드리든지 손으로 두드리든지 하면 잘 두드려져요
틱틱 까져 막 콩이 콩나치	틱틱 까져 막 콩이 콩낱이
그러믄 베테 베짝 몰랴가꼬언자 그거또	그러면 볕에 바짝 말려 가지고 인제 그것도
몰랴가꼬 막 자리예도 다마서 노코 막 말려 가지고 막 자루에도 담아 놓고 막  저네 양철똥우요 물리고 데이능거 막 그런디도인자 다마노코	
저네 양철똥우요 물리고 데이능거 막 그런디도인자 다마노코	전에 양철동이요기 물 이고 다니는 거 막 그런 데도 인제 담아 놓고
어떠틍가네 매 몰랴야데요	어떻든 간에 매 말려야 돼요
안 몰랴노머 마 썩꼬 막 허니까로	안 말려 놓으면 뭐 썩고 뭐 그러니까
베치 나모 막 언제라도 메뻐이라도 몰류지 할매드리	볕이 나면 막 언제라도몇 번이라도 말리지 할머니들이
몰랴가꼬 간수를 해가꼬언자 해무꼬	말려 가지고 간수를 해 가지고 인제 해 먹고
마 그래찌요 직쩌므로언자	뭐 그랬지요 각자 인제
직쩜 농사지가꼬마 자기들 무꼬 사릉기지머	각자 농사 지어 가지고 뭐 자기들먹고 사는 거지 뭐
지그믄 막 머 도늘 사뭉는다고 막 허고 허지마는	지금은 막 뭐 돈을 사 먹는다고 막 하고 하지만
저네는 돈 살 떼도 억꼬	전에는 돈 벌 데도 없고
그걸 가 묵꼬 사라씽께	그걸 가지고 먹고 살았으니까
돈 살 때 업따라는거는 팔로 간단 마림니꺼	돈 살 데 없다라는 것은 팔러 간단말입니까
예예	예예 예
저네는 하동장에 폴로 하동자아 또 새보게 이러나가꼬	전에는 하동장에 팔러하동장에 또 새벽에 일어나 가지고
그 먼 하동장에 지금 차로 강께로 가죽지	그 먼 하동장에 지금 차로 가니까 가깝지
저 날 샘스로 날 샘스로 장에 함본 갈라먼	저 날 새면서 날 새면서 장에 한 번가려면
막 싸리나 머 보싸리나 머 막 콩이나 머 이고	막 쌀이나 뭐 보리쌀이나 뭐 막콩이나 뭐 이고
이고 그래가꼬 즈 하동장에 즘두룩 가따가	이고 그래 가지고 저기 하동장에저물도록 갔다가
거러가따 거러오믄 또 어덥해야 지베 드러오고 거러가따 거러오니까	걸어 갔다가 걸어 오면 또 어두워야 집에 들어오고 걸어갔다 걸어오니까
저네는 장에도 그리 뎅기쓰요	전에는 장에도 그렇게 다녔어요
저네는 차도 업꼬 마니 엉꼬	전에는 차도 없고 많이 없고
긍게 또 구루마	그러니까 또 수레
구루마 그기언자 오일마네 장에 하몬쓱 가모	수레 그게 인제 오일 만에 장에 한번씩 가면
그게언자 지믈 실꼬 또 넘 따라 가고	거기에 인제 짐을 싣고 또 남을 따라 가고
그리 사라써요 참 저네 세상은 참말로	그렇게 살았어요 참 전에 세상은 참말로
어찌 그리 일만 망코 에러벤능고	어찌 그렇게 일만 많고 어려웠는지
그러모 할머이 지금까지는언자 나락 보리 밀 콩 요런거인자 타자케가꼬갈무리하는 그거여씀니다인자	예 그러면 할머니 지금까지는 인제 벼 보리 밀 콩이런 것을 인제 타작해서 갈무리하는 그것이었습니다 인제
예예	예 예
쪼꼼 쉬싣따가 또 나중에 다른 기회예 또 다른 걸 쫌 여쭤보게씀니다	조금 쉬셨다가 또 나중에 다른 기회에 또 다른 걸 좀 여쭤보겠습니다
고맙슴니다	예 고맙습니다
할머이 저 옌나레에	할머니 저 옛날에
이 동네에서 미영 키앋찌예	이 동네에서 목화 키웠지요
미영	예 목화
미영은 운제 오디에 숭굼니까	목화는 언제 어디에 심습니까
바테요	밭에요
언제쯤 숭굼니꺼	언제쯤 심습니까
언제쯤 보리 베내고	언제쯤 보리 베어 내고
사워리가 보리비내고 즈즏	사월인가 보리 베어 내고 저 저
보리르 즈즈 사워레베냐 하모 사월오워레	보리를 저저 사월에 베냐 아무렴 사월 오월에
사월오워레 베므 보리베믄 그 미영을 막	사월 오월에 베면 보리 베면 그 목화를막
고를 내가꼬 고를 내가꼬막 미영씨를 흐쳐가꼬 그름흑꼬	고랑을 내 가지고 고랑을 내 가지고 막 목화씨를 흩어 가지고 거름 흩고
그래가꼬언잗 허머 나머언자 풀매주모고마 지가커가꼬 인자 열매열고	그래 가지고 인제 하면 나면 인제 풀 매 주면 그냥 제가 커 가지고 인제 열매 열고
아예	아 예
그 열매를 머라캗씸니까	그 열매를 뭐라고 했습니까
다래요	다래요
다래	목화다래
다래 그	목화다래 그
열매	열매
쪼깨날때는 그따가묵꼬 이랟찌예	조그만 할 때는 그거 따 가지고 먹고 그랬지요
쪼깬헐때 여 쪼깬헐때는저저 따무믄달차허그든	조그만 할 때 여 조그마할 때는 저저 따 먹으면 달거든
따묵꼬	따 먹고
그다따무뿌모 난주게	그 다 따 먹으면 나중에
미영도 몬따지요	목화도 못 따지요
그건 머 따뭉능가요 배끼 항개 따무보고고마 반맴서로근능기지	그건 뭐 따 먹는가요 공연히 한 개 따 먹어 보고 그냥 밭 매면서 그러는 거지
그라먼자 고거 다 이그몬 아네서 하야이 터질꺼아임니까	그러면 인제 그거다 익으면 안에서 하얗게 터질 거 아닙니까
고고 고고 쫌 말씀해주이소	고것 고것 좀 말씀 좀 해 주십시오
언자 커기언자 다래 그걸언자나뚜먼	인제 크게 다래 그걸 인제 놔 두면
잔잔허이언자 여러가꼬	자잘하게 인제 열어 가지고
다 언자 다래그기막크기대므언자 크기 감재마느이 대므언자	다 인제 다래그게 막 크게 되면 인제 크게 감자만하게 되면 인제
나두믄 지가언잗 할짝피지요	놔 두면 제가 인제 활짝 피지요
그걷또 필때대므언자	그것도 필 때 되면 인제
피머언자 막 미영이 허허니 인자 막 또	피면 인제 막 목화가 허옇게 인제 막또
그 꼬타리가 탁탁 쪼개짐서르 막 미영이 허허이 피거등뇨	그 꼬투리가 탁탁 쪼개지면서 막 목화가 하얗게 피거든요
피머언자 막 머이걷저걷 일허다가	피면 인제 막 뭐 이것 저것 일하다가
미영이 핃떠라 미영따러가자 막 허그드	목화가 피었더라 목화 따러 가자막 하거든
그래가꼬언자 막 소쿠리가꼬 가서 미영 따고	그래 가지고 인제 막 소쿠리 가지고 가서 목화 따고
그 이긍건마언자 핑거마언자 허허이 핑거마언자 따지요 만날	거 익은 것만인제 핀 것만 인제 허옇게 핀 것만 따지요 만날
허허이 피능거 그건만 따가꼬오능기라	허옇게 피었는 것 그것만 따 가지고 오는 거야
따가꼬와서언자 또 그 머이고 껍뜩 그 까내비리고	따 가지고 와서 또 그 뭐니껍질 그 까 내버리고
꼬타리 그건만언자 미영꼬타리 근 네 넫 쪼가리거등뇨 그걷또 넫쪼가리	꼬투리 그것만 인제 미영 꼬투리 그거 네 네 쪼가리거든요 그것도 네 쪼가리
그래가꼬 까가꼬 허허이 피머언자 까가꼬 몰랴가꼬	그래 가지고 까 가지고 허옇게 피면 인제 까 가지고 말려 가지고
즈 방앋까네 거서게 기게에가서언잗 즈즈즈 미영타는디가 읻꺼등뇨 기게가	저기 방앗간에 거기에 기계에 가서 인제 저 저 저 목화솜 타는 데가 있거든요 기계가
그걸 가가머언자막 몰랴가꼬 가가머언잗	그걸 가져 가면 인제 막 말려 가지고 가져 가면 인제
씨 그거 기게예 나오고 그글 피야조요	씨 그것 기계에 나오고 그걸 피워 줘요
그래가꼬언자 와가꼬언자	그래 가지고 인제 와 가지고 인제
그리 그래해가꼬 막 인자 머멈 베를인자 막 맨들고 머 허능기지	그걸 그리 해가지고 막 인제 뭐뭐 베를 인제 막 만들고 뭐 하는 거지
그럼아까 미영타는 기게가 읻따 그랟찌예	그럼 아까 미영타는 기게가 있다고 그랬지요
기게가 저 하믄 고마	기계가 저 하면 고마
고 기게는 운제드러옹김니까	그 기계는 언제 들어온 겁니까
요새기겜니꺼 옌날부터이씅김니까	요새 기곕니까 엣날부터 있었던 겁니까
저네언자 그른 미영타는기게가 이떼요	전에 인제 그래 목화솜타는 기계가 있데요
그응게 여 이동네가 인능게아이고 저 너무동네꺼지 먼디꺼지 막 가야대요	그러니까 여기 이 동네에 있는 게 아니고 저 남의 동네까지 먼 데까지 막 가야 돼요
그게 옌나레 기게업쓸때는 우짿씀니꺼	그게 옛날에 기게 없을 때는 어떻게 했습니까
기게 머 고 고골로가꼬언잗 해가꼬 핻찌 저네 우리 알기느	기계 뭐 그 그걸로가지고 인제 해 가지고 했지 전에 우리 알기는
금 할머이는	아 그러면 할머니는
저 기게가 나와서 그타는 그때부터 기억하신다 그말씀임니까	저 기계가 나와서그 타는 그때부터 기억하신다 그 말씀입니까
예예예	예예
그람그 타가오면 금 허영기나올꺼아임니꺼이	그럼 그 타서 오면 그럼 허연게 나올 것 아닙니까
허영거만 가져올꺼아임니까	허연 것만 가져올 것 아닙니까
허허이인자피아가꼬막 가오능기라요	허옇게 인제 피어가지고 가져 오는 거예요
그기게예 가서 해아꼬모	그 기계에 가서 해 가지고 오면
그럼 지베와서 그머이고 제주 똗	그럼 집에 와서 그 뭐니 죄다 또
막 수북허이 수북허이 보따리 함보따리썩마 여그 해노코	막 수북하게 수북하게 보따리 한 보따리씩 막 여기 해 놓고
이제저녕내그즈즏 요리 태구끼매이로	이제 저녁 내 저 저 요리 태극기처럼
즈 작때기가 읻꺼능뇨 그 그그이 요리요리모라 이쩌깬쓱이거 타옹걸	저 작대기가 있거든요 그 그거 요리요리 말아 이 조금씩 이거 타 온 걸
그거 기게에 가서막 미영꼬타리가가서 씨 빼고	그거 기계에 가서 막 목화 꼬투리 가져 가서 씨 빼고
그 허허이 막 이즈즏 이부레 이 솜매이로 그래가 주구등뇨	그 허 허옇게 막이 저저 이불에 이 솜처럼 그래 가지고 주거든요
이부레 솜노특끼 허허이 해주모 보들보드리이 막 해주먼	이불에 솜 넣듯이 허허옇게 해 주면 보들보들하게 막 해 주면
가 와서 수북허이 해노코 마	가지고 와서 수북하게 해 놓고 마
여 오세막 온즌시네 다엥기고 그기	여기 옷에 막 온 전신에 다 엉기고 그게
그래가꼬언자 쪼깬씩 저 이리납짝허이 딱딱 가다기 이써요 그걷또	그래가지고 조금씩 저 이리 납작하게 딱딱 가닥이 있어요 그것도
그래가꼬 가닥가닥인자 쪼깬쓱떼가꼬	그래 가지고 가닥가닥 인제 조금씩 떼어가지고
이리 모능기 이써요 또 요리 모랃써 제주 저녕내 또 타가꼬 오모	이리 마는게 있어요 또 요리 말았어 죄다 저녁 내 또 타 가지고 오면
기게 타오모 요리 수북허이 재노코	기계 타 오면 요리 수북하게 재어 놓고
보따다 재노코언자 이고와가꼬	보따리에다 재어 놓고 인제 이고 와 가지고
인자요리요리 모능기 이써요 저네 요리요리요리리리 모라	인제 요리 요리 마는게 있어요 전에 요리 요리 요리 말아
모라각꼬인잡	말아 가지고 인제
그걸 고치래 고치	그걸 고치라고 해 고치
고치 이르미 고치라고	고치 이름이 고치라고
그라가꼬언자막 간종간종허이 또요리막 깡허리에다 질쭉허이 해가꼬	그래가지고 인제 막 간종간종하게 또 요리 막 광주리에다 길쭉하게 해 가지고
그래가꼬언자 그걸 실로내요	그래 가지고 인제 그걸 실로 내요
그걸 요래소느로 제주 거 비비가꼬	그걸 요리 손으로 죄다 거 비벼 가지고
떡꾹까리매이로마리잠 그리 비비가꼬	가래떡처럼 말하자면 그리 비벼 가지고
질쭈거니 해노코	길쭉하게 해 놓고
언자그걸가꼬 여 물레예다가	인제 그걸 가지고 여기 물레에다가
물레에다가언자 시를 내요 또 요리 자사가꼬	물레에다가 인제 실을 내요 또요리 자아 가지고
여여즈 쐬로가꼬 거 즈즏	여기여기 저 쇠룰 가지고 거 저저
물레에다가 그 쐬그으 거르노코 그머이고	물레에다가 그 쇠 그거 걸어 넣고 그뭐니
그 이리미 머이고이	그 이름이 뭐니
인자 싹따 질싸믈아낭께 그걷또다이읻삗따	인제 싹 다 길쌈을 안 하니까 그것도 다 잊어버렸다
씨아	씨아
즈즈즈증 머시곧	저 저 저 저 뭐니
쐬로가꼬 질쭈허이 그렁걷또 다포라노꼬	쇠를 가지고 길쭉하게 그런 것도 다팔아 놓고
자새	얼레
자새는언자 따로언자 또 머 자새는 인능기고	얼레는 인제 따로 인제 또 뭐 얼레는 있는 거고
그 물레예	그 물레에
무물레예 마리자모 요리요리요리 저스모	물레에 말하자면 요리요리요리 저으면
이 여 요렁걸 요리 그스글 낀는데 그이르믈 모리겓따이	이 여기 요런 걸 요리거석을 끼었는데 그 이름을 모르겠다
끼가꼬 그걷 고치그걸 지주 실로 내요	끼어 가지고 그거 고치 그걸 죄다 실로내요
시를 요리 자사가꼬 내야대 요리	실을 요리 자아 가지고 내야 돼 요리
지주 내가꼬 질쌈해꺼등	죄다 내 가지고 길쌈했거든
그래가꼬언자 그걸가꼬언자 막 베를 맨들고 막 그랙꺼등뇨	그래 가지고 인제 그걸 가지고 인제 막 베를 만들고 막 그랬거든요
그랜는디	그랬든데
그이 머이니라 일마네 도는마느	그것이 뭐더라 입 안에 돌거마는
나중또생각나시믄 그 이름말쓰매 주시고	나중에 또 생각나시면 그 이름 말씀해주시고
네네	아 네 네
그라믄언자	그러면 인제
내일 어른 거시기한테 무러야겓꾸먼 모리머	내일어른 그슥한테 물어야겠구만 모르면
사람한테 무러가 와야게꾼	사람한테 물어서 와야겠군
그러믄	그러면
어째뜬언자 기게 가서	어쨌든 인제 기계에 가서
으음	음
씨 빼고	씨 빼고
그러니까	그러니까
미영씨	목화 씨
태아태아 오능거다 그지예	타서 타서 오는 것이다 그죠
예옏	예 예
태아	타서
씨빼고예	씨 빼고요
예예	예 예
태아오가지고 그라모 푹신푹신할꺼 아임니꺼이	타 와 가지고 그러면 푹신푹신할거 아닙니까
그렁께	예 그러니까
고거를 갇따가 아까 머라그랟슴니꺼 곧	고것을 갖다가 아까 뭐라고 그랬습니까 그것
마 요리요리 막	막 요리요리 막
미능기	미는 것이
꼬치	고치
꼬치는	고치는
꼬치매이로	고치처럼
머가꼬치고치매이로	뭐가 고치고치처럼
고치매이로 저 떡꾹까리매이로	고치처럼 저 가래떡처럼
질쭉허니 요리 모라요 손빠다그로	길쭉하게 요리 말아요 손바닥으로
그람 고치랑거는멈니까 미러너야 떡꾹가리	그럼 고치라는 거는 뭡니까 밀어놔야 가래떡
그거 염방 그거	그거 연방 그것
거서 미영타옹거	거슥 미영 타온 거
그걸 언자 모라농께로 고치라그러거든	그걸 인제 말아 놓으니까 고치라 그러거든
이리	이리
모라노응기 고침니꺼	말아 놓은 게 고칩니까
아아	아 아
첨 퍽 퍼진 그기 고치가 아이고	처음 퍽 퍼진 게 그게 고치가 아니고
하모하모	아무렴 아무렴
그거는언자 쪼깨쓱	그거는 인제 조금씩
언잗 기게예서 해와꼬	인제 기계에서 해 왔고
해 왇씅께언자 쪼깬쓱언자 가닥가닥	해 왔으니까 인제 조금씩 인제 가닥가닥
떼가꼬	떼 가지고
띠가꼬잉	떼 가지고
요따가언자 막 반반헌 판때기나 이래 해노코	여기다 인제 막 반반한 판때기나이렇게 해 놓고
꼬쟁키가 이 머 그때막이리 까까가꼬	꼬챙이가 이 뭐 그때 막 이리 깎아 가지고
즈즏 이써요 그렁 작때기가	저 저 있어요 그런 작대기가
모는 고치모는 작때이가	마는 고치 마는 작대기가
그래가꼬 지주 그걸 수북허이 해옹걸 그걸	그래 가지고 죄다 그걸 수북하게해 온 걸 그걸
소느로 난나치 지베오몬 모라야 덴당께	손으로 낱낱이 집에 오면 말아야 된다니까
그람 요기언자 짝때김니다이	그럼 요기 인제 작대깁니다이
요래하믄 요 짝때이	요래 하면 요 작대기
도로로로 도라가면서	도르르르 돌아가면서
하모 요래요래요래요래 비비요	아무렴 요리요리요리요리요리 비벼요
예예	예 예
요 주 가에로 자꾸밀릴꺼 아임니꺼이	요 주 가장자리로 자꾸 밀릴 거 아닙니까
그마리지예	그 말이지요
질쭉 질쭉허니요리 모라가꼬	길쭉 길쭉하게 요리 말아 가지고
언자 소쿠리에다 맏 착착 떡꾹까리매이로 막 조키 간조로이 나야데	인제 소쿠리에다 막 착착 가래떡처럼 막 좋게 간조롬히 놓아야 돼
그라믄해가 요거는언자 빼야댄다 그지	그러면 해서 요거는 인제 빼야 된다 그죠
빼고 그람 아네 요쪽 구머이 똥끄랑이	빼고 그럼 안에 요쪽 구멍이 동그랗게
예예 읻써	예있어
하모 읻찌	아무렴 있지
그래 그이 고치라능기라언자 고치	그래 그게 고치라는 거야 인제 고치
이리미	이름이
고치는 그기 고침니꺼	고치는 그게 고칩니까
이리미 이리미 고치 고치모자 막 그러고그러거등	이름이 이름이 고치 고치말자 그러고 그러거든
고치 머하자고예	고치 뭐하자고요
모자고 언자그리 이리비비능거이 모능기라	말자고 인제 그리 이리 비비는 것이마는 거야
그래가꼬언잗	그래 가지고 인제
지주 그렁걸다 이처넌썩주고 저네	죄다 그런 걸 다 이천 원 씩 주고 전에
다 포라무뿓따 베논능그거	다 팔아 먹어버렸다 베 놓는 그것
그 고치아임니꺼이	그 고치 아닙니까
모랃찌요	말았지요
언자모라가지고	예 인제 말아 가지고
그람 모란거를 갇따가언자 또 이삼니꺼우짬니꺼	그럼 만 거를 갖다가 인제 또잇습니까 어쩝니까
몽걸갇따가 모라농걸갇따가 그렁께로	만 걸 갖다가 말아 놓은 걸 갖다가 그러니까
그 머이고 이 돌리능거 물레	그 뭐니 이 돌리는 거 물레
물레	물레
물레그거예다가 즈즏	물레 그것에다가 저저
쎄를그렁께 요리딱질쭉허이 똑 거러논는디 그거르 이리미생개기안나네	쇠를 그러니까 요리 딱 길쭉하게 똑 걸어 놓는 데 그거를 이름이생각이 안 나네
그걸가꼬언자 막 자꾸언자이리 돌리머 그 주리나와요	그걸 가지고 인제 막 자꾸 인제 이리 돌리면 그 줄이 나와요
주리 요요렁거언잗 쐬예다가 이리그스해노코	줄이 요런 거 인제 쇠에다가 이리 거슥해 놓고
주리이리 물레를돌리머 자꾸돌리머	줄이 이리 물레를 돌리면 자꾸 돌리면
돌리머 인자 주리 줄줄줄줄 나오고 요리 손 인는대로 요리 질기빼가꼬	돌리면인제 줄이 줄줄줄줄 나오고 요리 손 있는대로 요래 길게 빼 가지고
또 가락가락 가라기다 염방	또 가락 가락 가락이다 연방
모리능거 내 가락	모르는 것 나 가락
가락	가락
가락 그걸 질쭉허이해노코 막 이리 자꾸 요리 돌리서 요리	가락 그걸 길쭉하게 해 놓고 막 이리 자꾸 요리 돌려서 요리
요리요리요리해가꼬 막	요리요리요리 해 가지고 막
요리또걷따가 가가게다가허먼 막	요리 또 거기다가 가락에다가 하면 막
가래기또 불퉁허이 요리 실감능거매이로	가락이 또 불퉁하게 요리 실 감는 것처럼
이래되는기지예	이리 되는 거지요
예예예	예예
이래 가마가꼬	이렇게 감아 가지고
요리 가마가꼬 욛따가 요 올리 또 자꾸 요리요리요리	요리 감아 가지고 여기다가 요 올려 또 자꾸 요리 요리 요리
물레를 돌리므	물레를 돌리면
그 시리 그 가마야 데요 염방 가라게아가	그 실이 그 감아야 돼요 연방 가락에다가
가므모엄잗 가래기 또 크대머이 막 요리대그등 요리	감으면 인제 가락이 또커다랗게 막 요리 되거든 요리
대므언잗 어느정도대믄언잗자	대면 인제 어느 정도 되면 인제
그가라글 또 빼노코	그 가락을 또 빼 놓고
그 집 지 블 나락허는 나락 짐뇨	그 짚 짚을 벼하는 볏짚요
집 그걸언자	짚 그걸 인제
그 쌔 쌔예다 물레예다가 요리질쭉허니 꼬자논	그 쇠 쇠에다 물레에다가 요리길쭉하게 꽂아 놓은
인자언자 모디모디 요 댄모디매이로	인제 인제 마다마디 요 대마디처럼
조응건만 지푸래이그을 직그걸 요 나락지플	좋은 것만 지푸라기 그걸 짚 그걸 요 볏짚을
충징걸 진걸	충실한 것을 긴 것을
그걸저저저 모디예 모디마당 요리빼가꼬 그가라게다가 끼요	그걸 저저저 마디에 마디마다 요리 빼 가지고 그 가락에다가 꿰어요
쐬 가라게다가 물레 가라게다가	쇠 가락에다가 물레 가락에다가
끼 가꼬언자 이 주를 빼가꼬 그올리능기라 자꾸 요래올리	껴 가지고 인제 이 줄을 빼 가지고 그 올리는 거야 자꾸 요리 올려
물레가 물레가 저저읻떠마는 그리 그리 허 허더마는	물레가 물레가 저저 있더만은 그리 그리 하 하더만은
그래가꼬 그래가꼬언자 실로 자꾸 빼가꼬 일도 마나요	그래 가지고 그래 가지고 인제 실을 자꾸 빼 가지고 일도 많아요
그렁께 그 질 그 베를 놀라머	그러니까 그 길 그 베를 놓으려면
그래가꼬 지주 물레로가꼬 돌리가꼬 그시를 또빼능기라 싸악 빼능기라 시를	그래 가지고 죄다 물레를 가지고 돌려 가지고 그 실을 또 빼는거야 싹 빼는 거야실을
시를 그 빼가꼬 그리가라게 가라글 그렁께	실을 그 빼 가지고 그리 가락에 가락을 그러니까
막 마니가라글 또 해가맥깨를 대지 그 함보따리	막 많이 가락을 또 해서 몇개나 되지 그 한 보따리
타가꼬오먼 미영을	타서 가지고 오면 목화를
그래가꼬언잗	그래 가지고 인제
또 막 이리니리고	또 막 이렇게 내리고
그 주를 막	그 줄을 막
한니리고 그래가꼬이리 또 베내고 막	한 내리고 그래 가지고 이리 또 베 내고막
풀로미가꼬 그그막 그그 그리 난나치	풀을 먹여 가지고 그것 막 그그 그리 낱낱이
그 주를 그리 마니 빼가꼬	그 줄을 그리 많이 빼 가지고
또그거 즈즏 푸를 미이가꼬	또 그것 저저 풀을 먹여 가지고
할매드리 미테부를나노코 모닥뿔로나서언잗	할머니들이 밑에 불을 놔 놓고 모닥불을 놔서 인제
제를 따딷허이 해노코	재를 따뜻하게 해 놓고
따딷허이 해노코 풀그거 요리막 소느로막	따뜻하게 해 놓고 풀 그거 요리 막손으로 막
밀푸를 막 끼리가꼬 한상 끼리노코	밀풀을 막 끓여 가지고 한 상을 끓여 놓고
인자 이 베그걸 막	인제 이 베 그걸 막
자꾸 요리막 마니 쪼무락쪼무락해서 치를 허먼 빠빧허이대거등뇨	자꾸 요리막 많이 조물락 조물락 해서 칠을 하면 빳빳하게 되거든요
빠빧허이대므언자 그거 몰률라고	빳빳하게 되면 인제 그거 말리려고
그거몰률라고언잗 부를언잗	그거 말리려고 인제 불을 인제
피아가꼬 따딷허이 해가꼬 잳뿌를해노코 할매드리	피워 가지고 따뜻하게 해가지고 잿불을 해 놓고 할머니들이
베를언자 또 자꾸 매능기라요 요리	베를 인제 또 자꾸 매는 거예요 요리
매가꼬언잗 빠빧허이 그래가꼬언자 몰류고 막	매 가지고 인제 빳빳하게 그래가지고 인제 말리고 막
그 소를 가꼬 또 솔 아능가요 저네웨	그 솔을 가지고 또 솔 아는가요 전에왜
솔 그걸가꼬 막 이리 비끼고	솔 그걸 가지고 막 이리 벗기고
풀 미이가꼬 이리 딱딱 가닥가닥 떠러지라고	풀 먹여 가지고 이리 딱딱 가닥가닥 떨어지라고
철개비 댇씅께 푸리	칠갑이 되었으니까 풀이
긍께언잗 그리미이가꼬 베를 해가꼬언자	그러니까 인제 그리 먹여 가지고 베를해 가지고 인제
도투마리에다가이리 또요리 막마당에서 요리 돌리감서	도투마리에다가 이리 또요리 막 마당에서 요리 돌려 가면서
가마감서 요 모링거는 가마강꼬 또 요새로 또 요리허고	감아 가면서 요 만 것은감아 가지고 또 요 새로 또 요리 하고
그래가꼬 막 이트리고 사하리고 그리 막 그리 맨드라가꼬	그래 가지고 막 이틀이고 사흘이고 그리 막 그리 만들어 가지고
그래가꼬언자 베틀 차리가꼬 베 베를 언자 또 짜기시작허지	그래 가지고 인제베를 차려 가지고 베 베를 인제 또 짜기 시작하지
베틀로 매가꼬	베틀을 매 가지고
그래가꼬 머	그래 가지고 뭐
베짜고 북 부글가꼬 베 베짜고 머	베 짜고 북 북을 가지고 베 베 짜고 뭐
일도 참말로 마나 베 그	일도 참말로 많아 베 그
베틀 그거쫌 말씀해 주이소언자 베짜능거예	베틀 그거 좀 말씀해 주십시오 인제 베 짜는 거요
그렁께언자 구러케 매가꼬 베를	그러니까 인제 그렇게 매 가지고 베를
실로가꼬 베를 매가꼬 마당에서 그리 불로피아가꼬인자	실을 가지고 베를 매 가  지고 마당에 그것을 불을 피워 가지고 인제
따딷허이재뿌레해가꼬인자 풀인자 그 미기서	따뜻하게 잿불에 해 가지고 인제풀 인제 그 먹여서
베트레다가 그그 머이고	베틀에다가 그 그 뭐니
도투마리에다가 이리이리리리 가마가꼬 자꾸	도투마리에다가 이리 이리 이리 감아 가지고 자꾸
그래가꼬언자 마다아서 내창 그래가꼬 몰랴가꼬	그래 가지고 인제 마당에서내 참 그래 가지고 말려 가지고
언잗 베트레다가그 거를언자 언저가꼬	인제 베틀에다가 그것을 얹어 가지고
걷 마당에 역써언자 그	그거 마당에 서 인제 그
베그거 맨등거 그거를언자 엉꼬	베 그거 만든 거 그거를 인제 얹고
차리고 머 잉에 걸고 머머 허고 막	차리고 뭐 잉앗대에 걸고 뭐 뭐 하고 막
이리미 열뚜 열뚜가지나 데능가 모르걷따 베차리라머	이름이 열두 열두 가지나되는지 모르겠다 베 차리려면
그래가꼬 잉에 걸고 잉에막 요리 거러야 막	그래 가지고 잉앗대에 막 요리 걸어야 막
발로 이리 끄 댕기리고 이리 막	발을 이리 끌어 댕기고 이리 막
발꿈치르 또 끼고 막 열고	발꿈치를 또 끼고 막 열고
베짤람 차말로먿 정신을 약깐 써야지	베 짜려면 참말로 뭐 정신을 많이 써야지
베트레 부기라능게 이써찌예	베틀에 북이라는 게 있었지요
북 읻찌요	북 있지요
부글 요리여야 또 요리 짜고	북을 요리 넣어야 또 요리 짜고
아페 요리짜능그는 즈즏	앞에 요리 짜는 거는 저 저
여리 부근언자 질쭈허이 해가꼬 요리 연능기고	이리 북은 인제 길쭉하게 해가지고 요리 넣는 것이고
그 염방 뱀매가꼬	그 연방 베를 매어 가지고
그 또 머이고	그 또 뭐니
요리 땡기는 그거는또머이고 아이	요리 당기는 그거는 또 뭐니 아이
오래대농께 내 다이리빋따	오래 되어 놓으니까 내 다 잊어 버렸다
흐리에하능거는 부태라캗슴니까	허리에 하는 거는 부태라고 했습니까
부태 부태	부태 부태
그는 와 함니까	그것은 왜 합니까
그걸해야 베를 짜요 그거 해야	그걸 해야 베를 짜요 그거 해야
구걸해야 시미 읻쩨	그걸 해야 힘이 있지
여 허리 요리 해가꼬	여기 허리 요리 해 가지고
거 베 거 베틀허고 전시 영기리 덴능데	그 베 그거 베틀 하고 전부 연결이 되었는데
영기리 데고	연결이 되고
또 발꿈치로가꼬 막 발로	또 발꿈치를 가지고 막 발로
이리 밀고 이리 땡기고	이리 밀고 이리 당기고
땡김서 또 베 요리 짜고	당기면서 또 베 요리 짜고
그때그 시늘 머슨시니라라캗심니꺼 머 철기시니라캗씀니까 머	끄대 그 신을무슨 신이라고 했습니까 뭐 철기신이라고 했습니까 뭐
철거덩 머 머또 익꼬 막	철거덩 뭐 뭐 또 있고 막
잉에걸고 머 걸고	잉아 걸고 뭐 걸고
잉에걸 뻐뻗허이 막 요리막 잉에 요리막 또 노프게 거러노코	잉아 걸 뻣뻣하게막 요리 막 잉아에 요리 막 또 높게 걸어 놓고
그 이리머 항가지 두가지가 아이구마 베틀찰라머	그 일이 뭐 한 가지 두 가지가아니지 베틀 차리려면
그러믄 요새치믄 한시간쭘 짜믄 베를 얼마나 짬니꺼	그러면 요새 치면 한 시간쯤 짜면 베를 얼마나 짭니까
그그는뇨 그귿똗	그거는요 그것도
잘짜능 사라믄 막 즈즈 오리막 한재두재 막	잘 짜는 사람은 막 저 저 요리 막 한자 두 자 막
이리언자 잘짜는 사라믈	이리 인제 잘 짜는 사람을
우리 어매는 저그 만날인잗	우리 어머니는 저기 만날 인제
그사라믈 언자 먿 싸글 주고	그 사람을 인제 뭐 삯을 주고
싸글 주고언자 베 잘짜는 사람 읻써거등 이 동네	삯을 주고 인제 베 잘 짜는사람이 있었거든 이 동네
동네 베잘짜는 사라미 이써 그래가꼬	동네 베 잘 짜는 사람이 있어 그래 가지고
아드른 막 영 아드른 막 마니	아이들은 막 영 아이들은 막 많이
여러시 나가꼬 양서근 함껃또 업꼬 그사래미	여럿이 낳아 가지고 양식은 아무것도 없고 그 사람이
베는 잘짜고	베는 잘 짜고
그래 그사라믄언자 베째러오라고 오늘 해노믄	그래 그 사람은 인제 베 짜러 오라고 오늘 해 놓으면
베째러 오라해노모 우리지베와 베를짜는디	베 짜러 오라 해 놓으면 우리 집에 와베를 짜는데
저머이고 또식꾸가 아가 마나농께 영가믄 일치기 죽꼬	저 뭐니 식구가 아이가많아 놓으니까 영감은 일찍이 죽고
아가 마나농께	아이가 많아 놓으니까
바블마 보쌀로언자 구마 마니 끼리가꼬	밥을 뭐 보리쌀을 인제 그만 많이 끓여가지고
내가언자 끼리가꼬 막	내가 인제 끓여 가지고 막
바블 막 그저네 꺼멍소테다가 저네는 바블 해뭉께	밥을 막 그 전에 검은 솥에다가 전에는 밥을 해 먹으니까
보쌀 끼리가꼬	보리쌀 끓여 가지고
반지기를 해가꼬 반지기가 머이냐믄 쌀반 보리반	반지기를 해 가지고 반지기가무엇이냐면 쌀 반 보리 반
보쌀 끼리서 퍼노코	보리쌀 끓여서 퍼 놓고
인자 쌀 한바가치여코 그래가꼬 쌀반 보리반 그래가꼬	인제 쌀 한 바가지 같이  넣고 그래 가지고 쌀 반 보리 반 그래 가지고
반지기를 해가꼬	반지기를 해 가지고
바블 반지를 해가꼬 또바가 저네는 박가치에다가	밥을 반지기를 해 가지고 또바가 전에는 박바가지에다가
박가치에다가막 항껃 퍼서언자	박바가지에다가 막 한껏 퍼서 인제
바가치에다 바블 한솓 해가꼬	바가지에다 밥을 한 솥 해 가지고
우리밥 쫌 허고언자	우리 밥 좀 하고 인제
그사람 함바가치 퍼가꼬언자 아들 주라고 그사라믈 줘요 그아짐마를	그 사람한 바가지 퍼 가지고 인제 아이들 주라고 그 사람을 줘요 그 아줌마를
아짐마를 주모	아줌마를 주면
또 머머 짐치등가 머 반찬 좀 허고	또 뭐 뭐 김치든가 뭐 반찬 좀 하고
그래가 갇따주언잗	그래서 가져다 주 인제
갇따가언잗 정시미라고 주모인자	가져다가 인제 점심이라고 주면 인제
갇따 주고 또 차리주고오고	갖다 주고 또 차려 주고 오고
그래 또 저녀게 또그리하 해서 줘야데 바블	그래 또 저녁에 또 그리해 해서 줘야 돼 밥을
그지비 양시기음싱께	그 집이 양식이 없으니까
양시기음싱께로	양식이 없으니까는
아들 아느 망코	아이들 아이는 많고
그래가꼬 그 사라믄인잗	그래 가지고 그 사람은 인제
그리 이를허고 밥함바가치썩 어꼬 그래가꼬	그리 일을 하고 밥 한 바가지씩 얻고 그래 가지고
아들로 키우고 그랟써 그 아짐마는	아들을 키우고 그랬어 그 아줌마는
그사라믄 그리 베를 영 잘 짜거등	그 사람은 그리 베를 영 잘 짜거든
긍께 한시가니고 머이고 고마 하리짜모 고마	그러니까 한 시간이고 뭐고 그냥 하루 짜면 그냥
저저 도투마라고 막	저저 도투마리라고 막
이리막 수북허이 막 마니 베를 매서 가마노코	이리 막 수북하게 막 많이 베를 매서 감아 놓고
그걸막 싹따 비야내요 고마 잘짱께로 그 아짐마는	그걸 막 싹 다 비워 내요그냥 잘 짜니까는 그 아줌마는
그래가꼬 맏	그래 가지고 마
해대로고마 짜모 아적밥 무꼬딱	해대로 그냥 짜면 아침밥 먹고 딱
드러서모 안지믄 정심시가넨 딱 하먼 나오고	들어서면 앉으면 점심 시간엔 딱 한번 나오고
언자 뭐 그래가꼬 마	인자 뭐 그래 가지고 마
그 사라믄 마이 짜비리 고마 베를	그 사람은 많이 짜 버려 그냥 베를
짜서 막	짜서 막
그베투마리 그겁	그 베 도투마리 그거
벧 도투마리 도투마리 그걸고마 싹	베 도투마리 도투마리 그걸 고마 싹
비우 비야요 비야	비우 비워요 비워
항걷 가마논능걸	아주 많이 감아 놓은 걸
잘치 잘짜고	잘 치 잘 짜고
그러몬 그짜게	그러면 그쪽에
도투마리에 감깅기 베미까	도투마리에 감긴 게 벱니까
그 베가	그 베가
그베를 요리짜가꼬인자	그 베를 요리 짜 가지고 인제
짜모언자 여 아페기 베지	짜면 인제 여기 앞의 것이 베지
그러믄 도투마리리 비안다는거능	어 그러면 도투마리 비운다는 거는
도투 도투마리예 머가읻씀니꺼	도투 도투마리에 뭐가 있습니까
그거 인자그거 베짜능거	그거 인제 그거 베 짜는 거
우리 요리요리 풀 아까 미긷따능거	우리 요리 요리 풀 아까 먹였다는 거
그걸 지주 그거막	그걸 죄다 그거 막
요리 강꺼든뇨 도투마리에다가 가마가꼬 인자이리	요리 감거든요 도투마리에다가 감아 가지고 인제 이리
잉에걸고 먿 걸고언자 베를 언자	잉앗대에 걸고 무엇에 걸고 인제 베를 인제
짜느키 시작허그등뇨	짜 넣기 시작하거든요
그이 도투마리예	음 그러니까 도투마리에
걸려인능거는	걸려 있는 거는
베는 아이다 그지예	베는 아니다 그죠
그거느언잗	그거는 인제
이 시리 이시리네 그라모	이 실이 이 실이네 그러면
시르 하모 시리지	실을 암 실이지
시린디언자 이 부글 여가꼬 그사래미	실이데 인제이 북을 넣어 가지고 그 사람이
고마 차그닥차그닥차그닥 영 잘짜요	그냥 차그닥차그닥 영 잘 짜요
잘짱께로마 시무 시무잳 짣따허고 막	잘 짜니까 뭐 스무 스무 자 짰다고 하고막
요리 재가 또 요리	요리 자가 또 요리
요런 재가읻꺼등뇨 저네	요런 자가 있거든요 전에
거 나무재	그거 나무 자
나무재로 가꼬	나무 자를 가지고
인제 자근재 큰재 막 읻꺼든	인제 작은 자 큰 자 막 있거든
킁거쫌 요리 자긍거 킁거	큰 거 좀 요리 작은 거 큰 거
그래가꼬 막 큰재로막 시무대 시무재 짠네그러고	그래 가지고 막 큰 자로 막 스무 자 스무 자 짰네 그러고
열째 짠네허고 막	열 자 짰네 하고 막
거 그사라미 베를 영잘 딱 잘 짣꺼등	거 그 사람이 베를 영 잘 짰 잘 짰거든
열째 짣따 스무재 짣따카능건인제 지리를 말하지요	열 자 짰다 스무 자 짰다고하는 건 인제 길이를 말하지요
예예	예 예
그그이 색	그거 색
포근 딱 정해져이씀니꺼	폭은 딱 정해져 있습니까
포근 펭상 거 정해가 읻찌	폭은 통상 정해져 있지
얼마 댐니까 포기	얼마 됩니까 폭이
포기 요만해요 요만해	폭이 요만해요 요만해
요만하다메는	요만하다면은
요만해 마리자머	요 요만해 말하자면
요즘말로 한 삼씹쎈치대네예 그러니까 음	요즘 말로 한 삼십센티 되네요 그러니까 음
그릉께 고마 쭈욱 고마 그대로 쪼옥 가리 가틍께	그러니까 그냥 쭈욱 그냥 그대로 쪼옥 가로 같으니까
요렁게그냥쫘아악	요런 게 그냥 쫘악
요리여거	예 요리 여기
그리언자 스물개 댄다 그지예	그리 인제 스물 개 된다 그지요
여거 요리 또 허리 요리 차고	여기에 요리 또 허리 요리 차고
요리 홍둘깨라고 요리 베를 요리	요리 홍두깨라고 요리 베를 요리
짜믄 자꾸 요리 질쭉허이 분는다 아잉가요이	짜면 자꾸 요리 길쭉하게 붓잖아요이
거거거 거석 여가꼬	거거거 그슥 넣어 가지고
거 머이고 붕 녀가꼬	그 뭐니 북 넣어 가지고
부게 북그거서 시리 나오거등뇨	북에 북 거기서 실이 나오거든요
그러니까 도투마리에 걸린 시리 부글 통해서	그러니까 도투마리에 걸린 실이 북을 통해서
나아가지고 베가	나와 가지고 베가
예예 하모	예아무렴
귿 도투마리허고 여여여 붕 년는 실허고	거기 도투마리하고 여기 북 넣는 실하고
가치 요리 착착 짜야데거든	같이 요리 착착 짜야 되거든
하나는요래데고	하나는 요렇게 되고
예예	예 예
하나는 요래데야 댈꺼아임니꺼이	하나는 요렇게 되어야 될 거 아닙니까
예예	예 예
그래야 베가 델꺼 아임니꺼	그래야 베가 될 거 아닙니까
그렁께이자 쭈욱 요만해가꼬	그러니까 인제 쭈욱 요만해 가지고
쭈욱 요요 요매이로 반반허이 인자 베가 나오능기라요	쭈욱 요요 요처럼 반반한 인제 베가 나오는 거예요
그래가꼬언자 오슬 안해이번능가요	기래 가지고 인제 옷을 안 해 입었잖아요
그래가꼬 막	그래 가지고 막
그사라믄 시무재 짣따 머	그 사람은 스무 자 짰다 뭐
또 니는 열째 짣따 마 그러고	또 누구는 열 자 짰다 마 그러고
솜씨가 다 다링께 다 다링께	솜씨가 다 다르니까 다 다르니까
그러먼자 그 짜난베는 우째함니꺼	그러면 인제 그 짜 놓은 베는 어떻게 합니까
그냥지베서 오슬 해입끼도 하고	그냥 집에서 옷을 해 입기도 하고
팔기도 함니까	팔기도 합니까
함 마니 허는 사라믄 폴기도 허고	하모 많이 하는 사람은 팔기도 하고
식꾸 마는 사라믄 베가 이나 모지래지	식구 많은 사람은 베가 오히려 모자라지
거 한도투마리 짜도	거 한 도투마리 짜도
그래 그거 해가꼬언자	그래 그거 해 가지고 인제
그거 다짜머어자 그 푸링께로 막	그거 다 짜면 인제 그 풀이니까 막
막 무레 당가가꼬 방매가 뚜딜고 막 주무리고 보꼬 해가꼬	막 물에 담가 가지고방망이로 두드리고 막 주무르고 밟고 해 가지고
언자 막	인제 막
그래가꼬 또 오슬해 입찌	그래 가지고 또 옷을 해 입지
사 삼	사 삼
그 무레 여가꼬 보 마	그 물에 넣어 가지고 보 마
뚜디리고	두드리고
뚜디리고 하능거는언자 보드락께 할라꼬 하능김니까	두드리고하는 거는 인제 보드랍게 하려고 하는 겁니까
예예	예 예
하모 푸리 막 무덛씽께 그 베 읻	그럼 풀이 막 묻었으까 그 베 있
그 마당에서 풀로 이피가꼬 한사구 풀끼리노코	그 마당에서 풀을 입혀 가지고한 사구 풀 끓여 놓고
막 소느로 막 이리 막	막 손으로 막 이리 막
그그 철가블 해요 베를	그그 칠갑을 해요 베를
그 베르 오를 오를	그 베를 올을 올을
그래가꼬인잗	그래 가지고 인제
또 소를가꼬 마악 요리 비비고 요리 막	또 솔을 가지고 막 요리 비비고 요리막
머리 빅끼드끼 비끼요	머리 빗기듯이 빗겨요
비끼오 인자 몰류고 재뿌레다가 몰류고	빗기고 인제 말리고 잿불에다가 말리고
긍께 일도일도 엥가이도 마나	그러니까 일도 일도 어지간히도 많아
그래가꼬 인자 도투마리에다가언자 가마가꼬언자	그래 가지고 인제 도투마리에다가 인제 감아 가지고 인제
그 또 베틀 차리가꼬	그 또 베틀 차려 가지고
베틀 차리가꼬언자 베짜고	베틀 차려 가지고 인제 베 짜고
베 짜믄언자 끄치지	베 짜면 인제 끝이지
그래가꼬언자 오슬 해입찌언자	그래 가지고 인제 옷을 해 입지 인제
그라먼자 아까 미영씨 거 미영 타가저오가주고 그지요 걷또머 양이 마느며는쫌다르긴하겓찌마는	그러면 인제 아까 미영씨 그거 미영 타 가져 와 가지고 그죠그것도 뭐 양이 많으면은 좀 다르긴 하겠지마는
예예	예 예
미영타가저오가꼬 아까멈니까언자 그거	미영 타 가져 와 가지고 아까 뭡니까그건 인제 그것
이 모라 고치	이 말아 고치
고치 이	고치 이
모라	말아
고치 몰 모라가주고	고치 말 말아 가지고
겔구겐 베를	결국엔 베를
짤때까지 한 메치리나 걸림니까 보통	짤 때까지 한 며칠이나 걸립니까 보통
메치리 아니라 고만 어서어서허는 사람 빨리 해비리고	며칠이 아니라 그냥 어서어서 하는 사람 빨리 해 버리고
이자 얼르얼르 몬허는 사람 또 머 늑께 허고	인제 얼른 얼른 못하는 사람 또 뭐늦게 하고
긍께 하리 그 고치그걸인자 함뽀따리해 노으먼언잗	그러니까 하루 그 고치 그걸 인제 한 보따리 해 놓으면 인제
또 두서 서이나 너이나 막 이리막 뺑 둘러안자가꼬 푸마씨를 해가꼬	또 두서 셋  이나 넷이나 막 이리 막 뺑 둘러 앉아 가지고 품앗이를 해 가지고
이젣 저녀게 그걸인자 다 모라비리고 모라 치아야뎅께로	인제 저녁에 그걸 인제다 말아 버리고 말아 치워야 되니까
모라비리고	말아 버리고
모라가꼬 또 물레예다가 이릳	말아 가지고 또 물레에다가 이리
자사서 이 실 다 빼야대고	자아서 이 실 다 빼야 되고
이리 그만 항정도엄씨 마나요 그 베논능기	일이 그만 한정도 없이 많아요 그베 놓는 게
삼베나 모시베나 모시베도 마	삼베나 모시베나 모시베도 마
그라먼자 지금꺼지 말씀하싱기 인자	예 그럼 인제 지금까지 말씀하신 게인제
미영베	미영베
미영베 아임니꺼이	미영베 아닙니까
미영베	아 미영베
미영베	미영베
자 인자 미영베 이어가지고예	자 인제 미영베 이어 가지고요
그 다음인자 삼베 인자자 만드는김니다이	그 다음 인제 삼베 인제 만드는 겁니다
삼벧 삼베도 하모 삼베는	삼베 삼베도 하모 삼베는
사믈 가라가꼬 사믈 바테다가언자 골 처가꼬 막	삼을 갈아 가지고 삼을 밭에다가 인제 고랑 쳐 가지고 막
비로 흑꼬 막 줄줄 가라노믄 막	비료 흩고 막 줄줄 갈아 놓으면 막
콱 크기 저거 작때이 저거 만침 크거등뇨	콱 크게 저거 작대기 저거만큼 크거든요
저저 간짇때 간짇때만침 크머	저저 장대 장대만큼 크면
언잔 집 언잗 나트로막 베능기라요 식꾸대로 가가꼬	인제 집 인제 낫으로 막 베는 거예요 식구대로 가 가지고
식꾸가 머 두리등가 서이등가 인제 자기바테 인자 가라가꼬	식구가 뭐 둘이든가 셋이든가 인제 자기 밭에 인제 갈아 가지고
가라가꼬 가믄언인자 나트로언자 이리 베요 막	갈아 가지고 가면 인제 낫으로인제 이리 베요 막
간조로히언자 베서 착착 논능기라 노믄언자	가지런히 인제 베서 착착 놓는 것이라 놓으면 인제
노믄 또 막 이리 가재이가 막 이리 나무 요런데 막 가재이가 이리이리이리막 막 꼬치피고 막	놓으면 또 막 이리 가지가 막 이리 나무 요런 데 막 가지가 이리 이리 이리 막 막 꽃이 피고 막
즈즏 그거거등뇨	저 저 그거거든요
그러믄자 가재이그 걷또 다 훌터야대 소느로인잗 장가블 찌등가 머우짜등가	그러면 인제 가지 그것도 다 훑어야 돼 손으로 인제 장갑을 끼든가 뭐 어찌하든가
싸악 훌터삐리고언자 반반 매끈허이 조키언자	싸악 훑어 버리고 인제 반반매끈하게 좋게 인제
조키인자 요요 앵긍다리매이로 요리 빤드터이 해가꼬	좋게 인제 요요 안경다리처럼 요리 반듯하게 해 가지고
또 저네 여 미테 저적 지금 큰 여 우리 입꾸에	또 전에 여기 밑에 저기 지금  큰 여기 우리 입구에
솔라무 마니 읻찌요 큰 솔라무	소나무 많이 있지요 큰 소나무
거게 막 상 꾼는 저런 작때이거치 진걸 막 막 지고	거기에 막 삼 굽는 저런작대기같이 긴 걸 막 막 지고
나무따발매이로 이 막여자들 이고 그래각꼬 줄주리 거기예 가요	나무 다발처럼 이 막 여자들 이고 그래 가지고 줄줄이 거기에 가요
상 꾼는데가 항군데뿌이라농께 온 동네싸라믄 다 허고	삼 굽는 데가 한 군데뿐이라 놓으니까 온 동네 사람은 다 하고
그래가꼬 막언자 가는대로언자 또 순수가 이써요	그래 가지고 막 인제 가는 데로인제 또 순서가 있어요
그 대짜 서로 꾸울라쌍께	그 대차 서로 구으려 하니까
질기 또 항투우 우를가꼬 이리볼라가꼬 상그걸 착착 여리 여가꼬 막더퍼 가꼬막	길게 또 황토를 가지고 이리 발라 가지고 삼 그걸 착착 이리 넣어 가지고 막덮어 가지고 막
불로때가꼬 그리 이쿠거등뇨 고구매 이쿠드키	불을 때 가지고 그리 익히거든요고구마 익히듯이
고구매 이쿠드키 그른 나무를 즈즏	고구마 익히듯이 그런 나무를 저저
비가꼬 그거 저 삼베허능걸 그걸 비가 와서 이쿠먼	베어 가지고 그거 저 삼베하는 걸 그걸 베 가지고 와서 익히면
이쿠먼 이거가꼬언자 이리막 불때가꼬 이카서언자 싸악 직찌응걸 내조요	익히면 이거 가지고 인제 이리 막 불 때서 익혀서 인제 싹 각자의 걸 내 줘요
포르 해야대언자 직찌응걸	표를 해야 돼 인제 각자의 걸
낸 맫따바리다 니 나는 맫따바리다맫따바리다인자 다섣따반 다섣따반 머 일곱따바림 일곱따발	누구는 몇 다발이다 니 나는 몇 다발이다 몇 다발이다 인제 다섯 다발 다섯 다발 뭐 일곱 다발이면 일곱 다발
포를 해가꼬 직찌응걸 직찌응걸 인자 그리 딱 인자 내주먼	표시를 해 가지고각자 걸 각자의 걸 인제 그리 딱 인제 내 주면
또 그걸언자 그거서 거거 솔라무미테 그런데서막	또 그걸 인제 거기서 그그 소나무 밑에 그런 데서 막
거서 쌀마주는 사라미이써써요 임재가	거기서 삶아 주는 사람이 있었어요 임자가
쌀마 도늘박꼬 쌀마조 쌀마주믄 지주 또 이리째요 거거서	삶아 돈을 받고 삶아 줘 삶아 주면 죄다 또 이리 째요 거기서
물렁물렁물렁허거등 막	물렁물렁물렁하거든 막
그 요리 막 산때라 하고 소게 뺄따구그거는 산때라하고	그 요리 막 삼대라 하고속에 뼈대 그거는 삼대라 하고
쭈욱 쭉 막 이리 벡끼가꼬	쭈욱 쭉 막 이리 벗겨 가지고
베끼가꼬언자 직찌음 가와요 또지비 껍떵만가꼬	벗겨 가지고 인제 각자 가져 와요 또 집에 껍데기만 가지고
껍떵만 가꼬오믄	껍데기만 가지고 오면
아네 대는 내삐리고	안의 대는 내 버리고
대는 인자 또 대는 또 가와서언잗	대는 인제 또 대는 또 가져 와서 인제
또 나무허고 모리믄 나무가 또 조커등뇨	또 나무하고 마르면 나무가 또 좋거든요
대는 소개 대 그거는 허허이 막 나오거등 그거는언잗 가와 또 불때고	대는속의 대 그거는 허옇게 막 나오거든 그거는 인제 가져 와서 또 불 때고
거게서 껍떼기를 다 배낀단 말 아임니꺼 찌기 짼다	거게서 껍데기를 다 벗긴단말 아닙니까 쪄서 짼다
베끼가 와야대째	벗겨서 와야 돼째
지베 오서 가져때면 너무구더서 안대니까	집에 와서 가져 때면 너무 굳어서 안 되니까
하모 그렁께	아무렴 그러니까
거거서 고맏 너린디서 막 거서	거기서 고마 넓은 데서 막 거기서
그래가꾸만 카휴 일도 마나요 참말로	했구만 아휴 일도 많아요 참말로
그래가꼬 이리쭉쭉언자 두쪼가르썩 내요 항개를 쌀마주먼	그래 가지고 이리 쭉쭉 인제 두 쪼가리씩 내요 한 개를 삶아 주면
두쪼가리썩 넙쩍허이막 요리 넙쩍허이 막	두 쪼가리씩 넙적하게 막 요리 넙적하게 막
양쪼게 두쪼가르썩 요리 톡 뿌질러가꼬 여 가온데를 톡 뿌지리믄	양쪽에 두 쪼가리씩 요리 톡 부러뜨려 가지고 여기 가운데를 톡 부러뜨리면
저거 머이고 쪼개 써리씨거시기 소게 그게이거씽께	저거 뭐니 쪼개 써리씨 거시기 속에 그게 익었으니까
톡 뿌질라지거등	톡 부러뜨려 지거든
요개 나무거트몬 요 요거를 뿌진다하매	요게 나무 같으면 요 요거를 부러뜨린다 하면
톡 뿌질라가꼬	예 톡 부러뜨려 가지고
뿌질르믄 요개인자	부러뜨리면 요게 인제
그미강께네 고걸갇따가	금이 가니까 그걸 가져다가
예예	에 예
두쪼그로	두 쪽으로
그그해가꼬 요리 벡끼고	거기 해 가지고 요리 벗기고
요리 벡끼고 막 언자 네버늘 베끼능기라	요리 벗기고 막 인제 네 번을 벗기는거야
여 여기에 두번 여 우에 두번 막 그래각꼬	여 여기에 두 번 여기 위에 두 번막 그래 가지고
그러믄 껍띠이가막 이기 넙쩍넙쩍허이 나와요 삼너	그러면 껍데기가 막 이게넙적넙적하게 나와요 삼
그라믄 저 탁 뿔러질때예	그러면 저 탁 부러질 때에
아네 삼베삼때는 당여니 뿌러질끼고	안에 삼베 삼대는 당연히 부러질 거고
가예 껍떼기도 부러집니꺼	가장자리의 껍데기도 부러집니까
그게그게그이 찔구쫄긷쫄긷항기	그게그게그게 쫄깃쫄깃쫄깃한 게
그래도 그래도 그래각꼬인자 쭈욱쭉 베끼능기라	그래도 그래도 그래 가지고 인제 쭈욱 쭉 벗기는 거야
베끼가꼬막 그렁께그만 마라나서그러치 태산거치 껍띠이가	벗겨 가지고 막 그러니까 그만 말 안 해서 그렇지 태산같이 껍데기가
그으막 수하컨기 그래가꼬 가와도	그거 막 흉악한 게 그래 가지고 가져와도
할머이 그렁께예	할머니 그러니까요
요거 툭 안 뿔람니꺼	요거 툭 안 부러트립니까
뿔라모 삼때 아네 허연거는 당여니 뿔라지끼고	부러뜨리면 삼대 안의 허연 거는당연히 부러질 거고
가에는 껍떼기도 그끄너짐니까 아임 껍떼기는 안끄너짐니까	가장자리에는 껍데기도 끊어집니까 아니면 껍데기는 안 끊어집니까
껍띠기는 인자 그 끄너지면베 몬노치	껍데기는 인제 그 끊어지면 베 못 놓지
고 껍 껍떼이는 안끄너지지 그러니까잉	음 그 껍 껍데기는 안 끊어지지 그러니까
하 어	하 어
그래가꼬 그래가꼬언자 껍띠이 그거이 베거등	그래 가지고 그래 가지고 인제껍데기 그것이 베거든
그걸 수아캉걸 껍떡 그걸인자 해가꼬 와가꼬	그걸 흉악한 걸 껍데기 그걸 인제해 가지고 와 가지고
해가 와가꼬언자 또	해서 와 가지고 인제 또
지주 똗	죄다 또
거 시리나오구로 똗 해야대거등뇨	그 실이 나오게 또 해야 되거든요
그걸가와 무레당가가꼬 또 시리나오구로 또	그걸 가져 와 물에 담가가지고 또 실이 나오게 또
지주 그 허헌 시리 또 이써요 그 베논는 시리	죄다 그 허연 실이 또 있어요그 베 놓는 실이
껍떡그걸 또 베끼능기라 또 칼로가꼬 칼로가꼬이리 또 뿌질라가꼬	껍데기 그걸또 벗기는거라 또 칼을 가지고 칼을 가지고 이리 또 부러뜨려 가지고
포쩍마 질기언자 베끼가꼬인자 배끼믄언자 그 베논는 시리나오니까 그걸가꼬언자 또	폭싹 뭐 길게 인제 벗겨 가지고 인제 벗기면 인제 그 베 놓는 실이 나오니까그걸 가지고 인제 또
그리 몰 허허이 몰랴가꼬 간지때다 너러서 몰랴가꼬 대가리 요요요리 뭉꺼가고	그리 뭘 허옇게 말려 가지고 간짓대에다 널어서 말려 가지고 대가리 요요 요리묶어 가지고
그래가꼬언잗 또 째능기라요 막 손토블긍께 저네는 이할매드리 마이지랃써 요리	그래 가지고 인제 또 째는 거에요 막 손톱을 그러니까 전에는 이 할매들이 많이길렀어 요리
지라고 거 베 그걸 요리	기르고 거 베 그걸 요리
납짝허이이리 해옹걸 갇따가 그걸 지주 또 째야 뎅께	납작하게 이리 해온 걸갖다가 그걸 죄다 또 째야 되니까
손터비 지러야데	손톱이 길어야 돼
그걸 손토블가꼬요리 난나치 쨍께	그걸 손톱을 가지고 요리 낱낱이 째니까
그래가꼬 막 지일 또 해가꼬	그래 가지고 막 길게 또 해 가지고
그거언자 굴께 째능거	그거 인제 굵게 째는 거는
굴께 짜믄	예 굵게 짜면
굴글끼고이	굵을 것이고
굴거	굵어
가늘게 째며는	가늘게 째면은
가는베	가는 베
보드라이대근네예	보드랍게 되겠네요
가는베	가는 베
가늘게 헐라믄 가는베	가늘게 하려면 가는 베
잘기 쪼개능거는 가는베	잘게 쪼개는 거는 가는 베
국끼쪼개능거는 마 닫쌔베 머 엿쌔베 마	굵게 쪼개는 거는 뭐 닷새 베 엿새 베 뭐
마리자모 녹차 그거 저거 칭아 입띡끼	말하자면 녹차 그거 저거 층계 있듯이
그걷또언자 막 칭아가 이써요	그것도 인제 막 층계가 있어요
구끼 째가꼬허믄 막 닫쌔베라허고 엳쌔베라하고 가늘게허믄	굵게 째 가지고 하면 막 닷새 베라 하고 엿새 베라 하고 가늘게 하면
마악 그래가꼬언잗	마악 그래 가지고 인제
그 쌀마가꼬 그리 하이고 일도 마나요 그래가꼬 해가꼬	그 삶아 가지고 그리 아이고 일도 많아요 그래 가지고 해 가지고
지주 허헌언잗 시를 내가꼬 오대임는 시를 내가꼬	죄다 허연 인제 실을 내 가지고 옷 해 입는 실을 내 가지고
물파게여 옫 이거 거더 올리고 지주 또 그거 이서요 그거 여러 동가링께	무릎에 여기에 옷 이거 걷어 올리고 죄댜 또 그거 이어요 그거 여러 동강이니까
그걸 지주 요래이 막	그걸 죄다 요래 막
꼬랑댕이 요리 째가꼬 또 손토블가꼬 꼬랑대이 째가꼬 요리막 비비고 이서가꼬	꼬랑댕이 요리 째 가지고 또 손톱을 가지고 꼬랑댕이 째 가지고 요리 막 비비고이어 가지고
질기 이서야 그걸 또 그 도투마리예 이 해가꼬 베를 노커등뇨	길게 이어야 그걸 또 도투마리에 이 해 가지고 베를 놓거든요
그걷또 내나 아까 그거허고 또가테요 삼베나 모시베나	그것도 내나 아까 그것하고 똑 같아요 삼베나 모시베나
지주 그리이	죄다 그러니
지주 그리한단 마른 점부다한단 마림니꺼	지주 그리한다는 말은 전부 다 한다는 말입니까
저 하	저 하
지주한다	지주한다
지주 마	지주 마
그래 지주 한다능게	그래 지주 한다는 게
지주고마전시 다 이리 이써가꼬	지주 고마 전신에 다 이리 이어 가지고
질게 해야뎅께	길게 해야 되니까
전시네 다	예 전신에 다
예예 전시네 고마	예예 전신에 그냥
삼베도 그리해야 대고 모시베도 그리해야 데고	삼베도 그리 해야 되고 모시베도그리 해야 되고
미영베는언자 그리 물레예다가 짇 시를 빼야대고	미영베는 인제 그리 물레에다가짓 실을 빼야 되고
아까버네 그 함보따리저걷 해가꼬와가꼬 미영꼬타루 가가서 씨빼고	아까번에 그한 보따리 저거 해 가지고 와 가지고 미영 꼬투리 가지고 가서 씨 빼고
그 방아씨레서언자 찌주문 그스해 주먼	그 방앗간에서 인제 찧어 주면 그슥해주면
그래가꼬 그리 베를 노코 미영베는 그랜는데언자 삼베모시베는 그거	그래 가지고 그리 베를 놓고 미영베는 그랬는데 인자 삼베 모시베는 그거
난나치 그 소느로 째고 그리 맨드러야 데요	낱낱이 그 손으로 째고 그리 만들어야 돼요
그래가꼬 또 도투마리라고 이 거쌔이 머이고	그래 가지고 또 도투마리라고 그 뭐니
이 작때기를 여여거 요고매이로 상매이로 요리 따악 요리 세아노코	이 작대기를  여 여기에 요거처럼 삼처럼 요리 딱 요리 세워 놓고
두개를 욜 나무로가꼬 남자드리 요리 맨드러주믄 세아노코	두 개를 요리 나무를가지고 남자들이 요리 만들어 주면 세워 놓고
그거베그거 째고막 헝걸 요리 양쪼게다가 따악 물리노코	그거 베 그거 째고 막한 걸 요리 양쪽에다가 따악 물려 놓고
이제 이걸 또 시를 빼가꼬 이리 이서가꼬	이제 이걸 또 실을 빼 가지고 이리 이어 가지고
깡어리예다가 이리 당꼬 아이고 일도 마나요 삼베허고 모시베허고	광주리에다가 이리 담고 아이고 일도 많아요 삼베하고 모시베하고
그래가꼬 물파아다 비비고	그래 가지고 무릎에다 비비고
그리 일도 마나 그래가꼬 옫 해이피고 한핸능가요	그리 일도 많아 그래 가지고옷 해 입히고 했잖은가요
그러먼자	예 그러면 인제
삼베도언자 그래가꼬언자	삼베도 인제 그래 가지고 인제
결구근 베트레가서 짜야댈꺼 아임니꺼이	결국은 베틀에 가서 짜야 될 것 아닙니까이
하모	아무렴
짜능거는 아까 미영베 짜는거갇다 이마리지예 이제	짜는 거는아까 미영베 짜는 거 같다 이 말이지요 이제
미영베나 삼베나	미영베나 삼베나
똑 갇찌	똑같지
손 손 허능거는	손 손 하는 것은
전시네 소느로 다 핻씽께 모두	전신에 손으로 다 했으니까 모두
그러먼자 그 삼때 고 이파리 거는 어데다 씀니꺼	그러면 인제 그 삼대 그 이파리는 그거는 어디다 씁니까
입싸구마 다 버리지요 버리지 머	잎사귀는 다 버리지요 버리지 뭐
입싸구는 아무데로 베만드는데 쓸모가업따 그지요	잎사귀는 아무데도 베 만드는데 쓸모가 없다 그죠
예예	예 예
고고는 소도 안무꺼 아임니꺼이	그거는 소도 안 먹을 거 아닙니까
안무어 몬무꼬	안 먹어 못 먹고
거름함니까 아이먼 땔깜함니꺼	거름합니까 아니면 땔감합니까
고만 바테서 언자 입싸구는	그냥 밭에서 인제 앞사귀는
삼이파리는 그만 그렁께 아까 질쭉허이 저리 킁걸	삼이파리는 그만 그러니까 아까 길쭉하게 저리 큰 걸
캐도 저리킁걸 인자 베가꼬	캐도 저리 큰 걸 인제 베어 가지고
키아 저리크기 키아야대요 바테서	키워 저리 크게 키워야 돼요
고마 풀매서 키아노믄	그냥 풀 매서 키워 놓으면
이리막 나락매이로 망 나트로가 베요	이리 막 나락처럼 막 낫으로 베요
비가꼬 이자 싸악 훌터내비리지 바테 거거서 이파리 거는	베어 가지고 인제싸악 훑어 내 버리지 밭에 거기서 이파리는 그거는
훌꼬언자 매끈허이 해가꼬 와요	훑고 인제 매끈하게 해 가지고 와요
매끈허이 저저 해가꼬 와서 그갇따 쌀마야 대거등 쌈는데다가	매끈하게 저저해 가지고 와서 그 갖다 삶아야 되거든 삶는 데다가
아까	아까
삼마 저저 삼만 그리 쌀마	삼만 저저 삼만 그리 삶아
모시는 지비서언자	모시는 집에서 인제
또 품능기 읻꺼등 품는다고 이리이리이리 또 풍꼬	또 품는 게 있거든 품는다고 이리 이리 이리 또 품고
아까 저 인자 간지때이가튼 저런 기다란 삼때를 쌈는다안켇씀니꺼	아까 저 인제 장대 같은 저런 기다란 삼대 삶는다고 했잖습니까
예예	예예
쌈는다는거는 소테 너어가꼬 물로 부쳐하는기 아임니꺼이	삶는다는 거는 솥에넣어 가지고 물을 부어 하는 게 아닙니까
삼 저 소테허능기 아이고	삼 저 솥에 하는 게 아니고
상꾼매이로	삼굿처럼
상꾸시라고막 지일기 항토흐끌가꼬 맨드러나써요	삼굿이라고 막 길게 황토 흙을가지고 만들어 놨어요
그거를 머라고예	그거를 뭐라고요
상꾿 상꾿	삼굿 삼굿
상꾸로가자 막 우리가 그라고 가고 그러거등 그럼막	삼굿하러 가자 막 우리가 그러고 가고 그러거든 그럼 막
즈즏 가는대로 그걷또	저저 가는 데로 그것도
이리인자 줄주리 앙가능가요 에이 가믄	이리 인제 줄줄이 안 가는가요 에이 가면
줄줄히 가믄언자 니 걷 니가니가 언제왇따 언제왇따 해가꼬 딱그사람꺼언자 다서시기면 다서시	줄줄이 가면 인제 이것 누구 것 누구가 누구가 언제 왔다 언제 왔다 해 가지고 딱 그 사람 것 인제 다섯씩이면 다섯씩
다섣찌비 딱 뭉치가꼬 쌀마주고 또 그넘 쌀마내고 또 딴사람 인잗 착착언자 서로쌀믈러고	다섯 집이 딱 뭉쳐 가지고 삶아 주고 또 그놈 삶아 내고 또 딴 사람 인제 착착 인제 서로 삶으려고
아페온사람 디에온사람 서로쌀믈라싸니까 안대거등 순수가이써가꼬	앞에 온 사람 뒤에 온 사람 서로 삶으려고 하니까 안 되거든 순서가 있어 가지고
지금 즏 즈즈즈 투포허로 가믄 순수읻씨낃 줄주리 그걷매이로	지금 저 저저저투표하러 가면 순서 있으니까 줄줄이 그것처럼
이자 정때가는 사람 아적찌레 가는 사람 막그라능가요이 바테서 해가꼬	인제 저녁 때 가는 사람 아침결에 가는 사람 막 그러는가 요리 밭에서 해 가지고
그러니까언자 가는대로 착착 모아가꼬언자	그러니까 인제 가는대로 착착 모아가지고 인제
항께쌈꼬 항께 쌍꼬	함께 삶고 함께 삶고
그래서언자	그래서 인제
그리쌈능기라	그리 삶는 거야
언자	인제
하모	아무렴
한번도 내 본저기 엄써서 여쭤보능긴데예	한번도 내 본 적이 없어서 여쭤 보는 건데요
그렁께 예	그러니까 예
그거넌자 결국 소튼아이다임니꺼이	그것은 인제 결국 솥은 아니잖습니까
예 질쭈욱허이 막	예 길쭉하게 막
질쭉허거 머 만드러야 댈꺼아임니꺼이	길쭉하게 뭐 만들어야 될 거 아닙니까
흐클 가꼬	흙을 가지고
부를 때는 데도 익꼬	불을 때는 데도 있고
글아까 머 상꾸라캗씸니	그거를 아까 뭐 삼굿이라고 했습니까
상꾿 상꾿	삼굿 삼굿
머시 무어시다캐보이소 그머	뭣이 무엇이다라고 해 보이소 그 뭐
사 상꾿	사 삼굿
상꾸	삼굿
상꾸심니까 상꾿멈니까	삼굿입니까 삼굿 뭡니까
상꾿 상 상꾸러가자 머 상꾸 상꾸라데	삼굿 삼 삼 구워러 가자 뭐 삼굿삼굿이라데
쎄도 안도라간다	혀도 안 돌아간다
상꾸시라 마리자믄	삼굿이라 말하자면
상꾸세 즈즏 그리	삼굿에 저저 그리
그러믄	그러면
바서 막	봐서 막
결구건자 흑까지고 먼가	결국은 인제흙 가지고 뭔가
이리 킁걸 만드러야 댈꺼	이리 큰 걸 만들어야 될 거
이리 질기	이리 길게
질기 만들고	질게 만들고
요리 킁게 드러 갈랑께	이리 큰 게 들어 가려니까
만드러가지고	만들어 가지고
막 구리 지퍼요 어으 지퍼	막 굴이 깊어요깊어
그렁께언자	그러니까 인제
여거서 저저 천정꺼지 그리 지퍼요	여기서 저저천장까지 그리 깊어요
땅미트로 드러감니까	땅 밑으로 들어갑니까
이자 그래가꼬 착착언자 그걷 우리가 바테서 저렁걸 해가머	인제 그래 가지고착착 인제 그것 우리가 밭에서 저런 걸 해 가면
이자 요리 착착 요리 다늘 뭉크거등뇨	인제 요리 착착 요리 단을 묶으거든요
다늘 양쪼게 탁탁 뭉꺼가서 바테서 뭉꺼가믄언자	단을 양쪽에 탁탁 묶어가서 밭에서 묶어가면 인제
착착 나가꼬 막 저 마리자믄 헌 막 저런 수건매이로 헝거 킁거 막	착착 나가지고 막 저 말하자면 헌 막 저런 수건처럼 헌 것 큰 거 막
그걸가꼬 착 우에 더퍼요 더퍼가꼬언자 막	그걸 가지고 저 위에 덮어요 덮어가지고 인제 막
담뇨거틍걸가꼬 헌담뇨 그렁걸 막 착 더퍼가꼬	담요같은 걸 가지고 헌 담요 그런 걸 막 착 덮어 가지고
부를막 저저 여거서인자 가매소테 불때능거매로 막 때지요 아페서	불을 막 저저여기서 인제 가마솥에 불 때는 거처럼 막 때지요 앞에서
때머언자 막 지미 펄펄 나요 거거막	때면 인제 막 김이 펄펄 나요 거기 막
지미 막 올라와 그 가마이때기 막 더퍼논디서	김이 막 올라 와 그 가마니때기막 덮어 논 데서
그러믄언자 어느정도인자 임재는언자 쌩깅걸 알거등뇨	그러면 인제 어느 정도인제 주인은 인제 삼긴 걸 알거든요
이러먼자 쌀마젇끋따 허머언자	이러면 인제 삶아졌겠다 하면 인제
또 그걸 그사람 거 아페항 걸 싹 드러내주고	또 그걸 그 사람 거 앞에 한 걸싹 들어내 주고
새로또 착착언자 너머걸	새로 또 착착 인제 남의 것을
또 다시인자 또 여가꼬 상꾸세다가 여가꼬 또 부를때능기라요	또 다시 인제 또넣어 가지고 삼굿에다가 넣어 가지고 또 불을 때는 거에요
그래고 쌀마조 임재가	그래 가지고 삶아 줘 주인이
그러믄 상꾸슨	그러면 삼굿은
땅 우에 이씀니까 땅 미테 이씀니까	땅 위에 있습니까 땅 밑에 있습니까
고마언자 그사래미 우리 마당저런디다가 땅에다가	그냥 인제 그 사람이 우리 마당 저런 데다가 땅에다가
그리맨등기지	그리 만드는 거지
그인자 그라믄결국 마당뽀다 상 상꾸슨 좀노픔니꺼	그 인제 그러면 결국 마당보다 삼 삼굿은 좀 높습니까
노프지요 상꾸시	높지요 삼굿이
노프지예	높지요
미테는불때는데 익꼬이	밑에는 불 때는 데 있고
불때는데 여서 불때고	불 때는 데넣어서 불 때고
그다음언자	그 다음 인제
그렁께 저 우 저 천장만치로 노파야 덴당께	그러니까 저 위 저 천장처럼 높아아 된다니까
상꾸시	삼굿이
그러믄 완저이 무더미네 마	그러면 오나전히무덤이네 뭐
그라믄제가 인자 몰라서 함 드른마가꼬 제가 정리를 해볼께예	그러면 제가 인제몰라서 한 번 들은 말 가지고 제가 정리를 해 볼게요
마당가테 펑펀한 데다가	마당같은 데 평평한 데다가
예예	예 예
일따는	일단은
우리좀 허지마 거는	우리 좀 하지마 그거는
그래 할머이 저아까 인자 우리인자	그래 할머니 저 아까 인제 우리 인제
쌍꾸세다가 인자 쌈능거 이야기 안해씀니꺼이	삼굿에다가 인제 삶은 거 이야기안 했습니까
예예	예 예
거인자	그거 인제
쌍꾿	삼굿
상꾼 어어 거 상꾸시인자	어 삼굿 어어 그거 삼굿이 인제
내가볼때 이 노피가 아주놉꼬 아까 말쓰믈 드러보니까	내가 볼 때 니 높이가아주 높고 아까 말씀을 들어 보니까
그렁께	그러니까
그러니까이	음 그러니까
긍께 여여 마당걱꼬	그러니까 여기 여기 마당 같고
인자 그래서 거	에 인제 그래서 거기
마당에 인자 불때능구뭉은 하나이써야 댈꺼 가코	마당에 인제 불 때는 구멍은하나 있어야 될 거 같고
예예 고 불때는디가 막 읻쩨	예예 거기 불 때는 데가막 있지
그다메인제 우게는 머 흑꺼 이런 흑꺼틍거 가꼬 쫘악 기다라게 만드러노코	그 다음에 인제 위에는 뭐 흙 이런 흙같은 거 가지고 쫘악 기다랗게 만들어 놓고
그다메 거또 그게 멈니까 저 삼때가	그 다음에 그거 또 뭡니까 저 삼대가
그게 껍띠기가 배끼질라카믄 물 물끼도 이써야 델꺼 가커든	그게 껍데기가 벗겨지려고 하면 물 물기도 있어야 될 거 같거든
그렁께 무를 막	그러니까 물을막
우게서 암버 채채 그람 이래댐 미테 인자	위에서 한 번 채채 그럼 이래 됩니까 잍에 인제
착착 재 노코	착착 재 놓고
미테그라먼자 흑그틍거 가지고 짝 함 만드러노코	밑에 그러면 인제 흑 같은 거가지고 쫘악 만들어 놓고
맨드러	예 만들어
미테는 부를 떼고이	밑에는 불을 때고
예예	예예
그다메 고게 인제 삼때 여코	그 다음에 거기에 인제 삼대 넣고
우게 머 가마때기나 이렁거 덥꼬	위에 뭐 가마니때기나 이런 거 덮고
우게무를 계속 뿌어주야 댈꺼아임니까 마씸니까	위에 물을 계속 부어줘야될 거 아닙니까 맞습니까
무를 하모 부찌	예 물을 아무렴 붓지
그래서 그렁거	음 그래서 그런 거
무리 이써얃	물이 있어야
그 상꾿 상꾸세 대해서 함번 또 말쓰믈 쪼끔 더해주이소	그 삼굿 삼굿에 대해서 한 번 또 말씀을 조금 더 해 주십시오
긍께	그러니까
상꾸슬 우째 만드런는지	삼굿을 어떻게 만들었는지
긍께 그래 그 임재가언자 이리 질쭉허니 저런 저렁기저래 막 징기 드러가니까로	그러니까 그래 그 주인이 인제 이리 길쭉하게 저런 저런 게 저리 막 긴 게 들어가니까는
거이 그렁께로 그리 지읻당께 그 솔라무 큰 솔라무	거의 그러니까 그리 지었다니까 그 소나무 큰 소나무
미테 솔라무미테 거그 바로고마 질까예 큰 정지남미테	밑에 소나무 밑에 거기바로 그냥 길 가에 큰 정지나무 밑에
그 머시고 지금 뻐스댕기는디 거거이 거거가 기라요	그 뭣이고 지금 버스 다니는데 거기에 거기가 맞아요
거가 지그믄 막 지를 느카농께 그러치	거기가 지금은 막 길을 넓혀 놓으니까 그렇지
거게다가 상꾸슬 그리 맨드러가꼬	거기에다가 삼굿을 그리 만들어 가지고
맨드러가꼬 거이	만들어 가지고 그리
그인자 상꾸세다가	그 인제 삼굿에다가
사믈 삼때를 여가꼬 삼때를 여가꼬 바테서 찌거가꼬 막	삼을 삼대를 넣어 가지고 삼대를 넣어 가지고 밭에서 찧어 가지고 막
직쩜 바테서 지저 산 나무로 그리막 지이고지고 막 와가꼬	각자 밭에서 전부삼 나무를 그리 막 이고 지고 막 와 가지고
걷따 여가꼬 부레다가	거기다 넣어 가지고 불에다가
상꾸레다가 여가꼬 그래가꼬	삼굴에다가 넣어 가지고 그래 가지고
쌀마가꼬 그리 막	삶아 가지고 그리 막
삼베를 해찌	삼베를 했지
쌀마가꼬	삶아 가지고
쌀마가꼬 그걷또 머 메뻐늘 그 배끼옴 껍떠글그만 매뻐늘 씩꼬	삶아 가지고 그것도 뭐 몇 번을 그 벗겨 온 껍데기를 그냥 몇 번을 씻고
막 해요 그거를	막 해요 그거를
그라먼자 아까미영씨도핻꼬 미영베도핻꼬 인자 삼베도 해씀니다이	그러면 인제아까 미영씨도 앴고 미영베도 했고 인제 삼베도 했습니다이
언자는언자 모심니더모시	인제는 인제 모십니다 모시
모시	모시
모시도 우째 운제 우째 시머가꼬 우째키앋심꺼	모시도 어찌 언제 어떻게 심어가지고 어찌 키웠습니까
모씨 즈 찌금저거이 저거이 기거등뇨 요요아칭기우예모시	모시를 저 지금 저것이 저것이 모시거든요 요요  위에 모시
모시이파리막 깬니파리만 넙쩍넙쩍허이 엄떵가요 그 벌로받쩨	모시 이파리 막깻잎 이파리처럼 넙적넙적하게 없던가요 그 건성으로 봤지
그렁거가꼬 내나 해써요	그런 거 가지고 내나 했어요
그렁걷또 그걷또언자 막 비를 이 저 저네는막 바테다 저렁걸 막 시머꺼등요 그직쩌응걸 헐랑께로	그런 것도 그것도 인제 막 비료를 이 저 전에는 막 밭에다 저런걸 막 심었거든요 그 각자의 걸 하려니까
직찡기 이써야 허그등	각자의 것이 있어야 하거든
우리 귿 전지니 그만 바테다가 저런 모시를 시머가꼬	우리 그것 전부 그만밭에다가 저런 모시를 심어 가지고
모시를 시머가꼬언자 막 비료이리 시르르 해 노으몬 고망막 요리커요 그걷또	모시를 심어 가지고 인제 막 비료 이리 시르르 해 놓으면 그냥 막 요리 커요 그것도
그게 그 들깨하고 비스터이생겯씀니꺼	그게 그 들깨하고 비슷하게 생겼습니까
여거여거 이써요 내일바요	예 여기에여기에 있어요 내일 봐요
그걸가꼬 베농기라 베를 낟써요	그걸 가지고 베 놓은 거야 베를 놓았어요
그걸 해가꼬 언자 이리 막 나트로 비가꼬 이파리 칙 떼서	그걸 해 가지고 인제이리 막 낫으로 베어 가지고 이파리 척 떼서
해가꼬 대만 막 이리키아노으믄 대만 막 매끄너이	해 가지고 대만 막 이리 키워 놓으면 대만 막 매끈하게
그걷또 이꺼등뇨	그것도 있거든요
그래가꼬 그거는고마 안쌍꼬 쌩걸로 고마이리	그래 가지고 그거는 그냥 안 삶고생걸로 그냥 이리
내일언자 그놈항개 그거해가꼬 갤차드리야지	내일 인제 그것 한 개 그거 해 가지고 가르쳐 드려야지
즈즏 이리 반트로고마 툭뿌질라가꼬 막 그걷또 인자 이리 삼매이로막 찍찍째요	저저 이리 반으로 그냥 툭 부러뜨려 가지고 막 그것도 인제 이리 삼처럼 막 찍찍 째요
째서 껍떡그거망가꼬 베를 허낑께	째서 껍데기 그거만 가지고 베를 할 것이니까
속때는 내비리고	속대는 내 버리고
그래가꼬언자막	그래 가지고 인제 막
또 알랭이그걸 푸머가꼬	또 알맹이 그걸 품어 가지고
참머일이리 망쿠마 그 그렁거 그렁거 가꼬 베를 헐렁께 대차	참 뭐 일일이 많구만 그 그런 거 그런 거 가지고 베를 하려니까 대차
풀립파라가꼬 베를헝께 그래가꼬	풀 이파리를 가지고 베를 하니까 그래 가지고
그 모시는언자 숭구는 때는 그 파종하는 때는 운젭니꺼	그 모시는 인제 심는 때는 그 파종하는 때는 언젭니까
고만 함분숭구노머요 고만 지질로 자꾸나 하내만 숭구노머	그냥 한 번 심어놓으면요 그냥 저절로 자꾸 나 한 해만 심어 놓으면
뿌리이가 익끼 따매 뿌리가 항정업시 지퍼요 저기	뿌리가 있기 때문에 뿌리가 한정없이 깊어요 저게
그래가 베노으믄 저리 또 올라오고 베노믄 또 올라오고 막	그래서 베 놓으면저리 또 올라오고 베 놓으면 또 올라오고 막
거르라머	그럴려면
그람 모시나 모시가그 크몬 키가 얼마나 뎀니꺼	그럼 모시나 모시가 그 크면키가 얼마나 됩니까
크머요 크머 마 우리키만 허지요 더 크기도 허고	크면요 크면 뭐 우리 키만 하지요 더 크기도 하고
으이 모시도언자	그러니까 모시도 인제
이파리는 띠고	이파리는 떼고
이파리 함 마 요립 비가꼬 그걷또 요리 똥구영을 비가꼬	이파리 아무렴 뭐 요리베어 가지고 그것도 요리 똥구멍을 베어 가지고
막 요리고막 훌터비리지 키가 크니까	막 요리 고만 훑어 버리지 키가 크니까
훌터비리고 대가리 여 띠비리고	훑어 버리고 대가리 여기 떼 버리고
그래가꼬언자 대마가오능기라요 대마	그래 가지고 인제 대만 가오는 거예요대만
대마 가와가꼬언자 또 요리 뿌질라가꼬 껍떵만 이리 비끼가꼬 삼매이로	대만가져 와 가지고 인제 또 요리 부러뜨려 가지고 껍데기만 이리 벗겨 가지고 삼처럼
껍떵만 베끼가꼬 또 막	껍데기만 벗겨 가지고 또 막
또 소글 소글 그걸 속때를 또 요리 쭈욱 베끼머 허허이 막 나오거등뇨	또속을 속을 그걸 속대를 또 요리 쭈욱 벗기면 허옇게 막 나오거든요
그걸가꼬 인자 베를 허능기라 또	그걸 가지고 인제 베를 짜는거에요 또
그라믄	그러면
걷 거테인는 젤 가예인는 껍떼기는 결국 몬씰끼고 그 아네 인능거인잗	겉 겉에있는 젤 가장자리에 있는 껍데기는 결국 못 쓸 거고 그 안에 있는 것 인제
저 야뭉거그거는 베끼야 댈꺼아임니꺼	저 여문 것 그거는 벗겨야 될 거 아닙니까
인잗	인제
거거 꺼쭉배끼는 대 그걸가꼬 그거는 여 모시가 이씽깨 내가 내일갤차디리믄데근네	거기 가죽 벗기는 대 그걸 가지고 그거는 여기 모시가 있으니까 내가 내일가르쳐 드리면 되겠네
그럼	그럼
껍더게서 껍더게서 그 속 속 시리 익꺼등	껍데기에서 껍데기에서 그 속 속 실이 있거든
그걸가꼬언자 베를노니까	그걸 가지고 인제 베를 놓으니까
그래 고거는 안쌈는다 앙그랟씀니까	그래 그거는 안 삶는다 그랬잖습니까
예 안쌀마	예 안 삶아
쌩껄로	생 걸로
쌩걸해가꼬 말람니까 우짬니까	생것을 해 가지고 말립니까어쩝니까
쌩걸로언자 막	생걸로 인제 막
그렁께 껍띠기 베끼가꼬 그걸언자또 요리 토비라고 저네 익꺼등뇨	그러니까 껍데기 벗겨 가지고 그걸 인제 또 요리 톱이라고 전에 있거든요
저 베예 벧허는	저 베에 베 하는
톱 그걸가꼬언자 요리 막 또 이리 훌트머	톱 그걸 가지고 요리 막 또 이리 훑으면
저저 대꼬재이 저렁거 저저 쪼삗허이막 칼매이로 맨드라가꼬	저저 대꼬챙이저런 거 저저 뽀죡하게 막 칼처럼 만들어 가지고
그걸가꼬언자 요리 뿌질러가꼬언자 이리 껍띠기를 베끼머	그걸 가지고 인제 요리 부러뜨려 가지고 인제 이리 껍데기를 벗기면
또 허허이 시리 나와요 모시 시리 나와	또 허옇게 실이 나와요 모시 실이나와
언잗 그걸가꼬언잗 베를 논능기라요 또	인제 그걸 가지고 인제 베를 놓는 거예요또
그는 쌩거를 가꼬 베를 만듬니까 말라가주고 만듬니까	그거는 생것을 가지고베를 만듭니까 말려 가지고 베를 만듭니까
그그는 인자	그거는 인제
그걷또 그리 맨드러가꼬 저젇 제줃 요리 째가꼬	그것도 그리 만들어 가지고저저 죄다 요리 째 가지고
잔잔허이 째등가 머 크기 째등가 째가꼬	잔잔하게 째든가 뭐 크게 째든가 째가지고
물파다 비비가꼬 제주 이리 이서야대 또	무릎에다 비벼 가지고 전부 이리 이어야 돼 또
요막썩허니 허니까르 질구로 자꾸 이서야대	이만큼씩 하니까 길게 자꾸 이어야 돼
물파게다가 이리 비비서 인잗	무릎에다가 이리 비벼서 인제
대가리예다 똥꾸영을 대가꼬 비비고 새끼까능거 매이로	대가리에다 똥구멍을 대가지고 비비고 새끼 꼬는 거처럼
새끼까능거매이로 자꾸 이서야데	새끼 꼬는 거처럼 자꾸 이어야 돼
그래가꼬	그래 가지고
읻 이슬때는	잇 이을 때는
매드블매씀 맴니까 아이면 새끼꼬드시 그래 감니까	매듭을 맸습 맵니까 아니면 새끼꼬듯이 그렇게 갑니까
새끼 꼬드끼 고마 자꾸 매듭 안허구 고마요리 요리 비비서 비비서 에헤	새끼꼬듯이 그냥 자꾸 매듭 안 하고 그냥 요리 요리 비벼서 비벼서 에헤
아하	음 아하
비비서 인능기라요 자꾸	비셔서 잇는 거예요 자꾸
그기언자	그게 인제
질쭉허이	음 길쭉하게
비빈 그부부니 이슨부부니 결국 인자 말린다임니꺼이	비빈 그 부분이 이은 부분이 결국 인제 말리잖습니까
그기인자 안빠지구로 야무기 비비야지	그게 인제 안 빠지게 여물게 비벼야지
야무기	여물게
걷또 기수리 피료하걷따 그지요	그것도 기술이 필요하겠다그죠
기술 이쓰 피료해요	예 기술 있어 필요해요
거 시원차이 비비노믄 칙 처저비리거드	거 시원찮게 비벼 놓으면 축처져 버리거든
그럭컨네예	그렇겠네요
새끼 새끼 아드리 몽까는사람 매이로	새끼 새끼 아이들이 못 꼬는 사람처럼
그그 모니써가꼬 막 가늘고 뚜뚝꼬 그러면 안데거등뇨	그그 못 이어 가지고 막가늘고 두껍고 그러면 안 되거든요
쪼옥 골라야 대거등 그 인능 걷또	쪼옥 골라야 되거든 그 잇는 것도
인능 걷또 골라야 쪼옥 골라야 대 그래야 베가 데거등	잇는 것도 골라야 쪼옥골라야 돼 그래야 베가 되거든
그러먼자 갤구건자 베를 다 짠는데그지예 가믄 아까 머 부분저그로 나왇씀니다마는	그러면 인제 결국은 인제 베를 다 짰는데 그죠 그러면 아까 뭐 부분적으로 나왔습니다마는
질쌈할 때 사용하는 기구드레는 어떵기 이씀니까 기구	길쌈할 때 사용하는 기구들에는 어떤 것이 있습니까 기구
빌 질싸말때 쓰는 기구	길 길쌈할 때 쓰는 기구
그렁께로 그 전짇따리 전짇따리 요리 세아노코	그러니까 그 전짓다리 전짓다리요리 세워 놓고
인자 그 베 그 모시베 그걸언자 실내가꼬 요리 전짇따리라고 익꺼등뇨	인제 그베 그 모시베 그걸 인제 실 내어 가지고 요리 전짓다리라고 있거든요
게 양쪼게 이리 작때기를 세아노코	그거 양쪽에 이리 작대기를 세워 놓고
그래가꼬언잗	그래 가지고 인제
항개쓱 요리 짝짝찌저가꼬언자 요리 거러노코 전짇따리예다가	한 개씩 요리 짝짝찢어 가지고 인제 요리 걸어 놓고 전짓다리에다가
인자 요리 이서대능기라 요리	인제 요리 이어 대는 거야 요리
항개쓱 빼가꼬 줄 줄로 그거 실 그걸 빼가꼬 요리 또	한 개씩 빼 가지고 줄줄을 그거 실 그걸 빼 가지고 요리 또
비비고비비고 해가꼬 잘기 매능기라요	비비고 비비고 해 가지고 길게 매는 거예요
그래가꼬언잗 또 베를 논능기라	그래 가지고 인제 또 베를 놓는 거예요
저 전짇따리라캉기 먼지 함번 또 설명해주이소	저 전짓다리라고 하는 게 뭔지한 번 또 설명해 주십시오
전짇따리 그어럳 내일내가 저저 나무가꼬오 갤차주야건네	전짓다리 그걸 내일 내가 저저 나무갖고 가르쳐 줘야겠네
요래 생깅김니까	요래 생긴 겁니까
저젇 항개썩 항개썩인자 요기 마리자머 여 나무퉁바리리지요 나묻	저저 한 개씩 한 개씩 인제 요리 말하자면 여 나무 동강이지요 나무
저 장작매이로 퉁바리	저 장작처럼 동강
툭빠리 이리 이씨머 요리인자 질쭉허이 대를인자 항개 또 요리 세아가꼬	동강이리 있으면 요리 인제 길쭉하게 대를 인제 한 개 또 요리 세워 가지고
요리언자 여 요리 쪼개요 요리	요리 인제 여 요리 쪼개요 요리
요리 쪼개고 또 여거항개 여거항개 두개를 똑가치언자 요리 해노코	요리 쪼개고 또 여기에 한 개 여기에 한 개 두 개를 똑같이 인제 요리 해 놓고
그람미테요건 땅에파서 무스무씀니꺼	그럼 밑에 요건 땅에 파서 묻습 묻습니까
어디요 암묵꼬 고마요리 그렁께로 모슬지가꼬 전짇따리맨들거등	아니오 안묻고 그냥 요리 그러니까 못을 지어 가지고 전짓다리 만들거든
이 나무매이로 요고매이로	이 나무처럼 요것처럼
그래가꼬언잗 실그거 모시그거언잗	그래 가지고 인제 실 그거 모시 그거 인제
실 그걸 요리언잗 또 거러노코 항개썩 요리 빼가꼬	실 그걸 요리 인제 또 걸어놓고 한 개씩 요리 빼 가지고
저기여이 이슬라모 고마 이슬라모	저기 여 이 이으려면 그냥 이으려면
그 전짇따리는 내일내가 저저 나무가 이씽께로 요 리 설밍해디리믄 알걱꼬	그전짓다리는 내일 내가 저저 나무가 있으니까 요리 설명해 드리면 알겠고
금 전짇따리 그거넌자 모시할때만 피료항김니까	그럼 전짓다리 그거는 인제 모시할 때만 필요한 겁니까
모시베허고 삼베허고	모시베하고 삼베하고
그럼 전짇따리도 피로하고	예 그럼 전짓다리도 필요하고
아까 마란언자 물레도 이써야 댈끼고	아까 말한 인제 물레도 있어야 될 거고
물레 물레가 이써야 미영을 잗쩨	예 물레 물레가 있어야 목화를 잣지
그 짤라카몬 베틀도 이써야 델끼고	그 짜려고 하면 베틀도 있어야 될 거고
베틀도 익꼬 머 벨 이리미 항정엄찌	베틀도 있고 뭐 별 이름이 한정 없지
씨아라능거는 멈니까 씨아	씨아라는 거는 뭡니까 씨아
씨아가 머잉가요	씨아가 뭣인가요
씨아가 머이고	씨아가 뭐지
그런마른 여 안써씀니까	그런 말은 여기서 안 썼습니까
그러먼자 할무이 그 미영이나 미영베	그러면 인제 할머니 그 미영이나 미영베
삼베 모시	삼베 모시
모시	모시
함필 그 함필두필그랟찌예	한 필 그 한 필 두 필 그랬지요
그 함피레 기리는	그 한 필의 길이는
시무재	스무 자
시무재 시무재먼자	스무 자 스무 자면 인제
저 재 재가 익꺼등 요리	저 자 저 자가 있거든 요리
요게 한재	요게 한 자
고게 쉬 시무개란마리지예	그게 스 스무개란 말이지요
한재두재 막 열째 막	한 자 두 자 막 열 자 막
그 재가 이씽깨 딱딱 재거든	그 자가 있으니까 딱딱 재거든
그래 고거 아까 잘 짜는 삼베 잘짜는 동네 누가 읻따	그래 그거 아까 잘 짜는 삼베 잘 짜는 동네 누가 있다
우리동네 하모 이썯쩨	우리 동네 하모 있었지
그 말씀하션는데	그 말씀하셨는데
하리예 그러먼자	하루에 그러면 인제
시무재도 짜데요	스무 자도 짜데요
잘 짱께	잘 짜니까
그라먼 시무재 안짜고 머 보통짜먼	그러면 스무 자 안 짜고 뭐 보통 짜면
보통사라미 짜먼 한 얼마나 짤까예	보통 사람이 짜면 한 얼마나 짤까요
이자 열째 열째도 짜고 열다섣째도 짜고	인제 열 자 열 자도 짜고 열 다섯 자도 짜고
그렁께 모두 솜씨가 다 다링께	그러니까 모두 솜씨가 다 다르니까
그사라믄 진짜 잘짜요	그 사람은 진짜 잘 짜요
우리베 우리어메베는 다 짜꾸마는 해년 해마다	우리 베 우리 엄마 베는 다 짰구만 매년 해마다
인자 마 지금까지 머 이렁거 다 종합해가지고	인제 뭐 지금까지 뭐 이런 거 다종합해 가지고
질싸믈 직쩝해 보셛찌예	길쌈을 직접 해 보셨지요
베짣 베를	베 짤 베를
질싸말때 그때 생각나는 이리 이씨모 머든지 조으니까예	길쌈할 때 그 때 생각나는 일이 있으면 뭐든지 좋으니까요
함분 말씀함해보이 재민는 이리라든지 힘드럳떤 이리라든지 머든 조씀니더	한번 말씀 한 번 해보이소 재미있는 일이라든지 힘들었던 일이라든지 뭐든 좋습니다
뭔 이얘기를해 고마머머시 푸마씨 해가꼬 인자 저내는 막	뭔 이야기를 해 그냥 무엇무엇이 품앗이해 가지고 인제 전에는 막
오늘 오늘 정때는 니집꺼허고 오늘정때는 니집꺼허고	오늘 오늘 저녁 때는 누구 집 것 하고 오늘 저녁 때는 누구 집 것 하고
전시 여리면 열 다서시면 다섣	전신에 열이면 열 다섯이면 다섯
그래가꼬언자 이 집찜마당 다 가치 질싸믈 헝께로	그래가지고 인제 이 집집마다다 같이 길쌈을 하니까
그 베를 노으니까로	그 베를 놓으니까는
오늘 정때는 누구지베서 삼짜 내일 정때는 누구지베서 삼짜 막 그러고 온 정때마둥 막	오늘 저녁 때는 누구 집에서 삼자 내일 저녁 때는 누구 집에서 삼자 막 그러고 온 저녁 때마다 막
푸마씨를 해가 그리 사맏써요 베를	품앗이를 해서 그리 삼았어요 베를
그 거석 그거 인 전짇따리예다가 이리 거러노코	그 그슥 그거 전짓다리에다가이리 걸어 놓고
떼가꼬 여 물파게 이리 막 허고	떼 가지고 여기 무릎에 이리 막 하고
너무 공노예 인자 공노인는지베 공노야안자 하고	남의 공노에 인제 공노 있는 집에 공노에 앉아 하고
마린는 지벤 마리에 이리 졸조리 안자서	마루 있는 집에는 마루에 이리 졸졸이앉아서
공노가 멈니꺼	공노가 뭡니까
저거 저 누마리 누마리	저거 저 누마루 누마루
마리자먼 저저 우리 마리 그거 저쪼게 공노 엄능가요 그 나 안는디	말하자면 저저 우리 마루 그거 저쪽에 누마루 없는가요 그 나와서 앉는 데
그걸 공노라캄니까	아 그걸 공노라고 합니까
저넨 공노라핻써	아 전에는 공노라 했어
지그믄 누마리라 그러데요	지금은 누마루라 그러데요
우리는 공노라 그랟찌	우리는 공노라 그랬지
저네는	전에는
그라믄 저 여페 저 툭 튀논 그김니까	그러면저 옆에 저 툭 튀어 나온 그겁니까
으으	응
저짜 여페 툭 티노옹거	저쪽에 옆에 툭 튀어 나온 것
예예	예 예
아까 군수님 오셔슬때 그거 안자이써떤 그걸갇따가 공노라캐씀니꺼	아까 군수님  오셨을 때 그거 앉아 있었던 그거를 갖다가 공노라고 했습니까
예예 그걸 공노라 핻써	예예 그거를 공노라고 했어
공노	누마루
저네는 그걸 공노라거든	전에는 그거를 공노라고했거든
지그믄 막 누마리라하데 누마리	지금은 막 누마루라고 하데 누마루
어어	응
그기 공노라	그게 누마루야
그래가지고예	예 그래 가지고요
그래가꼬 고서 삼삼꼬	그래가지고 거기서 삼 삼고
공노인는 지베는 저런디인는 지비는인자 거거 뺑돌러 안자서 전짇따리그거 두개썩 딱딱노코	누마루 있는 집에는 저런 데 있는 집에는 인제 거기 빙 둘러 앉아서전짓다리 그거 두 개씩 딱딱 놓고
뺑 도라안자서언자 그리	빙 둘러 앉아서 인제 그리
전짇따리도 마낟찌 여러개지 그렁께	전짓다리도 많았지 여러 개지 그러니까
그래가꼬 노코 또 이	그래 가지고 놓고 또 이
또 청마 요리 인는지베는 청에 졸졸허이 안자가꼬 또	또 청만 요리 있는 집에는 청에 졸졸이 앉아 가지고 또
또 허고 그랟찌요	또 하고 그랬지요
지비 다 다릉께	집이 다 다르니까
그러믄 질싸믄 머 나제도하고 바메도하고 이랟씀니까	그러면 길쌈은 뭐 낮에도 하고 밤에도 하고 이랬습니까
저녀그로도 허고 나지러도허고 하모 만날 그걸막 들고안자써야댕께 모두	저녁이라도 하고 낮이라도 하고 하면 만날 그걸 막 들고 앉아 있어야 되었으니까 모두
이리 영마나요 항가이두가지가 아이라 그 베를 맨들라먼	일이 영 많아요 한가지 두 가지가 아니라 그 베를 만들려먼
일도 마나가꼬	일도 많아 가지고
저 인자 질싸믈하다가보면녜	저 인제 길쌈을 하다가 보면은요
쫌안 안재웁슴니까이	좀 안 지겹잖습니까이
요 재웁따	요 지겹다
하모 지엽찌	그럼 지겹지
지엽찌예	지겹지요
삼도 막	삼도 막
사믄 사 전짇따리 이리 나노코 이리 사면 사믐서로	삼은 사 전짓다리 이리 놓아 두고 이리 삼으면 삼으면서도
사람드리 요리 빼가꼬 요리 막 이섬서로	사람들이 요리 빼가지고 요리 막 이으면서도
가닥까닥 마안날 이서야대거등 막	가닥가닥 만날 이어야 되거든 막
여 깡허리 여 나노코 상깡허리 나노코 막 요리 새리고	여기 광주리 여기 놓아두고 삼광주리 놓아 두고 막 요리 새리고
이슨거는 인자 요리 이서가꼬 요리 허믄	이은 거는 인제 요리 이어가지고 요리 하면
막 자부리고	막 졸고
저녀그로도 삼따가 막 꾸뻑 자부리고 또	저녁으로도 삼다가 막 꾸벅 졸고 또
정신차리가꼬 또 그거 항개 또 읻꼬	정신차려가지고 또 그거 한 개 또 잇고
막 그러능기라요 사람드리 피곤해가꼬	막 그러는 거예요 사람들이 피곤해 가지고
점두룩이르고대차 저녀그로또 그거 사믈라머	종일 일하고 대차 저녁으로 또 그거 삶으려면
꾸뿍꾸뿍허지 자미	꾸벅꾸벅하지 잠이
그러먼자 그거 노 그 잠도 조름도 오고 한데	그러면 인자 그거 노 그 잠도 졸음도 오고 한데
그리허다가도인잗 또 또언자 그리함번허다가 조르다가	그리 하다가도 인제또 또인제 그리 한 번 하다가 졸다가
이자 정시늘 차리능기지 인자 또	인제 정신을 차리는 거지 인제 또
그 일 헐라고	그 일 하려고
이자막 나츨 씽는다 막 무레다가	인제 막 낯을 씻는다 막 물에다가
나츨씩꼬 또와서 막 허고 정시늘 차리능기지	낯을 씻고 또 와서 막 하고 정신을차리는 게지
그거할때 그때 부르던 노래가틍건 업써씀니까	그것 할 때 그 때 부르던 노래같은 건 없었습니까
노래 머 노래 모	노래 뭐 노래 뭐
자기 언자 허구자븐사람 허고막	자기 인제 하고 싶은 사람 하고 막
든는 사람도	듣는 사람도
질쌈할때 인제 우리인제 모내기할때먼	길쌈할 때 인제 우리 인제 모내기할 때면
모심기노래가 머 이뜨시	모심기 노래가 뭐 있듯이
그렁께 예	그러니까예
그 질쌈할때 부르는 노래가 그때동네 혹시 이써떤 기억이 남니까	그 길쌈할때 부르는 노래가 그때 도네 혹시 있었떤 기억이 납니까
그는 마 고만 흥글태롱허고모동 마	그거는 뭐 그냥 하고 모두 마
고만 그러치요 머	그냥 그렇지요 뭐
노래허는 사라믄	노래하는 사람은
그럼 그인자 그라믄 그 할때	그럼 그 인제 그러면 그 할 때
여러시인자 푸마시하며는	여럿이 인제 품앗이하면
머 이야기도하고 그럼니까 아니며는	뭐 이야기도 하고 그럽니까 아니면
아니 이야기 허지요 막 밸로무 이야기 다 허지	아니 이야기하지요 막 별놈의 이야기다 하지
어떤 이야기를 주로 해씀니까	어떤 이야기를 주로 했습니까
아이고마 여자들 서이만 모이먼 너무이약 안허덩가요 막 너무	아이고 뭐 여자들 셋만 모이면 남이야기 안하던가요 막 남의
어디 숭볼띠 이씸 너무 숭보고	어디 흉 볼 때 있으면 남의 흉 보고
막 아무거시찌비는 머 어떠터라 머어쩌데 머싸우데 머어쩌고	막 아무개 집에는 뭐 어떻더라 뭐 어쩌데 뭐 싸우데 뭐 어쩌고
너무마른 팽상잘헝께 모두 넘드른	남의 말은 평생 잘 하니까 모두 남들은
그런 얘기하고	음 그런 얘기 하고
노래 잘하는 사람 동네 계셛떱디까	노래 잘하는 사람 동네 계셨습디까
노래 머 그양막 허는 사람허고 막	노래 뭐 그냥 막 하는 사람 하고 막
그 또 일헐라믄	그 또 이를 하려면
노래부리머 그 이리 저거머이고	노래 부르면 그 일이 저거 뭐니
거석해요	그슥해요
그 암만해도 정시늘 씨머 이를정시는 써야지	그 암만해도 정신을 쓰면 일을 정신을 써야지
노래부리고 막어찌허믄 좀 지쟁이 이써	노래부르고 막 어찌하면 좀 지장이 있어
그렁께 노래는 머 그그험선 안허지 거이	그러니까 노래는 뭐 그 그거 하면서 안하지 거의
그양 말험서로 고마 삼만자꾸삼능기지	그냥 말하면서 그냥 삼만 자꾸 삼는 거지
그 자꾸 이서야대거든 그 오를	그 자꾸 이어야 되거든 그 올을
오를 전짇따리예 요리 막 뻗때노코막 만날 그걷 물파게다가	올을 전짓다리에요리 막 뻗대놓고 막 만날 그거 무릎에다가
이서야대 자꾸 이서야대 오를	이어야 돼 자꾸 이어야 돼 올을
그래 그 함분 봐쓰면 조컨네 선생니미	웃음그래 그 한 번 봤으면 좋겠네선생님이 웃음
그라문 고맙슴니다 오늘 그 저 말쓰먼자 그	그러면 고맙습니다 오늘 그 저말씀은 인제
미영베하고 삼베하고 또 그 모시	미영베하고 삼베하고 또 그 모시
모시베허고	모시베하고
모시베하고	모시베하고
고고하능거를 오늘 여쭤보아씀니더	그거 하는 것을 오늘 여쭤 보았습니다
오느른 요정도하고 내이른 또 다릉거로가꼬 함번 고맙씁니다	오늘은 요 정도하고 내일은 또 다른 거로 가지고 한 번 고맙습니다
예예 땅걸 가 허제	예 예다른 걸 가지고 하지
할머이 저 이버네는녜 으으 사니나 드레서 나는 나무를 우째 뜨더가지고 우째 나물로 핸는지 고곧쫌 여쭈보걷슴니대이	할머니 저 이번에는요산이나 들에서 나는 나물을 어떻게 뜯어 가지고 어떻게 나물로 했는지 그것 좀 여쭤 보겠습니다이
여 먼저 우리 요 펭사리 이 지역 사네서는 사네 주로 어떤 나물드리 남니까사네서 나는 나물 마림니다	여기 먼저 우리 요기 평사리 이 지역 산에서는 산에 주  로 어떤 나물들이 납니까 산에서 나는 나물 말입니다
치나물도 뜨더오고 기새라고 또 기새가 익꺼등 기새너물	취나물도 뜯어 오고기새라고 또 기새가 있거든 기새나물
기새너무른 그건 때다가 그거는 요리요리 때 나무에서언잗 잔잔허이 요리 올라오모	기새나물은 그건 떼어다가 그것은 요리 요리 떼 나무에서 인제 잔잔하게 요렇게 올라오면
사네 가머	산에 가면
기새도 나는디가 익꺼등뇨	기새도 나는 데가 있거든요
지자리 나는디갇 군데군데 이서가꼬 그기 앵기머 이리저릳 사네 댕기다가	제 자리나는 데가 군데 군데 있어 가지고 그게 안기면 이리저리 산에 다니다가
언자 보이모인잗 기새 그걷똗 쭉쭉 빼가꼬 와서 짝	인제 보이면 인제 기새 그것도 쭉쭉 빼어 가지고 와서 좍
쌀마 무치무운 노랑내가 나더마 맏또 엄떠마는	삶아 무쳐 먹으니까 노린내가 나더군 맛도 없더마는
그 기새도 빼고	그 기새도 빼고
그런데 기새는언자 제가 하문도 정 몯드러본 이르미거든	그런데 기새는 제가 한 번도 전에 못 들어본 이름이거든
기샏	아 기새
고거 쪼끔 설명을 해 주이소	고것 조금 설명을 해주이소
궁게 고마 나 저우고 머이곧 뿌리이가 이서가꼬 사네 가모 하기내마다 그기언자 나능기라요	그러니까 그냥 나 저기 뭐니 뿌리가 있어 가지고 산에 가면 해마다그게 인제 나는 거예요
그게 나뭄니까 푸림니까	그게 나뭅니까 풀입니까
풀매이로 보들보들허이 너물 너물종자 하아 기새라고	풀처럼 보들보들하게 나물 나물 종자 아무렴 기새라고
기새너물도 뜩꼬 언작 먹 저네 사네 댕길쩌게느 곤달비라고 또	기새나물도 뜯고인제 뭐 전에 산에 다닐 적에는 곤달비라고 또
치너물매이로 막 보들보들허이 막 빤짝빤짝허이 막 그럭커등 곤달비라고	취나물처럼 막 보들보들하게 막 반짝반짝하게 막 그렇거든 곤달비라고
그런 너물도 똗 비기믄 뜩꼬 맏	그런 나물도 또 보이면 뜯고 마
치너물도 언젇 치너물만 뜯짜네언작 치너물 뜨드러 가모언자 곤달비도 익꼬귿	취나물도 인제 취나물만 뜯지 않아 인제 취나물 뜯으러 가면 인제 곤달비도 있고 그
머이고 아까 그 머이고	뭐니 아까 그 뭐니
기새	기새
기새도 익꼬기새도 익꼬 막 또 쑥거틍거 저거 머이고	기새도 있고 막 또 쑥 같은 것 저것 뭐니
그거느 이름 머이라 하더라 그건 쑥떡뽀다무우므 먿 쑥떡매이로 쑥떡 해뭉능긴데 그이	그것은 이름 뭐라 하더라 그건 쑥떡 해 먹으면 뭣 쑥떡처럼 쑥떡해 먹는 건데 그게
기쑥	기쑥
그 기쑤기 아니고 머 이르미 인는디야	그 기쑥이 아니고 뭐 이름이 있는데야
생각나시모 말씀해 주시고예	생각나시면 말씀해 주시고요
이러버리 하아  이리빋따	잊어 버렸 응 잊어 버렸다
꼬사리도 이섣을꺼 아임니꺼	고사리도 있었을 것 아닙니까
꼬사리도 익꼬	고사리도 있고
또예 우선 종뉴부터 함 드러보입시더 꼬사리 익꼬 또	또요 우선 종류부터 한번 들어 보십시다 고사리 있고 또
허어	응
사네	산에
꼬사리익꼬 기새 익꼬	고사리 있고 기새 있고
곤달비 익꼬	음 곤달비있고
곤달비 익꼬	곤달비 있고
치나물 익꼬	취나물 있고
치나물 익꼬 내나	취나물 있고 내나
그 다메 그거는녜 그 돌가지는 업섣습니까 사네	그 다음에 그것은요 그 도라지는 없었습니까 산에
돌가지도 익꼬	도라지도 있고
돌가지도 막 칠파레 꼬치 피지 쪼깜 이시모	도라지도 막 칠팔월에 꽃이 피지 조금 있으면
그다메 더더근 업섣슴니까	그 다음에 더덕은 없었습니까
더덕도언자 우쩌다가언잔 냄세가 나지	더덕도 인제 어쩌다가 인제 냄새가 나지
사네 가모	산에 가면
이섣지예	있었지요
더덕도 익꼬	예 더덕도 있고
그 다메 꼬사리 종뉸데 꼬사리와 쫌 다릉걷	그 다음에 고사리 종륜데 고사리와 좀 다른 것
깨치미 깨치미라고 익꺼등	고비 고비라고 있거든
그걷또 묵찌예	그것도 먹지요
하모 뭉능기라요 그걸 지새 지내먼 즈즏	아무렴 먹는 거예요 그걸 제사 지내면 저 저
기시 마리 어른드리 기시니 저 금받 금방서게 안잗따느마 금방서게 그걸 조타고	귀신 말이 어른들이 귀신이 저 금방 금방석에 앉았다고 하더만 금방석에 그걸좋다고
꼬사리보당 그기 조탄다네	고사리보다 그게 좋다고 한다네
씨버요 그이 그는 씨버 너무리	써요 그게 그것은 써 나물이
아 그 그시기	아 그 그슥이
그럼 할무이예	그럼 할머니요
깨치미 그기 씨버	고비 그게 써
예제가 지금 말씀하신 중에서 몬아라드른 나무리 두개가 익꺼등녜	예 제가 지금 말씀하신 중에서 못 알아들은 나물이 두 개가 있거든요
하나는 아까 말한 기새너무리고 다른하나는언자 곤달빈데	하나는 아까 말한 기새나물이고 다른 하나는 인제 곤달빈데
곤달비라 캗슴니꺼	곤달비라고 했습니까
곤달비는 저걷 지피 또 드러가야인네요 요 야픈디는 엄서	곤달비는 저게 깊이 또 들어가야 있네요 요 얕은 데는 없어
그럼 기새는 이파리가 어느정도 커고 하는 이렁거를	그럼 기새는 이파리가 어느정도 크고 하는 이런 것을
그양고만 즈즌	그냥 그만 저 저
제일 달믕기 멈니까 기새하고 달믕기 어떵기 이슴니꺼	제일 닮은 게 뭡니까기새하고 닮은 게 어떤 게 있습니까
디거	
고래 여 내나 고만 기새라능거똔 요리 송까락만허이 그만	그래 여기 내나 그냥 기새라는 것도 요렇게 손가락만하게 그냥
보들보드리 너물 그슥 너물매이라요 너물매이러 보들보들해 에리서는	보들보들하게 나물 그슥 나물처럼이예요 나물처럼 보들보들해 어려서는
그걷또 꼬치 피거등 여엳 체판댁지베 인는디	그것도 꽃이 피거든 여 여 최판댁 집에 있는데
기새	기새
기새가	기새가
그라머 거는 나중에 가서 내 직쩝 한번 바야 데건네	그러면 그것은 나중에 가서 내 직접 한 번 봐야 되겠네
기새는 내 거 가서	예 기새는 내 거기 가서
으으 보몬 데고	응 보면 되고
그기언자 그기 내나 기새너물하고	그게 인제 그게 내나 기새나물하고
그다메 곤달비는녜	그 다음에 곤달비는요
곤달비는 저 지픈 사네 가야 이써	곤달비는 저 깊은 산에 가야 있어
그어는치나물갇타 그랟찌예	그것은 취나물 같다 그랬지요
그걷또 치나물이파리매이라 그래도 달라	예 그것도 취나물 이파리처럼이야그래도 달라
빤짝빤짝허이 영 예삐요	반짝반짝한 게 아주 예뻐요
동그람헝기 빠작빠작빠작 누니 나요	동그스럼한 게 반짝반짝반짝 윤이 나요
누니 나고 너물도 막 보들보들허고 조와	윤이 나고 나물도 막 보들보들하고 좋아
이 치너무른 고마 이리 그양 넙쩍허이 그마 그래 생기도	이 취나물은 그냥 이렇게 그냥 넙쩍하게 그냥 그렇게 생겨도
곤달비는 조키 조와 조키 생긷써	곤달비는 좋게 좋아 좋게 생겼어
사람 예삐디끼	사람 예쁘듯이
그럼 곤달비는 체참판대게는 업슴니까	그럼곤달비는 최참판댁에는 없습니까
하모 그렁거는 엄찌	아무렴 그런 것은 없지
그렁거는 엄찌 그거는 나무리고	그런 것은 없지 그것은 나물이고
그라모곤달비는 치나물 치너물 종늄니까	그러면 곤달비는 취나물 취나물 종륩니까
하모 고맘 그리 치너물매이러 그리 바야지머	아무렴 그냥 그렇게 취나물처럼그렇게 봐야지 뭐
그런 종재라 내나 그렁긴데언자 쪼깜 이피 다리지 꼰나무매로 옹골옹골허이 예삐데	그런 종자야 내나 그런 것인데 인제 조금 잎이 다르지 꽃나무처럼 옹골옹골하게 예쁘데
그래	그래
그러먼녜 인자	그러면요 인제
요거는언자 사네서 나는	요것은 인제 산에서 나는
수러치 아까 내 모린다능거 수러치가	아 수리취 아까 내가 모른다고 한 것 수리취가
수러치이가 쑹매이로	수리취가 쑥처럼
떡 떡해뭉능기라 그거	떡 떡 해 먹는 거야 그것
수러치 이파리 뜨더오고 마 사네 가마 보이모	수리취 이파리 뜯어 오고 마 산에 가면 보이면
요걷또 치나물 종뉴지예요것도 취나물 종류지요  그걷또 하먼 치나물 종눈디 질쭉허니 나무가 이피	
그걷또 하먼 치나물 종눈디 질쭉허니 나무가 이피	그것도 아무렴 취나물 종륜데 길쭉한 게 나무가 잎이
이피 염방 호방이파리매이로 막 쭉 대가 쭉 인능기 이피 익꼬	잎이 연방 호박이파리처럼 막 죽 대가 죽 있는 게 잎이 있고
저 호박 쭉때이매이로 막 쭉때이가 그리 이써요 그거는 곧 염방 거 머이라능기고	저 호박 줄기처럼 막 줄기가 그렇게 있어요 그것은 고거 연방 그 뭣이라는 것이니
숟 수리치	수 수리취
숟 수리치 수리치 그기 내나 쑥떡 해뭉능기라 쑥떡	수 수리취 수리취 그게 내나 쑥떡 해 먹는 거야 쑥떡
그얻또 캐다 몰랴 낟따가 쌩걸로 몰랴낟따가 푹쌀마각꼬 게우레 쑥떡 해뭉는다고	그것도 캐다 말려 놓았다가 생것으로 말려 놓았다가 푹 삶아 가지고 겨울에 쑥떡 해 먹는다고
떡 그 우리는 머 안해무박꾸마 해 만날 쑥 그거마 각꼬 해 무걷찌	떡 그 우리는뭐 안 해 먹어 봤구만  만날 쑥 그것만 가지고 해 먹었지
그 수러치 수리치도 익꼬 받 저네 사네가마	그 수리취 수리취도 있고  전에산에 가면
근디 지그믄 사니 저리 막 즈즈 험해각꼬 댕기도 몬해요 디야지도 익꼬	그런데지금은 산이 저렇게 막 저 저 험해 가지고 다니지도 못해요 돼지도 있고
저네는막 사네가서 전시 꼬사리 끄너오고 직찜 무우꺼머 함바치서 이래도 사네가서 꼬사리 끄너오고 핸는디	전에는 막 산에 가서 전신에 고사리 끊어 오고 각자먹을 것 뭐 한 바가지씩 이래도 산에 가서 고사리 끊어 오고
사네 몬끄느께언자 막 사네 뿌리이르 꼬사리 뿌리이르 아까 즈즏 모시 뿌리이매로 막 쭉 빠지거드요 땅 조은디 깨이로가 파머	산에 못 끊으니까 인제막 산에 뿌리를 고사리 뿌리를 아까 저 저 모시 뿌리처럼 막 죽 빠지거등요 땅 좋은데 괭이를 가지고 파면
쭉 빠지먼 그노믈막 빼다가 바테다 듬듬 숭구농께 한 오년데모마 자꾸 뻔치능기라	죽 빠지면 그놈을 막 빼다가 밭에다 드문드문 심어 놓으니까 한 오 년 데면마 자꾸 뻗치는 거야
저 마이 읻떼예	저기에 많이 있데요
즈 즈즉 그러께요	저 저 저 그러니까요
요요도 익꼬	요기에 요기에도 있고
요걷또 뻔치서 그래요 이 찌깬핸는데 뻔치가꼬 올해 저리 만네	요것도 뻗쳐서 그래요 이 조그마했는데 뻗쳐 가지고 올해 저렇게 많네
긍게 천지 뻔치각꼬 저럭케 뻔치요 꼬사는 쪼깬 숭구노모	그러니까 천지 뻗쳐가지고 저렇게 뻗쳐요 고사리는 조금 심어 놓으면
시가니 가모	시간이 가면
그래각꼬 막 사암드리 끄너요 지그믄 직쩜 바테다 해각꼬 사네가 몬끄능께 사니 저래 생기농께	그래 가지고 막 사람들이 끊어요 지금은 각자 밭에다 해 가지고산에 가서 못 끊으니까 산이 저렇게 생겨 놓으니까
그라모 할무이 제가 그지예	그러면 할머니 제가 그죠
할머이가 말씀하신 사네서 나는저 나 너물종뉴으 제가 이르믈 불러보께예이	할머니가 말씀하신 산에서 나는 저 나 나물 종류의 제가 이름을 불러 볼게요이
으으 기새가 익꼬	어 이새가 있고
그 다메 곤달비가 익꼬	그 다음에 곤달비가 있고
치너무리 익꼬	취나물이 있고
깨치미가 익꼬	깨치미가 있고
깨치미도 익꼬	깨치미고 있고
그다메 수러치가 익꼬	그 다음에 수리취가 있고
돌가지가 익꼬	도라지가 있고
더더기 익꼬	더덕이 있고
꼬사리가익꼬 이렁거시 읻따 마리지예	고사리가 있고 이런 것이 있다 말이지요
일목아그렁구마 읻찌	예 그런 것 마 있지
그라믄녜	예 그러면요
또 그 와 따뭉능거먿 마리자모 지픈 사네 요런디는 음찌마는	또 그 왜 따 먹는것 뭐 말하자면 깊은 산에 요련 데는 없지마는
다래 머구 다래 머구	다래 머위 다래 머위
다래	다래
다래가	다래가
다래 얼매나 마싣따고 즈즏	다래얼마나 맛있다고 저 저
아니 다래는 열매를 먹찌	아니 다래는 열매를 먹지
그렁께 열매 요막썩허이 따각꼬오모	그러니까 열매 요만끔씩하게 따 가지고 오면
그래 열매는 쫌 다릉거고 예예예	아 그래 열매는 좀 다른 게고
아아 열매는 안허고 하아	아 열매는 안 하고 아
아이 맏 하문 하입시더 그라모 다래	아니 마 한 번 하십시다 그러면 다래
그렁께 다래 걷 따다가저 아러모겓 파무더 노모 이불 미테	그러니까 다래 그것 따다가 저 아래목에 파묻어 놓으면 이불 밑에
파무더 노모언잗 그걷똗오늘 따오몬 오늘 무더노므 오올지역 자고	파묻어놓으면 인제 그것도오늘 따 오면 오늘 묻어 놓으면 오늘 저녁 자고
내일 요리 막 요리 손대 몰랑몰랑항거 그넘 주묵꼬 여뭉거는 도로 무더노코	내일 요렇게 막 요렇게 손 대 몰랑몰랑한 것 그놈 주워 먹고 여문 것은 도로 묻어 놓고
처네 그랙꺼마 몰랑몰랑허모언자 마식꼬	전에 그랬었지 몰랑몰랑하면 인제 맛있고
띤찌헝거는 여뭉거 무구모막 지즏맏또 음써요 씨버서	단단한 것은 여문 것 먹으면 막 저 저 맛도 없어요 써서
노래 창헌다 오늘 토요허는데 일룔 허는데	노래 창한다 오늘 토요일 하는데일요일 하는데 참고 밖에서 들려오는 노래 소리를 듣고 주제와 상관 없는 얘기를하신 것임
그러먼녜 언자는 아까 그거는 나물종뉴고예	그러면요 인제는 아까 그것은 나물종류고요
이 너무를	이 나물을
언자 우째 이머 껑커오든지 캐오든지 따오든지 할꺼 아임니꺼이	인제 어떻게이 뭐 꺾어 오든지 캐 오든지 따 오든지 할 게 아닙니까
응 으으 예	응 응
그래가주고 고	그래 가지고 그
우째인자	어떻게 인제
꼬사리는 머 쌀마섣 좀 당가낟따가 고만 또 복까묵꼬	고사리는 뭐 쌂아서 좀 담가 놓았다가 그냥 또 볶아 먹고
그래언자 제가 하나식 여쭈보께예	그래 인제 제가 하나씩 여쭤볼게요
먼저 기새너무림니다이 기새	먼저 기새나물입니다이 기새
기새는 운제 우쩌께 땀니꺼	기새는 언제 어떻게 땁니까
고만 즌 나무예 고맏 요리 꼬사리매로맏 쭝굳쭝굳 요리 올로오니까	그냥 저나무에 그냥 요렇게 고사리처럼 마 쫑긋쫑긋 올라오니까
요리 올라 바로 올라와요 바로 올로옹께그마 보이모언자 한무디 한테 온천짇 바테 읻짜내노넫	요렇게 올라 바로 올라와요 바로 올라오니까 그냥 보이면 인제 한무더기 한 데 온 천지 밭에 있잖고 논에
까끄매 읻자내 인는디가 이써요 그걷또 뿌리가 저 꼬사리매이로	산에 있지 않고 있는 데가 있어요 그것도 뿌리가 저 고사리처럼
꼬사리도 암디라도 엄꺼드 꼬사리 뿌리이가 이써야 그기 이싱께	고사리도 아무 데라도 없거든 고사리 뿌리가 있어야 그게 있으니까
궁게 이리 도리도리허이인자 요리요리 댕가다보모 기새가 오몰허이 이시모인자	그러니까 이렇게 도리도리하게 인제 요리 요리 다니다 보면 기새가 오목하게 있으면 인제
마 요릳 빼먼 대요 고마 요리 빼모맏 쭉쭉 빠저요	마 요렇게 빼면 돼요 그냥요렇게 빼면 마 쭉쭉 빠져요
뿌래이채로 뺌니까	뿌리째로 뺍니까
뿌리인 나뚜고 뿌리이 나두야또 후녀네 나지	뿌리는 놓아 두고 뿌리 놓아 둬야 또 내년에 나지
그라모 요기는 끙커야 뎀니까	그러면 요것은 꺾어야 됩니까
빠저요 빠저요릳 떼믄 데 제질로 소느로 고마 요리 떼고	빠져요 빠져 요렇게 떼면 돼 저절로손으로 그냥 요렇게 떼고
그 카리시마 칼로 고마 이리 문지라삐리고 소풀매이로	그 칼 있으면 칼로 그냥이렇게 베어 버리고 부추처럼
그래각꼬언자 각꼬와서 쌀마무치노머 노랑내가 나요 거이 노랑내가	그래 가지고 인제 갖고 와서 삶아 무쳐 놓으면 노린내가 나요 그게 노린내가
마시 맏또 엄떠마 노랑내가 나	맛이 맛도 없더군 노린내가 나
그러믄 그 나무른 그 저 반차는 어째 해묵슴니꺼	그러면 그 나물은 그 저 반찬은 어떻게 해 먹습니까
구렁게 구굳또그만 지름장에 마 무치묵찌머 너물 너물매이로 해뭄서	그러니까 그것도 그냥 기름장에 마 무쳐 먹지 뭐 나물 나물처럼 해 먹으면서
그라먼인자 기새는 그래 하고예	그러면 인제 기새는 그렇게 하고요
곤달비는자 우째 따옴니까	곤달비는 인제 어떻게 따 옵니까
곤달비도고마 이리 뚝뚝	곤달비도 그냥 이렇게 뚝뚝
따먼 데요	따면 돼요
이파리를례	이파리를요
쭉때기를 쭉때이가	줄기를 줄기가
쭉때기를	줄기를
쭉때이가 즈즈 똑 호박쭉때이매로 익꺼등	줄기가 저 저 꼭 호박 줄기처럼 있거든
그리 커각꼳 그리 나니까 곤달비	그렇게 커 가지고 그렇게 나니까 곤달비
그라먼 곧 따가지고 그걷또 반찬	그러면 그것 따 가지고 그것도 반찬
고옫또 쌀마 데치각꼬 새파래스 즈즈즈 그슥 너물매로 그 머이고	그것도 삶아 데쳐 가지고 새파래 저 저 저 그슥 나물처럼 그 뭐니
치너물매로 마 물 펄펄 끼리각꼬 살짝 데치각꼬	취나물처럼 마 물 펄펄 끓여가지고 살짝 데쳐 가지고
고만 헹거각꼬 고옫또 머 무처뭄 데요 무치가 너물허능기라	그냥 헹궈 가지고그것도 뭐 무쳐 먹으면 돼요 무쳐서 나물하는 거야
햐 마식껟따	햐 맛있겠다
그래 곤달비는 차말로 조응기라요 너물중에 제일로 즈즏 고그비라 안하나	그래 곤달비는 참말로 좋은 거예요 나물 중에 제일로 저 저 고급이라 하잖아
궁게 지픈사네 가야데 그어는 지픈사네 가서	그러니까 깊은 산에 가야 돼 그것은 깊은 산에 가서
드러와	들어 와
언자 그라먼녜 이제버네는 치너물 차렘니더이	인제 그러면요 이번에는 취나물 차롑니다이
치너무른 우째 땀니까 우째	취나물은 어떻게 땁니까 어떻게
치너무른 캐 언자 뽈곰뽈곰나머	취나물은 캐 인제볼긋볼긋 나면
사머레 뽈곰뽈곰 나머 칼로각꼬언자	삼월에 볼긋볼긋 나면 칼로 가지고 인제
여 소게 뿌리이 나뚜고 칼로각꼬언자 이리이리 너물캐득끼	여 속에 뿌리 놓아 두고 칼을 가지고 인제 이리이리 나물 캐듯이
쑥꾸재미 캐득끼 막 캐지 쑥꾸재미 아능가 모르걷따	쑥구재미 캐듯이 막 캐지쑥구재미 아는가 모르겠다
쑥꾸재미	쑥구재미
쑥꾸재미너물또 익꺼등 여여엳 여 도랑에 막 익꺼등 봄데머 쑥캘때	쑥구재미나물도 있거든 여기 여기 여기 여기 도랑에 막 있거든 봄 되면 쑥 캘 때
쑥캘때	쑥 캘 때
쑥하고 쑥꾸재미하고 다릉김니까	쑥하고 쑥구재미하고 다른 것입니까
쑤근하모 저 색까리 허허이 막 그럭코 쑥꾸재미는언자 즈즏 치너물매로 새파래	쑥은 아무렴 저 색깔이 허연 게 막 그렇고 쑥구재미는 인제 저 저 취나물처럼 새파래
새파래 그 막 캐각꼬 보메 사암드리 캐각꼬 폴먼	새파래 그 막 캐 가지고 봄에 사람들이 캐 가지고 팔면
한사발 나노코 삼처넌 이처넌 할매드리 폴고 막 그러데	한 사발 놓아 놓고 삼천원 이천 원 할머니들이 팔고 막 그러데
그 체판땍집 살빠게고 저 미테 동네로	그 최참판댁집 대문 밖에고 저 밑에 동네로
그람 쑥꾸재미도 체참판때게 가모 이스까예	그러면 쑥구재미도 최참판댁에가면 있을까요
긍게 지그믄 처리 아니라 가꼬 읍서저비서 쑥꾸재미 그거이	그러니까 지금은철이 아니라서 없어져 버렸어 쑥구재미 그게
어어	아
딴때는 마 온천지 긴디 저 지레고 머이고 보메느 캘때느	딴 때는 마 온 천지 그것인데 저 길에고 뭐에고 봄에는 캘 때는
캘때는 깍 찬는디 지그믄 막 푸리 차비리고 해농께 암보이능기라	캘 때는 꽉 찼는데 지금은 막 풀이 차 버리고 해 놓으니까 안 보이는 거야
천지가 쑥꾸재민디	천지가 쑥구재민데
그라몬자 쑥꾸재미 우선 치너물 그거언자 아까	그러면 인제 쑥구재미 우선 취나물 그것 인제 아까
그거는 칼가꼬 미테 캔단 마리지예	그것은 칼 가지고 밑에 캔단 말이지요
예 캐 캐요	예 캐 캐요
쑥캐득끼 쑥꾸재미 캐득끼	쑥 캐듯이 쑥구재미 캐듯이
예 쑥도 그러고 쑥꾸재미도 그러고	예쑥도 그러고 쑥구재미도그러고
그라모 고거느 또 나무른 우째해 묵슴니까	그러면 그것은 또 나물은 어떻게 해먹습니까
쑥꾸재미요	쑥구재미요
말고 치너물	말고 취나물
치너물도 내낟 쑥꾸재미고 머이고 내나 맏 뜨신무레 데치각꼬 무치묵찌요 무치 무어	아 취나물도 내나 쑥구재미고 뭐고 내나 마 뜨신 물에 데쳐 가지고 무쳐 먹지요 무쳐 먹어
전시네 너물 종늉께	모두가 나물 종류니까
쌀마 무치무거	삶아 무쳐 먹어
쑥꾸저어 그렁거느 쌩걸로 몬뭉께 쌀마 무치묵꼬	쑥구재미 그런 것은 생걸로못 먹으니까 삶아 무쳐 먹고
그다메 깨치미라 캐씀니까 깨치미라캐씀니까	그 다음에 깨치미라고 했습니까 깨치미라고 했습니까
깨치미	고비
깨치미	고비
꼬사릳거치 까머이 그것도	고사리같이 까맣게 그것도
까머이 깨치미는 어째서 깨치미냐 허먿 요리 동글동글동글허이 즈즈 방석매이라요	까맣게 고비는 어째서 고비냐 하면 요렇게 동글동글동글하게 저 저 저 방석처럼이라요
대가리가 꼬사리대가리가 저 호방이파리매이로 죽때기	대가리가 고사리 대가리가저 호박 이파리처럼 줄기가
요리 쫑귿허이 이씀시로 요리 딱 쫑귿허이 커각꼬 우예 대가리가 동글동글동글허이 그리 생긷써 그래서 깨치미란다	요렇게 쫑긋하게 있으면서 요렇게 딱 쫑긋하게 커 가지고 위에 대가리가 동글동글동글하게 그렇게 생겼어 그래서 고비란다
그래가꼬 그 즈즈 지새 모시모 그걸 각꼬 그 지새 다마 노오먼	그래 가지고 그저 저 제사 모시면 그걸 가지고 그 제사 담아 놓으면
즈즈 기시니 금방서기랜데요 그 방석매이러 동글동글동글 그리 생기노옹께 금방석	저 저 귀신이 금방석이라한대요 그 방석처럼 동글동글동글 그렇게 생겨 놓으니까 금방석
금방서기랜데 조타한대 기시니	금방석이라 한대 좋다 한대 귀신이
그럼 그거는 우째 뜨더옴니까	그러면 그것은 어떻게 뜯어 옵니까
그거요 꼬사리매이러 내낟 툭툭 뿌질라오지 뿌링이에서 나아옹께	그것요 고사리처럼 내나 툭툭 분질러 오지 뿌리에서 나오니까
뿌링에서 쭝머대 요마허이 나옹께	뿌리에서 죽 뭣해 요만하게 나오니까
툭툭 뿌질라가 와요 고맏 뚝뚝 뿌질라오먼 데 꼬사리도 그러고	툭툭 분질러서와요 그냥 뚝뚝 분질러 오면 돼 고사리도 그렇고
뿌질라가 와서언잗 쌀맏 너지 쌀마각꼬 너르 너러낟따가언자	분질러서 와서인제 널지 삶아 가지고 널어 널어 놓았다가 인제
그걸 저그 머이고 거기 꼬사리보당 싸다 해꺼등 저네 도늘 사마 도늘 사마깨치미나 도니 작때	그걸 저기 뭐니 그게 고사리보다 싸다 했거든 전에 돈을 사면 돈을 사면 고비나고비가 돈이 적대
그라먼자 고거넌자 깨치미고	예 그러면 인제 그것은 인제 고비고
그너먼자 꼬사리도 그래 한다 마리지예	그러면 인제 고사리도 그렇게한다 말이죠
꼬사리도 즈즏 쭈리이 조걷매이로 뿌링이에서고만 쭘부쭘부낭께	고사리도 저저  저것처럼 뿌리에서 그냥 쫑긋쫑긋 나니까
지금 저 우예언잡 패비리서 그러치 언자 저를 때라 노옹께	지금 저 위에 인제파 버려서 그렇지 인제 캐 먹지 못할 때라 놓으니까
보메는 막 쫑그쫑그쫑귿허이 마 이삐기 올로오거등 모가지가	봄에는 막 쫑긋쫑긋쫑긋하게 예쁘게 올라오거든 모가지가
쭉 올로오머 톡톡톡 끄느머 재미읻찌	죽 올라오면 톡톡톡 끊으면 재미있지
보메하먼 오시먼 저거옏 여거 꼬사리가 이싱게로 딱 하먼 끄능낀디	봄에 한 번오시면 저기에 여기 고사리가 있으니까는 딱 한 번 끊을 건데
어제 봉께네 요기이습띠더 요	어제 보니까 요기 있습디다 요기에
하무 끄너보낑디 보이지요작꾸 나 소게 이써서 그러치	한 번 끊어 볼 건데 보이지요 자꾸 나 속에 있어서 그렇지
보식꾸나	아 보셨구나
그러믄자 그거는 깨치미처럼 고 쌀마가꼬	그러면 인제 그것은 고비처럼 고 삶아 가지고
꼬사리 예	예 고사리 예
말런다 그지예	말린다 그죠
몰랴가꼬 언자 돈사고 먿 또 몰랴낟따가 지새모시고 쌀마가꼬	말려 가지고 인제 팔러 가고 뭐 또 말려 놓았다가 제사 모시고 삶아 가지고
지새모시고이	제사 모시고이
하모 쌀만 몰랴야 나야지 무조꾼 몰랴나야대	아무렴 삶아 말려 놓아야지 무조건 말려 놓아야 돼
그라먼 돌가지는 우째	그러면 도라지는 어떻게
도라지도 캐다가	도라지도 캐다가
씨쩌 언자 무렏 씩꺼가꼬 사네서 캐오모 흐키 마느니까	씻어 인제 물에 씻어가지고 산에서 캐 오면 흙이 많으니까
바테 캐난 즈즏 사네 캐나 흐키 막 망커등뇨 흑바테서 캥께	밭에서 캐나 저저 산에서 캐나 흙이 막 많거든요 흙밭에서 캐니까
캐가와서언자 즈즏 막 이리리리 씩꺼가꼬 저런 즈즏 시민바다 시시시실언자 흑터러각꼬	캐 가지고 와서 인제 저 저 막 이리이리 씻어 가지고 저런 세멘트 바닥에실실실실 인제 흙 털어 가지고
인자 머 칼로도 까고 손툽 질머 손투브로가 마 졸졸졸졸 돌리머	인제 뭐 칼로도 까고 손톱 길면 손톱으로써 마 졸졸졸졸 돌리면
까저요 잘 까저 마구 캐가꼬 와서 흑떠러가꼬	까져요 잘 까져 마구 캐 가지고 와서 흙 떨어 가지고
그래 깨각꼬언잗 요리언자 칼로각꼬언잗 요리 쪼개각꼬	그렇게 째 가지고 인제요리 인제 칼로 가지고 인제 요렇게 쪼개 가지고
까지 쪼개득끼 쪼개각꼬언잗 비테 너러낟따가	가지 쪼개듯이 쪼개 가지고 인제볕에 널어 놓았다가
또 머 정가도 해묵꼬	또 뭐 정과도 해 먹고
거 조총 고와가꼬언잗 그 조총에다가 그 몰랴낟따가 도라지를	그 조청 고와 가지고 인제 그 조청에다가 그 말려 놓았다가 도라지를
언잗 까수나 머 냄비에나 그 여세언자 여세다 고모 쫄곧쫄곧허거등뇨 달착허니	인제 가스나 뭐 냄비에나 그 엿에 인제 엿에다 고면 쫄깃쫄깃하거든요 달착지근하게
긍 그걸 정 정가라고 저네 그래가꼬도 묵꼬	그러니까 그걸 정 정과라고 전에그래 가지고도 먹고
또 너무 몰랴낟따가 지금 사람드른	또 너무 말려 놓았다가 지금사람들은
저네는 지주 도라지를 그리 몰랴낟따가 저 너무를 해무꼬 핸는데 지그믄 바테다이녁바테다 시믕께로	전에는 죄다 도라지를 그리 말려 놨다가 저 나물을 해 먹고 했는데 지금은 밭에가 자지 밭에다 심으니까
서리고 추서기고 마구고마 이리 캐다가 내일 추서기몬 오늘캐다가 함바가지캐다가	설이고 추석이고 마구 그냥 이리 캐다가 내일 추석이면 오늘 캐다가 한 바가지캐다가
고마쌩걸로고마 소그메 쪼무락쪼무락해가꼬 쌩걸로 해무모 연허다고	그냥 생것을 그냥 소금에 쪼무락쪼무락 해 가지고 생것을 해 먹으면 연하다고
저 쌀마몰랴농께 찔기요 도라지너무리 찔기다고	저 삶아 말려 놓으니까 질겨요도라지 나물이 질기다고
지그믄 이녁바테다가 쪼깐씩 숭군께로 고만 캐다가 내일 물꺼그트모 오늘캐다가	지금은 자기 밭에다가 조금씩 심으니까 그냥 캐다가 내일 먹을 거 같으면 오늘캐다가
마 베끼가꼬 시쳐가꼬 베끼가꼬 쪼개가꼬고마 너물로뽀까 뭉는기라요 요새는	뭐벗겨 가지고 씻어 가지고 볏거 가지고 쪼개 가지고 그냥 나물을 볶아 먹는거예요 요새는
도라지를 이녁바테 숭군다캐씀니까	음 도라지를 이녁 밭에 심는다고 했습니까
하모 이녁바테 숭구요	아무렴 이녁 밭에 심어요
이녁바티 어떤바침니까 누구 받	이녁 밭이 어떤 밭입니까 누구 밭
내바테	내 밭에
그걸 이녁바치라 그럼니까	그걸 이녁 밭이라 그럽니까
상대방 바치아니고 내 바틀 이녁바치라 그람니까	상대방 밭이 아니고 내 밭을 이녁 밭이라 그럽니까
그람 상대방 바튼 머라캄니까	그럼 상대방 밭은 뭐라고 합니까
너무 바치라그러지	남의 밭이라 그러지
너무바치라 그러고 우리바츤 마 우리바치라 허는디	남의 밭이라 그러고 우리 밭은 뭐 우리 밭이라 하는데
이녁바츤언자 또이리 이약허다가 보머	이녁 밭은 인제 또 이리 이야기하다가 보면
이녁 바테느 그러고그러지 우리가 이야글 허면서	이녁 밭에는 그러고 그러지 우리가 이야기를 하면서
이녁바테카몬 내바치다 그지예	이녁 밭에하면 내 밭이다 그죠
흐어내밭에	응내 밭에
이녁 바츤 그소리 씨거든	이녁 밭은 그 소리 쓰거든
그다믄자 도라지도 언자 나물 해무꼬	그다음 인제 도라지도 인제 나물 해 먹었고
아따 마이 무따 더더근 우찌함니까	아따 많이 먹었다 더덕은 어찌 합니까
더더근 언자 사네서 캐다가 또흑떠러서언자 손토브로고마 손토브로카덩가 머 칼로가덩가	더덕은 인제 산에서 캐다가 또 흙 떨어서 인제 손톱으로 그냥 손톱으로써하든가 뭐 칼로써 하든가
껍띠기 졸졸졸졸 베끼지거등요 잘까져요 더더근 더 잘까져	껍질 졸졸졸졸 벗겨 지거든요 잘 까져요 더덕은 더 잘 까져
그래가꼬언자머 소느로도 찍꼬 잘 찌저지머	그래 가지고 인제 뭐 손으로도 찢고잘 찢어지면
도라지도 도라지매이로막 칼로도 찍꼬 그래가꼬	도라지도 도라지처럼 막 칼로도찢고 그래 가지고
꼬이장에다가언잗 폭인잗 파무더나요 파버더노먼 밸거래	고추장에다가 인제폭 인제 파묻어 놔요 파묻어 놓으면 빨개
그 더더기 장아치가 데 장아치가 데 뺄거리	그 더덕이 장아치가 돼 장아치가돼 빨갛게
그래언자 꼬이장 요리 들씨고 요리 직까래이나먿 한짇까락 찌거서언자 접씨예다마서언자 밥쌍에 언저노몬언자또 묵꼬 묵꼬	그래 인제 고추장 요리 들추고 요리젓가락이나 뭐 한 젓가락 찍어서 인제 접시에 담아서 인제 밥상에 얹어 놓으면 인제또 먹고 먹고
꼬이장에도 허고 또 잔치허믄 마 그 더덕 그귿 탁탁탁언자귿	고추장에도 하고 또잔치하면 마 그 더덕 그것 탁 탁 탁 인제 그
그리막 해가꼬 납짝허이 콕콕콕콕 찌가꼬 살살 찌가꼬	그리 막 해 가지고 납작하게 콕콕콕콕 찧어 가지고 살살 찧어 가지고
오이소	아 오이소
찌가꼬 즈즈 꼬이장요리요리요리 볼라가꼬	찧어 가지고 저 저 고추장 요리 요리요리 발라 가지고
꼬이장 볼라가꼬또막 꾸가꼬 꾸가꼬 그래가꼬 수란주도허고 막 그러데요	고추장 발라 가지고 또 막 구워 가지고 구워 가지고 그래 가지고 술 안주고 하고 막 그러데요
언자 그라믄자 수러치가 남앋꺼든녜	예 인제 그러면 인제 수리취가 남았거든요
수러지	수리취
수러치도 내나그그 떠개뭉는기라고	수리취도 내나 그것 떡해 먹는 거라고
몰랴낟따가 쌩걸로 뜨더다가 몰랴낟따가	말려 놨다가 생것을 뜯어다가 말려 놨다가
뜬능거는 이파리를 뜬는 거네	뜯는 거는 이파리를 뜯는 거네
이파라요내나 쭉때기가익꼬 저 호방이파림 쭉때이매이로 질쭉허이 나거든	예 이파리에요 내나 줄기가 있고 저 호박 이파리 줄기처럼 길쭉하게 나거든
쭉때기예서 이피 치너물매이로 낭께	줄기에서 잎이 취나물처럼 나니까
그어마 뚝뚝 뜨더다가 비깁 요요리 대이다가 바테 사네 대이다가보몬 저네사네 대이때	그거 뭐 뚝뚝 뜯어다가  요리 요리 다니다가 밭에 산에 다니다가보면 전에 산에 다닐 때
마 뜨더가꼬 와서 인잗 쌩걸로 몰랴낟따가 떠개무굴쩌게 포옥 쌀마가꼬	뭐 뜯어 가지고 와서 인제 생것을 말려 놨다가 떡 해 먹을 적에 폭 삶아 가지고
좀 우라가꼬 하나저나 우라가꼬 그어머 방앋까네 가먼 머 찹쌀가 떡해중께 찹쌀로 가꼬	좀 우려 가지고 한나절이나 우려 가지고 그래 뭐 방앗간에 가면 뭐 찹살로떡 해 주니까 찹쌀을 가지고
이녁찌베 앙가가먼막 고마 자기들 쌀고마 당가가꼬 떠글해주고	자기 집이 안 가져 가면 막 그냥 자기들떡방앗간 집 쌀 그냥 담아 가지고 떡을 해주고
콩가가모 콩꼬모해주고	콩 가져 가면 콩고물 해 주고
할무이예	할머니요
저 쪼끔 다른얘긴데예	저 조금 다른 얘긴데요
옌나레 성냥업서쓸 때	옛날에 성냥 없었을 때에
쑥뿔 쑥뿔	쑥불 쑬불
그때 연게 수러치아니엳씀니까 쑤글 엳슴니까 수러치	그때 넣은 게 수리취 아니였습니까 쑥을 넣었습니까
쑥 쑹녀테	쑥 쑥 넣데
수러치 안엳씀니까	수리취 안 넣었습니까
하라씨 수리치도 여 연능가 모리지 저저 하라씨들 보문	할아버지 수리치도 넣었는가 모르지 저저 할아머지들 보면
그걸막 바짝 몰랴가꼬 쑤글 쑤글 바짝 몰랴낟따가 이리 비비 보드락끼	그걸막 바짝 몰려 가지고 쑥을 쑥을 바짝 말려 놨다가 이리 비벼 보드랍게
보드락끼막 소네다 비비가꼬 쩨깬쓱 비비가꼬 그 도레다가	보르랍게 손에다 비벼 가지고 조금씩 비겨 가지고 그 돌에다가
도레다 그 하라씨드리 쑥허고 이 착 머시 기리데	돌에다 그 할아버지들이 쑥하고 이 착 뭘 그리데
그래가 부리나 부리나가가꼬언자 부를 피우고	그래서 불이 나 불이 나 불이 나가지 가지고 인제 불을 피우고
그래 그래싿테 하라씨들 봉께	그래 그래 쌓대 할아버지들 보니까
게서 동 다른 동네가믄인제 이 수러치를가꼬 쑥매이로	그래서 동 다른 동네 가면 인제 이 수리취를 가지고 쑥처럼
아 그래하덩가요	어그래 하던가요
요래 착 불로케거든녜	요래 착 불을 켜거든요
예 그래서 요동네도 그랜나 시퍼서 여쭤봉김니다	예 그래서 요 동네도 그랬나 싶어서 여쭤 본 겁니다
그래핸능가도 모리지 난 쑥허능건만 받찌	그래 했는가도 모르지 난 쑥 하는 것만 봤지
잘 아랃씀니더이	예 잘 알았습니다이
그다음인자 요 지여게서 나는 산나물도인자	그 다음 인제 요 지역에서 나는 산나물도 인제
뜨더오가꼬 반찬해뭉는걷또 다 아랃씀니더이	뜯어 와 가지고 반찬 해 먹는 것도다 알았습니다이
아따 마식께 묻따	아따 맛있게 먹었다
언자는녜 음	인제는요 음
내나 그래 무	내나 그렇게 먹어
그 머 사니라기뽀단 들	그 뭐 산이라기 보단 들
아깐주로 사니고 물론이제 드라고 쫌머 갭치는걷또쪼끔 이낀이씀낌니다	아깐 주로 산이고 물론 이제 들하고 쫌 뭐 겹치는 것도 조금 있긴 있을 겁니다
드레서는 어떤 나물드리남니꺼	들에서는 어떤 나물들이 납니까
드레서는 저저 방애재비라고 저네	들에서는 저저 방아잡이라고 전에
저네는 무께 업씽께 방애라고 동그람허이 또 너무리 이써요	전에는 먹을 게없으니까 방아라고 동그랗게 또 나물이 있어요
아까그거 머머 선생니미 머 찯떠라 머 찯득끼	아까 그거 뭐뭐 선생님이 뭐 찾더라 뭐 찾듯이
너물 이리미 저 방애 그거십 보리뱅이보리뱅이	나물 이름이 저 방아 그 거슥 보리뱅이 보리뱅이
방애가아이고	방아가 아니고
하아 보리뱅이 보리뱅이 너무리 익꺼  등뇨	응 보리뱅이 보리뱅이 나물이 있거든요
그걸 호매이로가꼬 뿌리이채 칵 쪼사가꼬 쭈욱 뿌리이르 빼야대 그거느	그걸 호미를 가지고 뿌리째 칵 찧어 가지고 쭉 뿌리를 빼야 돼 그거는
잘빠저요 노닝께 논뚜루게 막 저무디미가머 막 저네 마이 이썩꺼등	잘 빠져요논이니까 논두둑에 막 저 무디미에 가면 전에 많이 있었거든
그럼	음 그럼
보리뱅이 그걸 막 한소쿠리해가꼬 그때는 무끼 엄싱께보리밥해가꼬 막	보리뱅이 그걸 막 한 소쿠리 해 가지고 그 때는 먹을 게 없으니까보리밥 해 가지고 막
보리뱅이 그걸막 한소쿠리석 사람들마둥 가가꼬 정때로 가가꼬 마 빼가와서	보리뱅이 그걸 막 한 소쿠리씩 사람들마다 가 가지고 저녁 때 가 가지고 뭐 빼 가지고와서
쌔비릳꺼등 저 무디미 가머 캐가꼬와서언자 이 막 끈니파리언자 뜨더내비리고개리가꼬 한소쿠리 해와서	널려 버렸거든 저 무디미 가면 캐 가지고 와서 인제 이막 겉 이파리 인제 뜯어 내 버리고 가려 가지고 한 소쿠리 해 와서
엳 쌀마 저 펄펄 끼리가꼬 물끼리가꼬언잗 이 머시매이로 무주꾼언자 쌈능기지언잗	인제 삶아 저 펄펄 끓여 가지고 물 끓여 가지고 인제 이 무엇처럼 무조건 인제삶는 거지 인제
파랑너무링께 너무링께 쌀마가꼬언잗 덴장 덴장그걸가 쪼무라쪼무락 묻찌요 쌀마묻치가꼬	파랑 나물이니까 나물이니까 삶아 가지고 인제 된장 된장 그걸 가지고쪼물락쪼물락 무치지요 삶아 무쳐 가지고
쌀마가꼬 즈즈즈 치너물매이로 무치	삶아 가지고 처처처 취나물처럼 무쳐
그래가꼬 덴장거게 치너물도 덴장에쪼깬 주무리믄 또 마싣떼 장에만 해묵따가	그래 가지고 된장 거기에 취나물도 된장에 조금 주무르면 맛있데 장에만 해 먹다가
덴장에다가 주무리무거	된장에다가 주물러 먹어
그람할머이 우선녜	예 그럼 할머니 우선요
에 요걷또인자그거종뉴부터먼저 아라보고예	에 요것도 인제 그거 종류부터 먼저 알아 보고요
그라먼자 보리뱅이읻꼬	그럼 인제 보리행이 있고
보리뱅이	보리뱅이
그담 또 드레서 나는너무레 또 머가읻씀니까	그 다음 또 들에서 나는 나물에 또 뭐가 있습니까
그 드레도 저네 쑥꾸재미도캐고 미나리도캐고 미나리	그 들에도 전에 쑥구재미도 캐고 미나리도 캐고 미나리
미나리너물 그걷또내나 쌀마무치묵꼬 초점지가꼬	미나리 나물 그것도 내나 삶아무쳐 먹고 초장 쳐 가지고
초 지가꼬 무치문사람무치묵꼬 그양	초장 쳐 가지고 무쳐 먹는 사람 무쳐 먹고그냥
쑥또 캐쓸끼고이	쑥도 캤을 것이고이
쑥또 더 익꼬 논뚜러게	쑥도 더있고 논두둑에
그다메 아까	그 다음에 아까
쑥 쑥꾸재미도 익꼬마	쑥 쑥꾸재미도 있고뭐
고들빼기는	고들빼기는
고들빼이느 여 바테 요런 데 읻찌	고들빼기는 여기 밭에 요런 데 있지
받또 드리니까	밭도 들이니까
예예	예 예
머라캐씀니까	뭐라고했습니까
고들빼이 고들빼이	고들빼기 고들빼기
아까 와 선생니미 이기 머이냐허데	아까 왜 선생님이 이게 뭐냐 하데
그이 고들빼이라	그게 고들빼기야
고들빼이고	고들빼기고
그다메 그거는 업섣씀니까 민들레 머	그 다음에 그거는 없었습니까 민들레뭐
민들레 읻찌요	민들레 있지요
거 민들레라 캐씀니까 머라캐씀니까 여게서	그거 민들레라고 했습니까 뭐라고 했습니까 여기에서
민들레 우리도	민들레 우리도
민들레도 익꼬 저저 하라씨들 맫뚱 어디 맫뚱에	민들레도 있고 저저 할아버지들 묫등 묫등에
할미꼳또익꼬마	할미꽃도 있고 뭐
할미꼳또 반찬함니까	할미꽃도 반찬 합니까
어디 기양마	어디 그냥 뭐
아니고 저기 반찬하능거	아니고 저기 반찬하는 것
어어	응
그다메	그 다음에
그 아까 나시래이라 캐씀니까 나숭개라 캐씀니까 이 동네 쓰던 말로	그 아까 나시랭이라고 했습니까 나숭개라고 했습니까이 동네 쓰던 말로
나 나숭개	나 나숭개
나 아까 방아 방아 보리뱅이	나 아까 방아 방아 보리뱅이
보리배이도 익꼬 나숭개라고 익꺼등또	보리뱅이도 있고 나숭개라고 있거든 또
푸리	풀이
우선언자 종뉴를 말함니더이	우선 인제 종류를 말합니다이
그 다메	그 다음에
그 비르미라꼬 업섣씀니까	그 비름이라고 없었습니까
비림도막 해묵떼요우리드른 아내무박꼬마는	비름도 막 해 먹데요 우리들은 안 해 먹어 봤구만
부사는 사 뭉는데요 그걸	부산은 사 먹는데요 그걸
그어 막 뜨더가고 그래 할매드리 즈즈즈 어디서 도헤지사람드리 오머 조타고	그것 막 뜯어 가고 그래 할머니들이 저 저 저 어디서 도회지 사람들이 오면 좋다고
그라믄 그거는 업섣씀니까 저기 그 달롱개라능거는 업섣씀니까	그러면 그거는없었습니까 저기 그 달래라는 것은 없었습니까
달롱개 이써요 바테 직쩜숭구가꼬 지금 포는디	달래 있어요 밭에 각자 심어 가지고 지금 파는데
또 어떵기 이써스꼬예 여기 이 씀바기 이렁건 업섣씀니까	또 어떤 게 있었을까요여기 이 씀바귀 이런 건 없었습니까
씀바기도 익꼬	씀바귀도 있고
씀바기도 캐다 폴고 머 밸걸다 캐다포라 바테다 해가꼬	씀바귀도 캐다 팔고 뭐별 걸 다 캐어다 팔아 밭에다가 해 가지고
그람 요렁 쪽 또 종뉴가 더 생각나시면 말씀해주시고예	그럼 요런 쪽 또 종류가더 생각나시면 말씀해 주시고요
돈너물	돌나물
돈너무라고 도레 도레 또 자잘허이 막 밥티매이로 엥기가꼬 커요	돌나물이라고 돌에 돌에 또 자잘하게 막 밥알처럼 엉겨 가지고 커요
크먼 그거르언자 보무로 할매드리 또 참 그걷또 막 뜨들라모 이리 마나	크면그거것을 인제 봄으로 할머니들이 또 참 그것도 막 뜯으려면 일이 많아
막 이리 거머가꼬막 이리이리이리 뜨더가꼬 풀조창 해가꼬 와서 항개쓱 항개쓱그 포릳때가리가틍걸	막 이리 검어 가지고 막 이리 이리 이리 뜯어 가지고 풀조차해 가지고 와서 하나씩 하나씩 그 파리 대가리 같은 걸
이자 칼로가꼬 싸악인자 조케해야 사가니까로 손님드리	인제 칼을 가지고 싸악  인제 좋게 해야 사가니까 손님들이
그리 따드머가꼬언자 이리 한사발썩해노코 머 이처넌삼처넌 그리 포데 우리드리야 머 그렁거 머 안해받찌만	그리 다듬어 가지고 인제 이리 한 사발씩 해 놓고 뭐이천 원 삼천 원 그리 팔데 우리들이야 뭐 그런 것 안 해 봤지만
돈너물 바테가먼 또 돈너물익꼬	돌나물 밭에 가면 또 돌나물 있고
금또 돈너물 말고 또 어떵기 또 이써쓸꼬예 드리나 바테서 나능거 나물례	그러면 또 돌나물 말고 또 어떤 게 또 있었을까요 들이나 밭에서 나는 거 나물요
그렁께 내나 구런종뉴지머	그러니까 내나 그런 종류지 뭐
그라믄 또 생각나면 말씀 더 해 주시고	예 그러면 또 생각나면 말씀 더 해 주시고
언자는녜	인제는요
요고 가지고 또 우째 뜬능가 또머 일부는 말쓰믈 미리 해주셛씀니다마는 저 하먼더 여쭈어보께예	요것 가지고 또 어떻게 뜯는가 또 뭐 일부는 말씀을 미리 해 주셨습니다마는 저 한 번 더 여쭈어 볼게요
먼저 아까 보리뱅이라능거	먼저 아까 보리뱅이라는 거
그거는 호매이 호미각꼬 캐고	그거는 호맹이 호미 갖고 캐고
이 보리뱅이가 머하고 요아까 말씀하신걷쭝에서 머하고젤 달맏씀니까 나숭개하고 달맏씀니까 보리뱅이가	이 보리뱅이가 뭐하고 요 아까 말씀하신 것 중에서 뭐하고 제일 닮았습니까 냉이하고 닮았습니까 보리뱅이가
나숭개 하모하모 고만 도리뱅뱅허이 나숭개도 도리뱅뱅헝께	냉이 아무렴 아무렴 그냥 도리뱅뱅하니 냉이도 도리뱅뱅하니까
보리뱅이가 나숭개하고 쫌 달맏씀니까	음 보리뱅이가 냉이하고 좀 닮았습니까
그라모 보리뱅이는 우째 뜨더옴니까	그러면 보리뱅이는 어떻게 뜯어 옵니까
호매이로각꼬 파온당께 뿌리이를 뿌리이조차	호미를 가지고 파 온다니까 뿌리를 뿌리조차
뿌리이	뿌리
쭈욱 뿌리이조차 캐와야대 그거느 이파리 뜨드모고마 안뎅께	쭉 뿌리조차 캐와야 돼 그것은 이파리 뜯으면 그냥 안 되니까
뿌리이를 뿌리가 마싣씅께로 으으	뿌리를 뿌리가 맛있으니까 응
그라몬 캐왁꼬 씨꺼가꼬언자 씨처가저고	그러면 캐 와 가지고 씻어 가지고 인제 씻어 가지고
고망 해 한소쿠리마 무조껀캐가꼬 와서 그망이제 따드마가꼬 조키	그냥 해 한 소쿠리 뭐 무조건 캐 가지고 와서 그만 이제 다듬어 가지고 좋게
뿌링이막 터리막 주룽주룽주룽 이씽께로 칼로가꼬막 이리 극꼬 지즈 따드머가꼬	뿌리 막 털이 막 주룽 주룽 주룽 있으니까 칼을 가지고 막 이리 긁고 저 저 다듬어 가지고
터리 그기막 망커등뇨 저저 뿌리조창 캐오머 그렁께로 막	털이 그게 막 많거든요 저저 뿌리조차 캐 오면 그러니까 막
싹 그걸 한나쓱또 다 따므마야대 이리 마나 그래묵꼬 사능기 모두 머이라도 그래각꼬	싹 그걸 하나씩 또 다 다듬어야 돼 일이 많아 그래 먹고 사는 게 모두 뭣이라도 그래 가지고
따드마각꼬 한소쿠리 캐와서 따드마가꼬	다듬어 가지고 한 소쿠리 캐 와서 다듬어 가지고
쌀마묻 쌀마각꼬 덴장에 주무리가꼬인자 그래가꼬 무꼬	삶아 무쳐 삶아 가지고된장에 주물러 가지고 인제 그래 가지고 먹고
그리허믄 또 그걷또 기양 갠차네요 한때는 마싣써	그리하면 또 그것도 그냥 괜찮아요 한 때는 맛있어
아까 미나리얘기는 압 아페서아까 드럭꼬예	예 아까 미나리 얘기는 앞 앞에서 아까 들었고요
미나	예 미나
그다메언자	그 다음에 인제
쑥꾸잼미도 아까 우에서 드럭꼬예	쑥꾸재미도 아까 위에서 들었고요
마 쑥이야기도 드럭꼬	뭐 쑥 이야기도 들었고
인자 고들빼김니더이	인제 고들빼기입니다이
고들빼이 요거는 우째 캐가꼬 우째 반찬해묵씀니까	고들빼기 요것은 어떻게 캐가지고 어찌 반찬 해 먹습니까
그걷또 아까 그그리 읻찌요 바테	그것도 아까그 그리 있지요 밭에
바테이씨머언자 호매이로각꼬 칵 뿌리이르 파아대 그걷또 뿌리이르 뭉께	밭에 있으면 인제 호미를 가지고 칵 뿌리를 파야 돼 그것도 뿌리를 먹으니까
뿌리를 파가꼬 인자 전니파리뜨더비리고 또 이리 뿌리이 그걷또막 가재이가찍찡나서막 트레이기 잔트레기 마느니까	뿌리를 파 가지고 인제 전잎 뜯어 버리고또 이리 뿌리 그것도 막 가지가 찍찍 나서 막 털이 잔털이 많으니까
싹잔트럭고마 뜨더비리고	싹 잔털 그냥 뜯어 버리고
막 뿌리이가 나중막 가을대믄 요막쓱 저기 요막쓱막 뿌리이가 생기거든뇨	막 뿌리가 나중 막 가을대면 요만큼씩 저기 요만큼씩 막 뿌리가 생기거든요
국끼 생기 생기머언자 뿌리이 그너미 마싣써 무시뿌리이매이로 짐치 다마노모	굵게 생겨 생기면 인제 뿌리 그놈이 맛있어 무 뿌리처럼 김치 담아 놓으면
입싸구보당 그래가꼬언자막 패여코	입사귀보다 그래 가지고 인제 막 파 넣고
인자 그 소금무레다가 소금 쪼깬 푸러가꼬 소금무레다가 톡 당가노먼 한이틀 당가 노머	인제 그 소금물에다가 소금 조금 풀어 가지고 소금물에다가 톡 담가 놓으면 한 이틀 담가 놓으면
노러이언자 똗 그걷또 사가저요	노랗게 인제 또 그것도 삭아져요
그러머인자 그거인자 헹거가꼬마 양님장해가꼬언잗 무치가꼬언잗	그러면 인제 그거 인제 헹궈 가지고 뭐 양념장 해 가지고 인제 무쳐 가지고 인제
짐치 짐치르언자 맨드러가꼬언잔 냉장고예 여노코언자 무꼬 지그믄 그러지	김치 김치를 인제 만들어 가지고 인제 냉장고에 넣어 놓고 인제먹고 지금은 그러지
고들빼기 그거	고들빼기 그거
뿌리이르	뿌리를
뿌리이르	예 뿌리를
짐치당글꺼 아임니꺼	김치 담글 거잖습니까
짐치당거	예 김치 담가
그러믄 그거는	그러면 그거는
할머이말씀대로 하메는  음	음
가시레 이게 굴따멘서예	가을에 이게굵다면서요
하모 가으레 인자 저 낭께	아무렴 가을에 인제 저 나니까
씨가	씨가
아니 보메나능거 아임니까 볼래는	아니 봄에 나는 거 아닙니까본래는
보메꺼는 꼬치피비리고 그기 내낟	봄의 것은 꽃이 펴 버리고 그게 내나
지금 가으레 나는 그기 보메 이꺼등뇨	지금 가을에 나는 그게 봄에 있거든요
그렁께 꼬치피서 동이 이리그마 동이 올라비리먼 몬써 맏 몬뭉능기라	그러니까꽃이 펴서 동이 이리 그만 동이 올라 버리면 못 써 못 먹는거야
동이오른다능거는 멈니까	동이 오른다는 거는 뭡니까
그 즈즈 오래 무긍기라농께 새로언자 설시고 나리따시먼 사머레	그 저저 오래묵은 것이라 놓으니까 새로 인제 설 쇠고 날이 따뜻하면 삼월에
나그등뇨 다시 줃따가 삼동에 긍게 요새 나능기 이자 가으레 해야 새기지	나거든요 다시 죽었다가 삼동에 그러니까 요새 나는 게 인제 가을에 해야 새 거지
가으레 무거야 새기지 언자 저나능거 저기	가을에 먹어야 새 거지 인제 저 나는거 저게
저기인자또 삼동에 주거각꼬 후년보베 따시믄 또 나요	저게 인제 또 삼동에 죽어가지고 내년 봄에 따뜻하면 또 나요
저리 올라와 올라오머언자 또 사람드리막	저리 올라 와 올라 오면 인제 또 사람들이 막
또 캐다가 보메 쑥꾸재이 폴고 막	또 캐다가 봄에 쑥꾸재미 팔고 막
쑥볼곰서로 캐다 포라요 할매드리 다라이 쩨깨난 다라이다 해노코 삼처넌 이처넌막	면서 캐다 팔아요 할머니들이 다라이 조그만 다라이에다 해 놓고 삼천 원이천 원 막
망마니큳 쪼강 큰다라이는막 오처넌 그래가 폴거든	막 많이 큰 조금 큰 다라이는 막 오천 원 그래 가지고 팔거든
캐다포라 그리고인잗 자꾸언잗	캐다 팔아 그리고 인제 자꾸 인제
나리가모언자 고마 그기 동이 올라비리믄언자 몬포능기라	날이 가면 인제 그냥그게 동이 올라 버리면 인제 못 파는 거야
동이 동이	동이 동이
동 동이 오른다능건 이기 쭉까고 쭉때기 가튼	동 동이 오른다는 건 이게  줄기 같은
동이 올라 쭉때기	예 동이 올라 줄기
쭉때기	줄기
가운데	가운데
가운데	가운데
쭉 올라와가꼬 꼬치피요	쭉 올라 와 가지고 꽃이 펴요
꼬치피가꼬 저기 꼭 그기 요리요리요리 바라메 흔들리가꼬	꽃이 펴 가지고 저게꽃 그게 요리 요리 요리 바람에 흔들려 가지고
온 전시네 나요 전부다 온천지이라	온 전신에 나요 전부 다 온 천지예요
내가 매비리서 그러치 풀맴서 파비리서 그러치	내가 매 버려서 그렇지 풀 매면서 파 버려서 그렇지
씨를 씨가 익끼땀세 동그기 올라가꼬 꼬치 피가꼬	씨를 씨가 있기 때문에 동그게 올라 가지고 꽃이 펴 가지고
씨가 항정엄써요	씨가 한정없어요
그래가꼬마 온 전시네 지대로언자 이리이리 바래미 불머 마니 이거노머 가으레이거노머	그래 가지고 뭐 온 전신에 제대로 인제 이리 이리 바람이 불면 많이 익어놓으면 가을에 익어 놓으면
씨가막 뿌리지능기라 그래덥또아나고 갈도아내도 지질로 저리자꾸나	씨가 막 뿌려지는 거야 그래 덮지도 안 하고 갈지도 안 해도 저절로 저리 자꾸 나
고드빼이 저거느 니바테라도 그래가꼬 고들빼이 풀만 매주모 고만 뎅께네	고들빼기 저거는 누구 밭에라도 그래 가지고 고들빼기 풀만 매 주면 그냥 되니까
그래가꼬 다마무거요 고들빼이 조아란사라믄 참 조아라하더만	그래 가지고 담아 먹어요 고들빼기 좋아라 하는 사람은 참 좋아라 하더만
할머이 저기	할머니 저기
아까 호박가틍걷드도 쭉때기라 그랟따임니꺼이	아까 호박같은 것들도 죽대기라 그랬잖습니까
그인제	그 인제
내가막 호박쭉때이 고마나 헌단소리가 보통고만 그러지	내가 막 호박 쭉대기 그냥 내 한다는 소리가 보통 그냥 그러지
그런 근데 호바근 쭉때긴데	그런 그런데 호박은 죽대기인데
고들빼이는 지금 머냐며는인자 동이라 그랟꺼든녜	고들빼기는 지금 뭐냐면 인제 동이라고 그랬거든요
고들빼이동 고들빼이 동이 올라 몬씨걷따 그러고 그러거든	고들빼기 동 고들빼기 동이 올라 못 쓰겠다 그러고 그러거든
그렁까 동하고 쭉때기는 우째다름니까 좀다를 좀 다를꺼 거태예	그러니까 동하고 죽대기는 어떻게 다릅니까 좀 다를 좀 다를 거 같아요
그렁께 제가 제 득끼로는	그러니까 제가 제 듣기로는
쭉때기는함분만 쭉 올라오믄 이파리 생기능기 죽 쭉때기고	죽대기는 한 번만 쭉 올라 오면이파리 생기는 게 죽대기고
동은 이거 요 오다가 또 파고 또 올라가고 또 요 나고 이렁거 아임니까 혹씨	동은 이거 요 오다가 또 파고 또 올라가고 또 요 나고 이런 거 아닙니까 혹시
그래 안허고 고만 이 가운데가 고들빼이 저기	그렇게 안 하고 그냥 이 가운데가 고들빼기 저게
항가운데가 저기인자 가으레 페믄 갠차는디	한가운데가 저게 인제 가을에 피면괜찮은데
이자 올해올해 씨가 떠러지가꼬 저 낟씽께 가으레언자 캐 짐치다마묵꺼등뇨 근디언자	인제 올해 올해 씨가 떨어져 가지고 저 놨으니까 인제 캐 김치 담가 먹거든요 근데 인제
그걸 온 바테 그걸 다 몬캐뭉께	그걸 온 밭에 그걸 다 못 캐 먹으니까
어찌해도 낭꺼든 고들빼이 저기 나믕께이자	어찌해도 남거든 고들빼기 저게남으니까 인제
막 이리 커가꼬 넙쩍허이 커가꼬 세가꼬	막 이리 커 가지고 넙적하게 커 가지고 쇠어 가지고
이자 게우레 주거가꼬 추웅께 이자 따시믄 새로 또 사라나요	인제 겨울에 죽어가지고 추우니까 인제 따뜻하면 새로 또 살아나요
사라나먼인자 그걸캐다가 또 설 시고인자 동그기 안오리니께로	살아 나면 인제그걸 캐다가 또 설 쉬고 인제 동 그게 안 오르니까는
그가운데막 동이 요러케 올라와요 나중 사월따리 데머 사머리 데머	그 가운데막 동이 요렇게 올라와요 나중 사월달이 되면 삼월이 되면
막 그래가꼬언잗 그러믄 그기그막 꼬치 데비리 꼬치	막 그래 가지고 인제 그러면그게 그 막 꽃이 돼 버려 꽃이
그러믄 동이 올라오먼 동 요쪼근 이피 도다나지예	그러면 동이 올라오면 동 요쪽은 잎이 돋아나지요
하모 막 이리저리 막	아무렴 막 이리저리 막
그렁께미테 처으메 요요 이파리가 인는데	그러니까 밑에 처음에 요요 이파리가있는데
하모 저그예 인는데	아무렴 저기에 있는데
동이 올라오더라도 여페이파리가 또 붇찌예	동이 올라오더라도 옆에 이파리가 또 붙지요
막 요리	예 막 요리
요리막 올라와	요리 막 올라와
그렁께 동이 올라오고 여프로 이파리 또 안생김니까 이파리는	그러니까 동이 올라오고 옆으로 이파리 또 안 생깁니까
하모 생기지	아무렴 생기지
생기지예	생기지요
생기가꼬 막 꼬츨막 여러 가재이가 꼬치 데능기라	생겨 가지고 막 꽃을 막 여러 가지가 꽃이 되는 거야
꼬치대가고 그게 여러 가재이가 씨가 데요	꽃이 돼 가고 그게 여러 가지가씨가 돼요
그렁께로 저리 자꾸 온전시네 머 나라댕기가꼬	그러니까 저리 자꾸 온 전신에뭐 날아 다녀 가지고
나라가꼬마 지질로 나능기라 고들빼이는 한나무만 이써도	날아 가지고 뭐 저절로 나는 거야 고들빼기는 한 나무만 있어도
그래가꼬언자 고들빼이	그래 가지고 인제 고들빼기
그라믄녜	그러면요
아까 저 보메도 캐묵꼬그라몬 가으레도 캐묵꼬 이람니까 그 고들빼기를	아까저 봄에도 캐 먹고 그러면 카을에도 캐 먹고 이럽니까 그 고들빼기를
설씨고도 캐뭉께 설시고도	설 쇠고도 캐 먹으니까 설 쇠고도
그라몬 운제캐뭉는기 그 가으레 캐난 고들빼기말고	그러면 언제 캐 먹는 게 그 가을에 캐 놓은고들빼기 말고
요새허능기 조치인자 가으레 가으레	요새 하는 게 좋지 인제 가을에 가을에
가으레허능기 진짜배기지인자 새걸 캐뭉께	가을에 하는 게 진짜배기지 인제 새걸 캐 먹으니까
그러몬 보메캐뭉는거는 지난버네 나믕기	그러면 봄에 캐 먹는 거는 지난 번에남은 게
하모요	아무렴요
동이 올라와 동이 올라오가지고 또 캐뭉는김니까	동이 올라와 동이 동라 와 가지고 또 캐 먹는 겁니까
동이인자 안올라 와서언자 캐묵꼬 동이오리모인자 갇따 몬포능기라 사람드리안사강께	동이 인제 안 올라와서 인제 캐 먹고 동이 오르면 인제 갖다 못 파는 거야사람들이 안 사가니까
그러몬 동이 올라오메는 그때는 뿌리이 거 캐메는 그기 벨로 가치가 업따	그러면 동이 올라오면 그때는 뿌리 그거 캐면 그게 별로 가치가 없다
몬써요 몬써	못 써요 못 써
꼬쟁키가 대비리 뿌리를 파머	꼬쟁이가 돼 버려 뿌리를 파면
동 오링거는 꼬쟁키 호매이러가꼬 이 뿌리이르 파 노머	동 오른 거는 꼬쟁이 호미를 가지고 이 뿌리를 파 놓으면
뻐뻗허이 나무장작 저 장작쪼가리매이라 그리대비리요	뻣뻣하게 나무장작 저장작 쪼가리처럼이야 그리 돼 버려요
그렁께 동이오리머 몬씬다 그기라	그러니까 동이 오르면 못 쓴다 그거야
고들빼이 저거는 뿌리이를 뭉께	고들빼기 저거는 뿌리를 먹으니까
긍게언잗 몬물상 시픔마 안포능기지 사람드리	그러니까 인제 못 먹을 성 싶으면뭐 안 파는 거지 사람들이
그폴면 대능가 요거더묵꼬 사가도아나고 또 그문디거트먼	그 팔면 되는가 욕 얻어 먹고 사 가지고 않고 또 그 문둥이 같으면
조응거 조응걸 사가지	좋은 거 좋은 걸 사 가지
그라믄자 갤구근	그러면 인제 결국은
할머이 이러치예	할머니 이렇지요
동이 올라오먼 꼳피먼 씨가매즐꺼아임니꺼	동이 올라오면 꽃 피면 씨가 맺을 거아닙니까
하모 씨대비러	아무렴 씨 돼 버려
요기인자 날려가모 새론	요게 인제 날려 가면 새로운
지금올로온거 새로 올로오는 고들빼기 아임니꺼	지금 올라온 거 새로 올라오는고들빼기잖습니까
그렁께	예 그러니까
요거는인자 캐모	요거는 인제캐면
보드라와가지고	보드라워 가지고
예예	예 예
짐치다므믄 그말쓰미지예	김치 담으면 그 말씀이지요
예예	예 예
그 고거는 짐치다마뭉능거는 뿌리이 가꼬 짐치를 다마물끼고	그 그것은 김치 담가 먹는 것은 뿌리갖고 김치를 담아 먹을 게고
하모 그래지금 아까 그 고들빼이그기인자 나중 가으레 콩 익꼬허믄 막 커그등뇨	아무렴 그래 지금 아까 그 고들빼기 그게 인제 나중 가을에 콩 익고 하면 막 크거든요
그럼 그때 뽀바다가 막 폴고 할매드리 그러능기라	그럼 그때 뽑아다가 막 팔고할머니들이 그러는 거야
그라모 고들빼이 이파리는 몬묵씁니까	그러면 고들빼기 이파리는 못 먹습니까
고들빼이 이파리 묵찌요	고들빼기 이파리 먹지요
그러믄	그러면
아파리도 보드라운거 묵찌	이파리도 보드라운 거 먹지
그라먼 할무이드리인자	그러면 할머니들이 인제
돈사러가능거는 입 이파리로가 함니까 뿌리이로	돈 벌러 가는 거는 잎이파리로 합니까 뿌리로
뿌리이 조차가 무조껀 뿌리를 파야데	뿌리조차무조건 뿌리를 파야 돼
뿌리이 파고	뿌리 파고
뿌리이 파가꼬 여간종간종해가꼬 시자아 가머	뿌리 파 가지고 여기 간종간종해 가지고 시장에 가면
막 끄네키로가 뭉커가꼬 이리막 오처넌 머 얼매 막 그리 폴거등뇨 하동장에도	막 끈을 가지고 묶어 가지고 이리 막 오천원 뭐 얼마 막 그리 팔거든요
뿌리이허고 막 저 저 입싸구 고마 캐가꼬 이 전니파리만 뜨더비리고	뿌리하고막 저 저 잎사귀 그냥 캐 가지고 이 전잎만 뜯어 버리고
간종간종 이리 머 간조로이 해가꼬 대가리만 간조로히 해가꼬 인자 뭉커가꼬	간종간종 이리 가지런하게 해 가지고 대가리만 가지런히 해 가지고 인제 묶어 가지고
한따바레언자 오처넌 마넌 쩨깨니 한주묵해노코 오처너이라요 지그믄 그걷또비싸가꼬 오망게 다 오링께	한 다발에 인제 오천 원 만 원 조금씩 한 주먹 해 놓고 오천 원이에요 지금은 그것도 비싸 가지고 오만 게 다 오르니까
마넌짜는언자 요만침 크고 크기 뭉끄고	만 원짜리는 인제 요만큼 크고 크게 묶고
할머이 저 고들빼이에 대해서 참 잘 아랃씀니다 내가 지금 지 누네 보이드시건 다 알건네예	할머니 저 고들빼기에 대해서 참 잘 알았습니다 내가 지금 제 눈에 보이듯이 그건 다 알겠네요
고들빼이 아까도 봐 농께로	고들빼기 아까도 봐 놓으니까
그라몬 이 고들빼기하고씀바귀하고 좀 안 달맏씀니까	그러면 이 고들빼기하고씀바귀하고좀 닮잖았습니까
씀바기가	씀바귀가
씸바기도 하모 고들빼이 머 비슫허지	씀바귀도 아무렴고들빼기 뭐 비슷하지
감 씀바귀는 우째 캐가꼬 머 우째 반찬해묵씀니까	그럼 씀바귀는 어떻게 캐 가지고 뭐 어떻게 반찬해 먹습니까
그걷또 쌀마무치무거요 쌉싸롬허이	그것도 삶아 무쳐 먹어요 쌉쌀하게
아니 우째 캠니꺼 멀캠니꺼	아니 어떻게 캡니까 뭘 캡니까
고마 호매이로 각꼬 그거또	그냥 호미를 가지고 그것도
호매이로 가꼬뿌리이를 그걸 뿌리이가 야기라고 뿌리이조차 캐무요 그걷또	호미를 가지고뿌리를 그걸 뿌리가 약이라고 뿌리조차 캐 먹어요그것도
그렁께 우리는고마 이런데 쌔씽께 온바테 이씨몬 빼가꼬막 칭 내비리고 허는디	그러니까 우리는 그냥 이런 데 널렸으니까 온 밭에 있으면 빼 가지고 막 칙 내버리고 하는데
머 도이지싸람드른 저 지레 항개 이씨먼 머 한장을 해 이 막 씸배기 읻따고	뭐도회지 사람들은 저 길에 한 개 있으면 뭐 환장을 해 이 막 씀바귀 있다고
사뭉께 자기드른	사 먹으니까 자기들은
그람 씀바귀를 씬내이라 캄니까	그럼 씀바귀를 씬냉이라고 합니까
그래 그러데 그사람 사람드리	그래 그러데 그 사람 사람들이
그 요게 쓰는마른 씀바귀를 써씀니까 씬내이를 써씀니까	그 요기에 쓰는 말은씀바귀를 썼습니까 쓴냉이를 썼습니까  예예
씸바구라두허구 머 씬내기라도허고 막 그러데요	씀바귀라고도 하고 쓴냉이라고도 하고 막 그러데요
어떠케예	어떻게요
씸내기 씬 쎄가 안도라간다	씬내기 씬 혀가 안 돌아간다
씬내이	쓴냉이
고마 그리하모 대지 머	그냥 그리 하면 되지 머
그이 주로는그람 씀바기라 써씀니까	그러니 주로는 그럼 씀바귀라 썼습니까
씀바기라 허데요 사람드리	씀바귀라 하데요 사람들이
나는 그렁거 해묵또 아낭께 머 빌로라	나는 그런 거 해 먹지도 않으니까 뭐 별로야
그라먼제 민들레는 우짬니까	그럼 인제 민들레는 어쩝니까
민들레는 즈즙그느레 몰랴가꼬	민들레는 저저 그늘에 말려 가지고
또 쌩걸로 민들레로 막 바테다 시머가꼬 허는 사라므요 막 포라	또 생것으로 민들레를 막 밭에다 심어 가지고 하는 사람은요 막 팔아
그기 야기라고 어떤 사람 사가거든뇨 강강손니미	그게 약이라고 어떤 사람 사가거든요 관광 손님이
이자 그걷또 고들빼이매이로 내나 이리 크니까	인제 그것도 고들빼기처럼 내나이리 크니까
고들빼이매이로 쭉인자 넙쩌커이 킁께로 막	고들빼기처럼 쭉 인제 넙적하게 크니까 막
호매이로가꼬 뿌리이조창 파가꼬 뿌리이조창 파가꼬	호미를 가지고 뿌리조차 파 가지고 뿌리조차 파 가지고
언자 간조로미 무꺼노코 또 한다바레 머 마넌 오처넌 막 그리 포데요	인제 가지런히 묶어 놓고 또 한 다발에 뭐 만 원 오천 원 막 그리 팔데요
그먼인잗 사가는 사람 사가거등 그 야기라고	그러면 인제 사가는 사람 사가거든 그 약이라고
민들레는 꼳피지예	민들레는 꽃 피지요
꼳피요  꼬치	꽃이
꼳피서 그걷또 또 꼬치 피가꼬	꽃 펴서 그것도 또 꽃이 펴 가지고
흔들흔들해가꼬 그리 나요 바테	흔들흔들 해 가지고 그리 나요 밭에
꼬튼 주로 어떤 새까림니까	꽃은 주로 어떤 색깔입니까
민들레	민들레
놀허데	노랗데
노러코 힝거는 어떠씀니까	예 노랗고 흰 거는 어떻습니까
히걷또 익꼬	흰 것도 있고
힝걷또 읻꼬	흰 것도 있고
힝걷또 익꼬	흰 것도 있고
그런갑떼 바테 보머	그런 거 같데 밭에 보면
그래 힝거하고 노릉거 어느거슬 더 고그브로 침니까	그래 흰 것하고 오란 거 어느 것을 더 고급으로 칩니까
그 머 똑가찌 노랑건 노랑걷때로 이삐고 힝거는 힝거때로 이삐고 똑가튼 꼬칭께	그 뭐 똑같지 노란 건 노란 것대로 예쁘고 흰 거는 흰 것대로 예쁘고 똑 같은꽃이니까
그라먼자 나숭개는 초보메 나지예	예 그럼 인제 냉이는 초봄에 나지요
막 그렁거 보메	예 막 그런 거 봄에
너물그렁거	나물 그런거
나숭개는 우째 캐가꼬 나물 우째 함니꺼	냉이는 어떻게 캐 가지고 나물 어떻게합니까
나숭개 그걷또요 파다가 막 뿌리이채 파다가	냉이 그것도요 파다가 막 뿌리째파다가
흑떠러가고 그리 포라 할매드리 보메 보메 막 그런 종뉴가 막	흙 떨어 가지고그리 팔아 할매들이 봄에 봄에 막 그런 종류가 막
그 염방대로머 멕까지 이씽깨 막그렁거 전부 돈너물 머 막 캐다가 막 폴거든	그 대로 뭐 몇 가지 있으니까 막 그런 거 전부 돌나물 뭐 막 캐다가 팍 팔거든
강강손님드리 사가니까 돈너물잘포데 모두 돈너물 그걸 사가가싿테할매드리	관광 손님들이 사가니까 돌나물 잘 팔데 모두 돌나물 그걸 사 가지고 가 쌓데 할머니들이
그러먼	그러면
돈너물너물 나 안무꼬잡더마는 저네	돌나물 나물 나 안 먹고 싶더만 전에
돈너물 마림니까	돗나물 말입니까
돈너물	돌나  물
저네 돈너물 그걸 지그 머이고	전에 돌나물 그걸 저거 뭐니
신근지를 궁물 이꾸로 싱근지를 단지예다 다마노먼 장꾸바아 다마노먼	국물김치를 국물 있게 국물김치를 단지에다 담아 놓으면 고방에 담아 놓으면
요리 저 이 뚤라고언자 그륵가꼬 요리 뚤라고 떠가꼬 밤물라고 요리 뜨러가모어덥헐때	요리 저 이 뜨려고 인제 그릇 가지고 요리 뜨려고 떠 가지고 밥 먹으려고요리 뜨러 가면 어두울 때
어더벌때언자 저무지요 저물모언자 그륵가꼬 요리	어두울 때 인제 저물지요저물면 인제 그릇 가지고 요리
사발가꼬 뜨로가마 장꼬바아 저 짐 그걸 다마노코	사발 가지고 뜨러 가면 고방에 저 김 그걸 담아 놓고
뜨로가머 시퍼러이 부리 씨가 이써 그 돈너무레	뜨러 가면 시퍼렇게 불이 켜져 있어 그 돌나물에
얻 나리 어드배저 농께 어드배저농께 요리 저젇	어 날이 어두워져 놓으니까 어드워져 놓으니까 요리 저 저
뚜꾸리를 덜씨머 장뚜껑을 떠 들씨머 시퍼러이 그런	뚜껑을 들추면 장뚜껑을떠 들추면 시퍼렇게 그런
그 부리 씨가 이써 돈너무레 히안해	그 불이 켜져 있어 돗나물에 희한해
그러고 또 똑 벌거지 씸능거매이로 그럭코 나는 그거 비우예 안맏떠마는	그러고또 꼭 벌레 씹는 것처럼 그렇고 나는 그거 비위에 안 맞더만
돈너물로 잘사가데요 막 신근치 당가뭉는다고	돌나물을 잘 사가데요 막 국물김치 담가 먹는다고
그거 여페이래 쪼꼬만하이 요리요리 착착 부치능거 고거	그거 옆에 이리 자그만하게 요리요리 착착 붙이는 거 고거
예예 그기 돈너무라 도레막 오골오골오골허거등	예예 그게 돌나물이야 돌에 막 오골 오골 오골 하거든
그걷또 꼬치피믄 노랑꼬치 피	그것도 꽃이 피면 노란 꽃이 피
꼳 예노랑꼬	꽃노란 꽃
꼭 그걷또 마이 피머 예삐거든	꽃 그것도 많이 피면 예쁘거든
노래이 피거등 즈즈 봄지내고 막아래껟 피서 다 저빋찌	노랗게 피거든저 저 봄 지나고 막 그 그저께 펴서 다 저 버렸지
비가 와싿코	비가 와 쌓고
저 그러면녜 돈 돈너물도 받꼬	저 그러면요 돌 돌나물도 봤고
달 달롱개는 어디읻씀니까 주로	달 달래는 어디 있습니까 주로
달롱개도 막 지금 전시 재배를해 가꼬 바테다가	달래도 막 지금 전신에 재배를해 가지고 밭에다가
저저 자자란 그걷또 막 씨가 조랑조랑허이 여니까 이리막 거 거석매이로	저저자잘한 그것도 막 씨가 조랑조랑하게 여니까 이리 막 그거 그슥처럼
쭝굳허이 막 즈즈 대가올라오가꼬	쫑긋하게 막 저 저 대가 올라와 가지고
대가 올라오가꼬 씨가 그걷또 이써요 까머이 씨가 이써	대가 올라와 가지고 씨가 이것도 있어요 까맣게 씨가 있어
긍게그걸언잗 씨마는사람 바테 자기드리 숭거가 마는사라믄	그러니까 그걸 인제씨 많은 사람 밭에 자기들이 심어 가지고 많은 사람
그걸 요리요리요리 따가꼬 쭉쭉 훌터다가 또 가라요	그걸 요리요리요리 따 가지고 쭉쭉 훑어다가 또 갈아요
고랑을 요리 처가꼬 후니네 후니네 그래가꼬고마 캐서 또 폰다아임니꺼	고랑을요리 쳐 가지고 후년에 후년에 그래 가지고 그냥 캐서 또 팔잖습니까
저 여쩌게막 여느메 항정엄씨마이해요 저 미테 너무동네 사라미	저 요쪽에막 여 너머에 한정없이 많이 해요 저 밑에 남의 동네 사람이
그래가꼬 보므로 포라 한다라이썩 캐가꼬 가가서	그래 가지고 봄으로 팔아 한 다라이씩 캐 가지고 가져가서
쩨깬썩 다마노코 머 오처넌삼처넌 그리 폴	조금씩 담아 놓고 뭐 오천 원 삼천 원그리 팔아
근데 엔나레는언자 그래 이불로 키아진 안코 보리바테 그기 마니 읻썯찌예	그런데 옛날에는 인제 그리 일부러 키우지는 않고 보리밭에 그게 많이 있었지요
예예	예 예
하모 보리밭에 있지 고랑에 이씨모언자 반매다가 항개 이씨모	아무렴 보리밭에있지 고랑에 있으면 인제 밭 매다가 한 개 있으면
게울로언자 반매다가 뽀쫌히 나머 칵 파고 칵 파고 해가꼬 한쭈먹 가꼬와가꼬언잗	겨울로 인제 밭 매다가 뾰족하게 나면 콱 파고 콱 파고 해 가지고 한 주먹 갖고 와 가지고 인제
고마 이 주물주물 씩꺼가꼬고마 써리가꼬 꼬칟까리엳코고마 지름지고	그냥 주물주물 씻어 가지고 그냥 썰어 가지고 고춧가루 넣고 그냥 기름 제기고
그래가 장에 가고 밥삐믄 달롱개 장 비 달롱개 장 해가꼬 무 밥삐무몬 마싣따싿코 막	그래 가지고 장에 가고 밥 비비변 달래 장 비 달래 장 해 가지고밥 비벼 먹으면 맛있다 쌓고 막웃음
그래가꼬 묵꼬 그랟찌 달롱개를 또	그래 가지고 먹고 그랬지 달래를 또
달롱개 그 뿌리이는 머하고 달맏씀니까	달래 그 뿌리는 뭐하고 닮았습니까
뿌 뿌리이 머 뿌리	뿌 뿌리 뭐 뿌리
마늘하고 마이 달맏찌예	마늘하고 많이 닮았지요
마늘허고 머	마늘하고 뭐
똥글똥글하이	동글동글하게
똥글똥글허이 쪼깬허이 그럳치	예 동글동글하게 자그만하게 그렇지
그게 달롱개지예	그게 달래지요
달롱개 하모 쪼깬허이 그거는 그거는 콩난만 콩매이로 똥글똥글허이 그리 생긷꼬	달래 아무렴 자그만하게 그거는 그거는 콩 낟만 콩처럼 똥글똥글하게 그리 생겼고
그릉께 참 종뉴가 마능기라	그러니까 참 종류가 많은 거야
그라먼녜 할머이	그러면요 할머니
그 지금까지 사네서 나는너물바테서 키우는 채소	그 지금까지 산에서 나는 나물밭에서 키우는 채소
사네서 나는 너물 드리나 바테서 나는 너물	산에서 나는 나물들이나 밭에서 나는 나물
요렁거가 쫌 말쓰믈드럳씀니다이	요런 거가지고 좀 말씀을 들었습니다이
그라먼자 나무를언자 캘 때 언자	그러면 인제 나물을 캘 때 인제
주로 도구 아까호매이 이런 말씀하션는데	주로 도구 아까 호미 이런 말씀 하셨는데
어떤 도구드리 이썬나머	어떤 도구들이 있었나 뭐
뿌리이 인능거	뿌리있는 거
어째 도구 도구드른 어떵기 이써씀니까	어찌 도구 도구들은 어떤 게있었습니까
나물캘라카머	나물 캐려고 하면
호맹 호맹이 반매는 호매이	호미 호미밭 매는 호미
또 머 칼도 이써야 델끼고	또 뭐 칼도 있어야 될 거고
카른 여 치너물캘때 또 칼허고	칼은 여기 취나물 캘 때 또 칼 하고
그니까 그러믄 호매이하고	그러니까 그러면 호미하고
칼 나슨피로업씀니까	칼 낫은 필요 없습니까
또 나츤 하모 머 그렁거 헐땐 피료엄찌	또 낫은 아무렴 뭐 그런 거 할 땐 필요없지
즈즈즏	저 저 저
나틀가꼬언자 쪼매는 지그믄 쪼매는 나츠르 호미매이로 해낟꺼등뇨 저젇 시자아 가먼	낫을 가지고 인제 조그마한 지금은 조그마한 낫을 호미처럼 해 놨거든요
그렁걸 갇따가언잗 동이요리 동이쪼깜 오리먼	그런 걸 갖다가 인제 동이 요리동이 조금 오르면
나틀가꼬언자 이리이리이리 베지 째깨난 나츨 그걸 사다가가	낫을 가지고 인제이리 이리 이리 베지 조그마한 낫을 그걸 사다 가져서
동이 나능거는인자	동이 나는 거는 인제
동이인자 즈즈	동이 인제 저 저
고들빼기가틍거	고들빼기 같은 거
오리거등	예 오르거든
치너무리 얼렁안캐머 바빠서 얼렁안캐머 동이올라요	취나물이 얼른 안 캐면 바빠서 얼른 안 캐면 동이 올라요
그 납짝허이 인능거는 칼로 캐야데고	그 납짝하게 있는 거는 칼로 캐야 되고
그거는 나틀가 캐머 이파리 쭉때 싹 비징께로고마 가치가 엄능기라요 포라묵또몬해	그거는 낫을 가지고 캐면 이파리 줄기 싹 베 지니까 그냥 가치가 없는 거예요팔아 먹지도 못해
그러먼자 고고 캐가지고 그라몬 소네들고 옴니까 우짬니까	그러면 인제 그거캐 가지고 그러면 손에 들고 옵니까
너무를료 소네 몬뜰고 오지 머머 빼재기도 가가고 머	나물을요 손에 못 들고오지 뭐뭐 보자기도 가져 가고 뭐
빼재기가 멈니까	빼재기가 뭡니까
저 쓰레기 모두는 저런 빼재기 쓰레기 모두는 요 이 디아네	저 쓰레기 모으는저런 보자기 쓰레기 모으는 요 이 뒤꼍에
뺄건자리 그거 엄떵가요	빨간 자루 그거 없던가요
빼재기가 머고 바구니	빼재기가 뭐니 바구니
자리자리	자루 자루
자리	자루
하 자리를 갇따가 빼재기라해농께 모린다	어 자루를 갖다가 빼재기라 해 놓으니까 모른다
자리자리	자루 자루
그걸 빼재기라 그럼니까	아 그걸 빼지기라 그럽니까
엔나레	옛날에
내가 그리그리 자꾸그리 요차는 소릴 해	내가 그리그리 자꾸 그리 요상한 소리를 해
아니 그 저 고걸언자언 드를라 그럼니다그게	아니 그 저 그걸 인제 인제 들으려 그럽니다 그게
빼재기라 안허고	빼재기라 안 하고
아임니다	음 아닙니다
저 거시기라 해야대는데	저 그슥이라 해야 되는데
빼재기는 그러몬	빼재기는 그러면
쌀빼재기 머저네	쌀 보자기 뭐 전에
빼재기는 머로가 만듬니꺼	보자기는 뭐로 만듭니까
빼재기 저 강목각꼬 미영베가꼬	보자기 저 광목 가지고 목화베 가지고
저네 요리 양쪽 기를 내가꼬 막 소느로	전에 요리 양쪽 귀를 내 가지고 막 손으로
꿍덕꿍덕 주가꼬 막 틀엄는 사라믄	꿍덕꿍덕 기워 가지고 가지고 막 틀 없는 사람은
그래가꼬 쌀도 여코 그랟써요	그래 가지고 쌀도 넣고 그랬어요
그러머녜	예 그러면요
빼재기도 너코 그다메언자 어떵거는소구리거틍거도 가저가서 거도 다마올꺼 아임니까	보자기도 나왔고 그 다음에 인제 어떤 거는 소쿠리 같은 것도 가져 가서 거기에도 담아 올 거 아닙니까
하모인자 쪼깨이캐믄 소쿠리예고마 캐가꼬 한때끄리 캐가꼬 와서 해 묵꼬	아무렴 인제 조금 캐면 소쿠리에 그냥 캐 가지고 한땟거리 캐 가지고 와서 해 먹고
이자 머 돈사을라고 막 치가 그집빠테 마니 이씨머	인제 뭐 돈 벌려고 막 취가 그 집 밭에 많이 있으면
치를언자 걷따가 소쿠리예다 캐가꼬 자꾸 그그 빼재기예다 여가꼬	취를인제 거기다가 소쿠리에다 캐 가지고 자꾸 그거 보자기자루에다 넣어 가지고
자리예다 여가꼬 또 지고오덩가 이고오덩가언자	자루에다 넣어 가지고 또 지고오든가 이고 오든가 인제
각꼬 오지 각꼬와서언자 또 폴고	갖고 오지 갖고 와서 인제 또 팔고
마는 사라믄	많은 사람은
소쿠리예는 작 이 캐가지고	소쿠리에는 이 캐 가지고
쪼깬썩	조금씩
쪼깬썩 캐가지고 마이 모이 그인자그라다 빼재기예 연는다 그지요	조금씩 캐가지고 많이 모아 그 인제 그러다가 보자기에 넣는다 그죠
예예 하모 여야지 빼재기에	예아무렴 넣어야지 보자기에
그라믄 빼재기말고 또또 크게 하올 또 다마오는 그르근 그륵거틍건 업씀니까	그러면 보자기 말고 또 또 크게 할 또 담아 오는 그릇은 그릇 같은 건 없습니까
그 자리인자 자리 저렁거인자 가가지 머	그 자루 인제 자루 저런 거 인제 가져가지 뭐
내나 빼재기	내나 빼재기
하모	아무렴
내가 무다이 빼재기라해서 그러치 자리자리 저렁거	내가 무단히 빼재기라 해서그렇지 자루 자루 저런 거  음음
자리저렁거야 킁거자긍거인자 가가능기지	자루 저런 거야 큰 거 작은 거 인제 가져 가는 거지
작께할라먼 째깨넌 자리 가가고 마니 해올꺼 이씨먼인자 큰자리 가가고	적게 하려면 작은 자루 가져 가고 많이 해올 거 있으면 인제 큰 자루 가져 가고
이자 거거는언자 너물따라서언자 가능기고	인제 그거는 인제 나물 따라서 인제가는 거고
할머이 저기 엔나레 사네 나물 마이 캐보싣찌예 너물	할머니 저기 옛날에산에 나물 많이 캐 보셨지요 나물
하모 저넨 사네 댕긷찌 사네	아무렴 전엔 산에 다녔지 산에
그라몬 엔나레 절믄시저레	그러면 옛날에 젊은 시절에
사네너물캐러 댕길때 보먼 머 여러가지 얘기가 안 이씀니까이	산에 나물 캐러 다닐 때 보면뭐 여러 가지 얘기가 안 있습니까
머 가다가 아인말로 배미를 바서 놀랟따던지 머 우짿딴 이런 얘기드리 이쓸꺼함 분	뭐 가다가 아닌 말로 뱀을 봐서 놀랬다던지 뭐 어쨌단 이런 얘기들이 있을거 한 번
독쌔	독사
독쌔그게 무섭찌	독사 그게 무섭지
긍께 할머이가 직쩝 경험핻떤	그러니까 할머니가 직접 경험했던
엔나레 좀	옛날에 좀
그 너물캘때 여러가지머 동무들하고 가가꼬 바블 싸서 묵꼬가핻떤 우짿 여러가지 얘기 이쓸꺼 아임니까 고 생각나는대로 해 해주이소	그 나물 캘 때 여러 가지뭐 동무들 하고 가 가지고 밥을 싸거 먹고 했던 어쨌든 여러 가지 얘기 있을 거 아닙니까 그거 생각나는대로 해 주십시오
그이 생각나능게 아이라언젇 도시 저사네 가서언잗 정심때 지도록헐라믄 배가고픙께	그게 생각나는 게 아니라 인제 도무지 저 산에 가서 인제 점심 때 지나도록하려먼 배가 고프니까
아직빱묵꼬 머 아직빠베 또 어데갈라믄 항께 따라갈라믄 막 밥또 몬묵꼬 막 거뜽거뜽허고 강께	아침밥 먹고 뭐 아침밥에 또 어디 가려면 함께 따라가려면 막 밥도못 먹고 거뜬거뜬하고 가니까
이자 덴장 머 반찬 머머 저 드레는 머 꼬사루끄느러 갈쩌게는	인제 된장 뭐 반찬 뭐뭐 저 들에는 뭐 고사리 끊으러 갈 적에는
덴장 그 쪼깐 싸고 그 쌩덴장	된장 그 조금 싸고 그 생된장
도가지예 단지예 인는 그걷 도 쌩덴장 한숙까락 푹 퍼가꼬언잗 곰빼재이나 이리 뭉치가꼬	독에 단지에 있는 그것 생된장 한 숟가락 푹 퍼 가지고 인제 보자기나 이리 뭉쳐 가지고
덴장 싸가능기라요 모도고마 아무라도 덴장 가가 사네느	된장 싸가는 거예요모두 그냥 아무라도 된장 가져가 산에는
그래가꼬 와 덴장을 가가냐허먼	그래 가지고 왜 된장을 가져 가냐 하면
꼬랑에언자 물인는디 가서 밤무므먼서로 덴장 그거만 가가먼 치너물	고랑에 인제 물 있는 데 가서 밥 먹으면서 된장 그거만 가져 가면 취나물
바테 그 사네 치너무리언자 이씽깨로 치너물 그넘 뜨더가꼬 싸믈허능기라	밭에그 산에 취나물이 인제 있으니까 취나물 그놈 뜯어 가지고 쌈을 하는 거야
쌈 덴장 그거 째깬노코고마 쌈해가꼬 밥 쫌 떠너코마	쌈 된장 그거 조금 놓고그냥 쌈 해 가지고 밥 좀 떠 넣고 뭐
그래가 무꼬 물 합씨무먼 배부리고 그랟찌요	그래 가지고 먹고 물 한 모금 먹으면 배 부르고 그랬지요
마싣끋따	아 맛있겠다
마싣써 진짜	맛있어 진짜
배가 고파가꼬	배가 고파 가지고
긍께 치너무른 사네 인능기고 그넘뜨더가꼬 고마 물까예 물 조은디언자 차자가꼬	그러니까 취나물은 산에 있는 거고 그놈 뜯어 가지고 그냥 물가에 물 좋은 데  인제 찾아 가지고
언자 서이면서인 다서시면 다서시언자 가먼	인제 셋이면 셋 다섯이면 다섯이 인제 가면
배고푸다 밥묵짜 해가꼬언자 덴장떵거리만막 가꼬가능기라 마 아무라도	배고프다 밥 먹자 해 가지고 인제 된장 덩어리만 막 갖고 가는 거야 뭐 아무라도
그래가 가서 고마 그이 체고라요 덴장 가가능기	그래 가지고 가서 그냥 그게 최고예요 된장 가져가는 게
고마 치너물그넘 뜨더가꼬 치너물그놈 뜨더가꼬고마	그냥 취나물 그놈 뜯어 가지고 취나물 그놈 뜯어 가지고 그냥
밥 밥쫌노코고마 덴장그넘 어디 물까예 물 조은디 꼬랑까예 가가꼬 바블 뭉는기라요 그 물허고 무글라고	밥 밥 좀 놓고 그냥 된장 그놈 어디 물가에 물 좋은 데고랑 가에 가 가지고 밥을 먹는 거예요 그 물하고 먹으려고
그래가꼬 마 묵꼬 와 그래가꼬 꼬사리 끄너가꼬 막 다라오지	그래 가지고 뭐 먹고 와 그래 가지고 고사리 끊어 가지고 막 돌아오지
그때는 그꼬랑은 언자 사네인는 꼬랑아님니까이	그때는 그 고랑은 인제 산에 있는 고랑이잖습니까
저네는 마 꼬랑에 이리하먼 요리요리요리 요 상가고 저 상가고허믄 꼬랑이 조은디가 무리 철철철 저사네서 내려 오거든	전에는 뭐 고랑에 이리 하면 요리요리요리요 산 가고 저 산 가고 하면 고랑이 좋은 데가 물이 철철철 저 산에서 내려 오거든
긍께머 무주껀 우수네 아페 무리조응께로 고마 뭉능기라요	그러니까 뭐 무조건우선에 앞의 물이 좋으니까 그냥 먹는 거예요
그런데는 약또 안치고 하모 저네는 사네	그런 데는 약도 안 치고 아무렴 전에는산에
엔나레그라몬 내려오는 꼬랑물도 다 묻씀니까	옛날에 그러면 내려오는고랑물도 다 먹었습니까
아이고 묻찌 그렁거 묻찌요 사네 가서 무리 무꼬자서	아이고 먹었지 그런거 먹었지요 산에 가서 물이 먹고 싶어서
그러고 또 무리막 데기 사늘타고 댕기먼 막 꼬사리 껑는다고 해대고 댕기믄	그러고 또 물이 막 되게 산을 타고 다니면 막 고사리 꺾는다고 해대고 다니면
쪼깨니 요리막 요리 파노코 무리언자 째작째작허이 익꺼등	조그맣게 요리 막요리 파 놓고 물이 인제 자작자작하게 있거든
그먼 올채이가 막 오글오글 익꼬	그러면 올챙이가 막 오글오글 있고
가먼 무리 무꾸자바 막 꼬랑도엄꼬 무리 무꼬자밤 그넘도 이블 대가꼬 쭉쭉 뽀라묵꼬 그랟써요	가면 물이 먹고 싶어 막 고랑도 없고 물이 먹고 싶어 그놈도 입을대 가지고 쭉쭉 빨아 먹고 그랬어요
올챙이 사는줄도	올챙이 사는 줄도
올채이 거 읻써도 무리 무꼬자 한재이라서	올챙이 거기 있어도 물이 먹고 싶어 환장이라서
저네는 그랟써요 사네 가머 그 꼬랑을 몬만내면 미차	전에는 그랬어요 산에 가면 그 고랑을 못 만나면 미처
하모 어쩌끼라 무리묵꼬자 죽껃꼬	아무렴 어쩔 거야 물이 먹고 싶어 죽겠고
긍께배서는 그래 물 안뭉는다하고 막 그래싿거등	그러니까 아이 배서는 그리 물 안 먹는다 하고 막 그래 쌓거든
엔나레 사네 그 갈때	옛날에 산에 그 갈 때
혹씨인제 요즘마라는 첨 암치매코로 이리 크다란 보잭 이런 하나 둘러가지고 요	혹시 인제 요즘말하는 앞치마처럼 이리 커다란 보자기 이런 하나 둘러 가지고 요
하모 아치메 가대이지 지금도 마리잠 바테 가도	아무렴 아침에 가져 다니지 지금도 말하자면밭에 가도
바테가도 호매이 그 여가꼬 만날 사람드리 어께예 미고 대인다이가 지금도	밭에 가도 호미 그 넣어 가지고 만날 사람들이 어깨에 메고 다니잖니 지금도
메고 댕기능거	아 메고 다니는 거
그걸 머라캗씀니꺼 이르미예	그걸 뭐라고 했습니까 이름이요
아치메	아침에
그니까 어꾹 어깨에	아 그러니까 어깨 어깨에
어깨에고마 할매드리 고마 메고 대이더로	예 어깨에 그냥 할머니들이 그냥 메고 다니도록
머에다너서 메고 댕김니까	뭐에다 넣어서 메고 다닙니까
자기 언자 바테면서언자 물	자기 인제 밭에 가면서 인제 물
무리무꼬장께 바테 가모 물끼링거 물한벵 가가고 머	무리 먹고 싶으니까 밭에가면 물 끓인 거 물 한 병 가져 가고 뭐
머 마리잠 머 자기 무꺼 이씨믄 머 빵쪼가라도 이씨먼 물라모 가가고	뭐 말하자면 뭐 자기 먹을 거 있으면 뭐 빵쪼가리라도 있으면 먹으려면 가져 가고
그렁거만 무주꾼 여가 댕기는기지	그런 거만 무조건 넣어 가지고 다니는 거지
그이 얻 어디예다 여씀니까 그걸갇따가	그러니 어디에다 넣습니까 그걸 갖다가
그 저저 치매요 압치매예	그 저저 치마요 앞치마요
압치매예	앞치마요
앞치매 그게 다드러감니까	앞치마에 그게다 들어 갑니까
아이고 드러가지 머이 지그믄 저런 즈즏	아이고 들어 가지 뭐 이 지금은 저런저 저
자리를 가꼬 쪼고만 자리 쌀짜리 읻찌요	자루를 갖고 조그만 자루 쌀 자루 있지요
쌀 정궁미포대 쌀짜리	쌀 정부미 쌀 자루
그 쪼깨난 자리가 쌀짜리가 쌛씽께 싸를 사묵꼬 헝께	그 조그마한 자루가 쌀자루가 많으니까 쌀을 사 먹고 하니까
그걸가꼬 이리 그막 꾸매가꼬 이리이리 니모빤드허이 꾸메고막 요리 차능거 고마 선해가꼬	그걸 가지고 이리 그 막 꿰매 가지고 이리이리 네모 반듯하게 꿰메고막 요리 차는 거 그냥 줄 해 가지고
끈끈 질기해가꼬 요리 마 둘러서 불끈 째매가꼬	끈 끈 길게 해 가지고 요리 뭐둘러서 불끈 조여 매 가지고
치너물도 캐여코 바테 가머 또 돔부 저렁걷또마 이긍거 이씸 이리 따 여코	취나물도 캐 넣고 빹에 가면 또 돔부 저런 것도 뭐 익은 거 있으면 이리 따넣고
그래가꼬 땅거를 그래 비우고 너무모 막 그래요	그래 가지고 딴 거를 그리 비우고 넘으면 막 그래요
돔부카능기 아까 그거내나 통	돔부라고 하는 게 아까 그거 내나 통
아까 진돔부 진돔부	아까 긴 돔부 긴 돔부
질기 나즌 돔부가 여러요 이 즈즈즈지	길게 낮은 돔부가 열어요 이 저 저저 저
골필매이로 여러요 질쭉허니 나중 이 안죽 꼳또 안핃떼 능크래이마언자 능클지 능크리마 능크지	골풀처럼 열어요 길쭉하게 나중 이 아직 꽃도 안 폈데 넝쿨만 인제 넝쿨만 얽혔지 넝쿨만 얽혔지
진돔부돔부 그 말나온 기메예	긴돔부 돔부 그 말 나온 김에요
장대	장대
고고 함번	그거 한 번
저 우째 숭거가꼬 우째 고고	저 어찌 심어 가지고 어찌 그거
아이 고만콩매이로 고만 호매이 푹 파가꼬 숭거만 노믄 나니까 저렁거는	아니 그냥 콩처럼그냥 호미 푹 파 가지고 심어만 놓으면 나니까 저런 거는
그 그그거는 콩이라 콩이라 카는지	그 그거는 콩이라 콩이라고 하는지
장대 장대	장대 장대
그래 콩이라곤 안카지예 그래	그래 콩이라고는 안 하지요 그래
긍께이르민잗 돔부라허고 장대라허고 그러지요	그러니까 이름이 인제 돔부라 하고 장대라 하고 그러지요
그러먼자 그 종자를	그러면 인제 그 종자를
종자로언자 저리 열믄 오래 열믄	종자를 인제 저리 열면 오래 열면
언자 따서 딱 몰랴나야지 몰랴낟따가 후년보메 또 숭거야 댕께	인제 따서 딱말려 놔야지 말려 놨다가 내년 봄에 또 심어야 되니까
그러니까그걸가타가 일딴 숭거 그럳 그 종자는 새까리 우떧씀니까	그러니까그걸 갖다가 일단 심어 그러니까 그 종자는 색깔이 어떻습니까
뺄그래요 폰매이로 폰매이로 저걷또 뺄그래요	빨개요 팥처럼 팥처럼 저것도빨개요
그때 포튼 쪼깬치만	그때 팥은 작지만
이 크지예	이 크지요
한 요정도	한 요 정도
아리 좀크지 하모	알이 좀 크지 아무렴
한 요정도 안댐니꺼	한 요 정도 안 됩니까
그린앙커도언자 쪼깐크지저거 폳뽀다	그리는 안 커도 인제 조금 크지 저거 팥보다
잘쭉허니	길쭉하니
그럳씀니까	아 그렇습니까
돔부라는게	돔부라는 게
돔부도 또 여러가징께	돔부도 또 여러 가지니까
돔부도 저건 진돔부 즈즈 니돔부라 그러고	돔부도 저건 긴돔부 저 저 누에돔부라 그러고
니덤부	누에돔부
아니 진돔부가 니돔붐니까	아니 긴돔부가 누에돔부입니까
진돔부라도 질기 그만 인는 돔부가 익꼬 또 종자도 두가지라요	긴돔부라도 길게 그만 있는 돔부가 있고 또 종자도 두 가지예요
니 니매이로 오골오골허이 모디모디 모디모디 질 모디모디	누에 누에처럼 오골오골하게 마디마디 마디마디 길 마디마디미
돔부그래 열므 참 저거 예삔디	돔부 그래 열면 참 저거 예쁜데
모디모디 니매이로 니가 모디모디 익꺼등뇨	마디마디 누에처럼 누에가 마디마디 있거든요
요리 모디모디 막 그리 생기거든 근디	요리 마미마디 막 그리 생기거든 그런데
니돔부라해 그걸 모디모디이씽께 장대가	누에돔부라 해 그걸 마디마디 있으니까 장대가
언자그거 돔부라능거는 질쭉허니고만 그리 생긷꼬	인제 그거 돔부라는 거는 길쭉하게 그냥 그리 생겼고
종뉴가 두개라 니돔부	종류가 두 개야 누에돔부
금 질쭉항거 아네	그럼길쭉한 거 안에
쪽이그 열매가 드링기 하나익꼬	쪽 이 그 열매가 든 게 하나 있고
예예	예예
니처럼 요러케요러케 촉	누에처럼 요렇게 요렇게 촉
알 드릉걷 하고 요러케	알 든 거 하고 요렇게
하모 요게 아리 듬서로 여거함모디	아무렴 요기에 알이 들어서 한 마디
쫄록쫄록하이	잘록잘록하게
예 한모디 여거 알드럳꼬 한모디 두모디	예 한 마디 여기에 알 들었고 한 마디두 마디
모디모디 그리 읻떼요 그 장대는	마디마디 그리 있데요 장대는
근 니돔붐니까	그건 누에돔부입니까
긍께 보기가 조아 그렁께 니거치 생긷따고 니돔부래	그러니까 보기가 좋아 그러니까 누에같이 생겼다고 누에돔부래
그라믄 진돔부 익꼬 니돔부 익꼬	그러면 긴돔부 있고 누에돔부있고
어어	어어
또 어떵거 이씀니까	또 어떤 거 있습니까
그기고 또 즈즈즈 머이고	그것이고 또 저 저 저 뭐니
능크리이 이리이리이리 강꼬막 저나무예 올라가는 돔부를 돔부는언잗또 그	넝쿨이 이리 이리 이리 감고 막 저 나무에 올라가는 돔부를 돔부는 인제 또 그
가으레 따거등 가으레 또 거걷또 근디 그런 돔부도 이써요	가을에 따거든 가을에 또 그것도 그런데 그런 돔부도 있어요
그 이르미 멈니까 그거는	그 이름이 뭡니까 그거는
그걷또 고마 저저 능크래이돔부라 그러지	그것도 그냥 저저 넝쿨돔부라 그러지
타고 올라가야 이어지그거는 응더게다 노픈응더게다	타고 올라가야 이어져 그거는 언덕에다 높은 언덕에다
저저 숭거가꼬 요리 아까매이로 니루덩가	저저 심어 가지고 요리 아까처럼 내리든가
그래야 여지 땅에느 안열거등뇨	그래야 열져 땅에는 안 열거든요
귿 돔부는 뺄그래이 이삐요 그 돔부	그 돔부는 빨갛게 예뻐요 그 돔부
그그거는 무슨돔부라고예	그 그거는 무슨 돔부라고요
능크리이돔부라 그래요 고마	넝쿨돔부라 그래요 그냥
낼 그런 돔부를 항개 낼 안가시믄 우리지비 인는디 갇따 비기야건네	내일 그런돔부를 한 개 내일 안 가시면 우리 집에 있는데 갖다 보여야겠네
뺄그래이 커 돔 콩보당 영커	빨갛게 커 돔 콩보다 영 커
그러믄녜	그러면요
진돔부하고 니돔부하고	긴돔부하고 누에돔부하고
장 능쿠리이돔부	장 넝쿨돔부
능쿠리이돔부 세개가 인는데	넝쿨돔부 세 개가 있는데
능쿠리이돔부는 아리 영커	넝쿨돔부는 알이 영 커
그라먼자 알크기는 능클돔부가 젤 큼니까	그러면 인제 알  크기는 넝쿨돔부가 제일 큽니까
그다으메가	그 다음이
대는 내나 저래	대는 내나 저래
저리 비슫허이 저래 아까보네 손댄데	저리 비슷하게 저래 아까번에 손 댄 데
그라몬 진돔부하고 니돔부크기는 어느기 아리 더 큼니까	그러면 긴돔부하고 누에돔부크기는 어느 게 알이 더 큽니까
니돔부가 조치 크지	누에돔부가 좋지 크지
그래서 니돔부저 개리가꼬 숭군다고 저 맥꾸덕 숭구난는디	그래서 누에돔부 저가려 가지고 심는다고 저 몇 구덩이 심어 놨는데
딴디는 머 우리바테는 저 타고올라갈띠도 엄꼬 숭굴띠가 엄꼬	딴 데는 뭐 우리밭에는 저 타고 올라갈 데도 없고 심을 데가 없고
저저 저런디 엉더그로 숭구난는디 비가와싸서 데다안느만 돔부도	저저 저런 데언덕으로 심어 놨는데 비가 와 쌓아서 되지도 않더만 돔부도
응 돔부가 데도아내	응 돔부가 되지도 않아
아유 고맙씀니다 할머이 또 쫌쫌 싣따가 또 하입시더이	아유 고맙습니다 할머니 또 좀 좀 쉬었다가 또 하십시다이
